168原告叶某甲诉被告王某某离婚纠纷案一审民事判决书.txt	依照 《 中华人民共和国 婚姻法 》 第三十二条 、 《 中华人民共和国 民事 诉讼法 》 第六十四 条 第一款 及 《 最高人民法院 关于 民事诉讼 证据 的 若干 规定 》 第二条 之 规定 ， 判决 如下 ： 

丁某某与杜某某离婚纠纷案一审民事判决书.txt	依照 《 中华人民共和国 婚姻法 》 第三十二条 和 《 中华人民共和国 民事 诉讼法 》 第一百 四十二条 、 第一百 六十条 之 规定 ， 判决 如下 ： 

丁某某诉赵某甲离婚纠纷一审民事判决书.txt	据此 ， 依照 《 中华人民共和国 婚姻法 》 三十二条 之 规定 ， 判决 如下 ： 

丁某甲与王某离婚纠纷一案 二审民事裁定书.txt	依照 《 中华人民共和国 民事 诉讼法 》 第一百七 十三条 之 规定 ， 裁定 如下 ： 

万某与姜某甲离婚纠纷一审民事判决书.txt	据此 ， 依照 《 中华人民共和国 婚姻法 》 第三十二条 、 《 中华人民共和国 民事 诉讼法 》 第六十四 条 及 《 最高人民法院 关于 民事诉讼 证据 的 若干 规定 》 第二条 之 规定 ， 判决 如下 ： 

万某兵与郑某琼离婚纠纷一审民事判决书.txt	依据 《 中华人民共和国 婚姻法 》 第三十二条 第二款 、 《 中华人民共和国 民事 诉讼法 》 第六十四 条 第一款 、 《 最高人民法院 关于 适用 ﹤ 中华人民共和国 民事 诉讼法 ﹥ 的 解释 》 第九 十条 的 规定 ， 判决 如下 ： 

万某某与袁某某离婚纠纷一审民事判决书.txt	据此 ， 依照 《 中华人民共和国 婚姻法 》 第三十二条 第二款 " 人民法院 审理 离婚 案件 ， 应当 进行 调解 ； 如 感情 确 已 破裂 ， 调解 无效 ， 应 准予 离婚 。 " 之 规定 ， 判决 如下 ： 

严某某与杨某甲离婚纠纷一审民事判决书.txt	依照 《 中华人民共和国 婚姻法 》 第三十二条 、 《 中华人民共和国 民事 诉讼法 》 第六十四 条 、 第 一百四十四 条 ， 《 最高人民法院 关于 民事诉讼 证据 的 若干 规定 》 第二条 之 规定 判决 如下 ： 

于某某诉彭某某离婚纠纷一案一审民事判决书.txt	依照 《 中华人民共和国 婚姻法 》 第三十二条 、 《 中华人民共和国 民事 诉讼法 》 第一百 四十八条 之 规定 ， 判决 如下 ： 

于某某诉邓某某离婚纠纷一审民事裁定书.txt	依照 《 中华人民共和国 民事 诉讼法 》 第 一百一十 八条 、 《 诉讼费用 交纳 办法 》 第二十条 、 《 最高人民法院 关于 适用 ﹤ 诉讼费用 交纳 办法 ﹥ 的 通知 》 第二条 的 规定 ， 裁定 如下 ： 

付某某与许某甲离婚纠纷一审民事判决书.txt	依照 《 中华人民共和国 婚姻法 》 第三十二条 、 最高人民法院 《 关于 民事诉讼 证据 的 若干 规定 》 第二条 的 规定 ， 判决 如下 ： 

付某某与鄢某某离婚纠纷二审民事判决书.txt	据此 ， 依照 《 中华人民共和国 民事 诉讼法 》 第一百七十条 第一款 第 （ 一 ） 项 " 原 判决 、 裁定 认定 事实清楚 ， 适用法律 正确 的 ， 以 判决 、 裁定 方式 驳回上诉 ， 维持原判 决 、 裁定 " 的 规定 ， 判决 如下 ： 

代某某与周某离婚纠纷案一审民事判决书.txt	依照 《 中华人民共和国 婚姻法 》 第三十二条 、 第十七条 和 《 中华人民共和国 民事 诉讼法 》 第一百 四十二条 之 规定 ， 判决 如下 ： 

代某某与王某某离婚纠纷一案一审民事判决书.txt	依照 《 中华人民共和国 婚姻法 》 第三十二条 二 、 三款 " 人民法院 审理 离婚 案件 ， 应当 进行 调解 ； 如 感情 确 已 破裂 ， 调解 无效 ， 应 准予 离婚 " ， 第三十七条 " 离婚 后 ， 一方 抚养 的 子女 ， 另一方 应 负担 必要 的 生活费 和 教育费 的 一部 或 全部 ， 负担 费用 的 多少 和 期限 的 长短 ， 由 双方 协议 ； 协议 不成 时 ， 由 人民法院 判决 " ， 《 中华人民共和国 民事 诉讼法 》 第六十四 条 第一款 " 当事人 对 自己 提出 的 主张 ， 有 责任 提供 证据 " 之 规定 ， 判决 如下 ： 

代某某与王某甲离婚纠纷一审民事判决书.txt	据此 ， 原告 要求 与 被告 离婚 的 诉讼请求 ， 不予 支持 。 依照 《 中华人民共和国 婚姻法 》 第三十二条 、 《 中华人民共和国 民事 诉讼法 》 第 一百四十四 条 之 规定 ， 判决 如下 ： 

代某浩与郑某娟离婚纠纷一审判决书.txt	据此 ， 为了 保护 当事人 的 合法权益 ， 促进 社会 的 稳定 ， 依照 《 中华人民共和国 婚姻法 》 第三十二条 第二款 、 《 中华人民共和国 民事 诉讼法 》 第六十四 条 第一款 、 《 最高人民法院 关于 民事诉讼 证据 的 若干 规定 》 第二条 之 规定 ， 判决 如下 ： 

代某甲与邓某甲离婚纠纷一审民事判决书.txt	据此 ， 原告 要求 与 被告 离婚 的 诉讼请求 ， 不予 支持 。 依照 《 中华人民共和国 婚姻法 》 第三十二条 之 规定 ， 判决 如下 ： 

任安杰与孔小叶离婚纠纷二审民事裁定书.txt	据此 ， 依据 《 中华人民共和国 民事 诉讼法 》 第一百七 十四条 " 第二审 人民法院 审理 上诉 案件 ， 除 依照 本章 规定 外 ， 适用 第一审 普通 程序 " 及 《 中华人民共和国 民事 诉讼法 》 第 一百四十 三条 " 原告 经 传票 传唤 ， 无 正当理由 拒 不 到庭 的 ， 或者 未经 法庭 许可 中途 退庭 的 ， 可以 按 撤诉 处理 ； 被告 反诉 的 ， 可以 缺席判决 " 之 规定 ， 裁定 如下 ： 

任某某与勾某某离婚纠纷一审民事判决书.txt	依照 《 中华人民共和国 婚姻法 》 第三十二条 、 《 中华人民共和国 民事 诉讼法 》 第 一百四十四 条 、 最高人民法院 《 关于 适用 〈 中华人民共和国 民事 诉讼法 〉 的 解释 》 第九 十条 之 规定 ， 判决 如下 ： 

任某某与牟某甲离婚纠纷一审民事判决书.txt	据此 ， 依照 《 中华人民共和国 婚姻法 》 第三十二条 、 第三十六条 、 第三十七条 ， 《 最高人民法院 关于 适用 < 中华人民共和国 婚姻法 > 若干 问题 的 解释 ( 二 ) 》 第二十一条 之 规定 ， 《 中华人民共和国 民事 诉讼法 》 第 一百四十四 条 ， 《 最高人民法院 关于 适用 < 中华人民共和国 民事 诉讼法 > 的 解释 》 第九 十条 ， 《 最高人民法院 关于 人民法院 审理 离婚 案件 处理 子女 抚养 问题 的 若干 具体意见 》 第 5 条 ， 缺席判决 如下 ： 

任某某诉王某某离婚纠纷一审民事判决书.txt	依照 《 中华人民共和国 婚姻法 》 第三十二条 第二款 、 《 最高人民法院 关于 民事诉讼 证据 的 若干 规定 》 第二条 到 二款 之 规定 ， 判决 如下 ： 

任某甲与王某离婚纠纷一审民事判决书.txt	根据 《 中华人民共和国 婚姻法 》 第三十二条 之 规定 ， 判决 如下 ： 

任某甲诉李某某离婚纠纷判决书.txt	依照 《 中华人民共和国 婚姻法 》 第三十二条 、 第三十六条 、 第三十七条 、 第三十八条 、 第三十九条 、 笫 四十二条 、 第四十六 条 之 规定 ， 判决 如下 ： 

伍某与李某甲离婚纠纷一审民事判决书.txt	据此 ， 依据 《 中华人民共和国 婚姻法 》 第三十二条 、 最高人民法院 《 关于 民事诉讼 证据 的 若干 规定 》 第二条 和 《 中华人民共和国 民事 诉讼法 》 第 一百四十四 条 之 规定 ， 判决 如下 ： 

伍某某与周某某离婚纠纷案一审民事判决书.txt	依照 《 中华人民共和国 民法 婚姻法 》 第三十二条 、 第三十七条 、 第三十九条 ， 《 最高人民法院 关于 适用 〈 中华人民共和国 婚姻法 〉 若干 问题 的 解释 （ 二 ） 》 第十四条 的 规定 ， 判决 如下 ： 

伍某某与张某某离婚纠纷一审民事判决书.txt	依照 《 中华人民共和国 婚姻法 》 第三十二条 、 第四十二条 之 规定 ， 判决 如下 ： 

伍某某与辜某某离婚纠纷一审民事判决书.txt	据此 ， 依照 《 中华人民共和国 婚姻法 》 第三十二条 第二款 、 《 中华人民共和国 民事 诉讼法 》 第六十四 条 第一款 、 第 一百四十四 条 、 《 最高人民法院 关于 民事诉讼 证据 的 若干 规定 》 第二条 之 规定 ， 缺席判决 如下 ： 

何建东与钟碧珍离婚纠纷一审民事判决书.txt	据此 ， 依照 《 中华人民共和国 婚姻法 》 第三十二条 、 《 最高人民法院 关于 民事诉讼 证据 的 若干 规定 》 第二条 ， 判决 如下 ： 

何某与张某甲离婚纠纷一审民事判决书.txt	据此 ， 依照 《 中华人民共和国 婚姻法 》 第三十二条 、 《 最高人民法院 ﹤ 关于 民事诉讼 证据 的 若干 规定 ﹥ 》 第二条 之 规定 ， 判决 如下 ： 

何某与杨甲离婚纠纷一审民事判决书.txt	依照 《 中华人民共和国 婚姻法 》 第三十二条 、 第三十六条 、 第三十七条 、 第三十八条 、 第三十九条 、 《 最高人民法院 关于 人民法院 审理 离婚 案件 处理 子女 抚养 问题 的 若干 具体意见 》 第 7 条 、 第 8 条 、 第 11 条 、 《 中华人民共和国 民事 诉讼法 》 第 一百四十四 条 和 《 最高人民法院 关于 适用 〈 中华人民共和国 民事 诉讼法 〉 的 解释 》 第九 十条 的 规定 ， 判决 如下 ： 

何某某与何某甲离婚纠纷案一审民事判决书.txt	依照 《 中华人民共和国 婚姻法 》 第三十二条 、 第三十九条 和 《 中华人民共和国 民事 诉讼法 》 第 一百四十四 条 、 第一百 六十条 之 规定 ， 判决 如下 ： 

何某某与向某甲离婚纠纷案一审民事判决书.txt	根据 《 中华人民共和国 婚姻法 》 第三十二条 第二款 " 人民法院 审理 离婚 案件 ， 应当 进行 调解 ； 如 感情 确 已 破裂 、 调解 无效 ， 应 准予 离婚 。 " 的 规定 ， 判决 如下 ： 

何某某与张某某离婚纠纷案一审民事判决书.txt	依照 《 中华人民共和国 婚姻法 》 第三十二条 、 第三十六条 、 第三十七条 、 第三十八条 和 《 中华人民共和国 民事 诉讼法 》 第一百 四十二条 、 第一百 六十条 之 规定 ， 判决 如下 ： 

何某某与李某甲离婚纠纷一审民事判决书.txt	根据 《 中华人民共和国 婚姻法 》 第三十二条 的 规定 ， 判决 如下 ： 

何某某与李某离婚纠纷一审民事判决书.txt	据此 ， 依照 《 中华人民共和国 婚姻法 》 第三十二条 " 男女 一方 要求 离婚 的 ， 可 由 有关 部门 进行 调解 或 直接 向 人民法院 提出 离婚 诉讼 。 人民法院 审理 离婚 案件 ， 应当 进行 调解 ； 如 感情 确 已 破裂 ， 调解 无效 ， 应 准予 离婚 " 之 规定 ， 判决 如下 ： 

何某某与李甲离婚纠纷一审民事判决书.txt	依照 《 中华人民共和国 婚姻法 》 第三十二条 的 规定 ， 判决 如下 ： 

何某某与梁某某离婚纠纷案一审民事判决书.txt	依照 《 中华人民共和国 婚姻法 》 第三十二条 、 最高人民法院 《 关于 民事诉讼 证据 的 若干 规定 》 第二条 和 《 中华人民共和国 民事 诉讼法 》 第一百 四十二条 、 第六十四 条 、 第一百 六十条 之 规定 ， 判决 如下 ： 

何某某与王某某离婚纠纷一审民事判决书.txt	据此 ， 为 保护 当事人 的 合法权益 ， 根据 《 中华人民共和国 婚姻法 》 第三十二条 、 第三十六条 、 《 最高人民法院 关于 人民法院 审理 离婚 案件 处理 子女 抚养 问题 的 若干 具体意见 》 第 3 条 之 规定 ， 判决 如下 ： 

何某某与谭某某离婚纠纷一审民事判决书.txt	依照 《 中华人民共和国 婚姻法 》 第三十二条 的 规定 ， 判决 如下 ： 

何某某与赵某某离婚纠纷一案一审民事判决书.txt	据此 ， 婚生子 由 被告 抚养 为 宜 ， 原告 应 承担 婚生子 的 抚养费 。 关于 共同财产 的 分割 问题 ， 庭审 中 ， 原告 认为 在 被告 老家 修建 的 房屋 属 夫妻 共同财产 ， 而 被告 认为 该 房屋 属 家庭 共有 财产 ， 且 双方 均 未 向 法庭 提供 相关 证据 ， 法庭 无法 确定 夫妻 共同财产 的 相关 情况 ， 故 本案 中 ， 法庭 暂 无法 对 夫妻 共同财产 的 分割 作出 处理 。 据此 ， 依照 《 中华人民共和国 婚姻法 》 第三十二条 、 第三十六条 、 第三十七条 、 《 最高人民法院 关于 适用 〈 中华人民共和国 民事 诉讼法 〉 的 解释 》 第九 十条 之 规定 ， 判决 如下 ： 

何某某与骆某某离婚纠纷一审民事判决书.txt	依照 《 中华人民共和国 婚姻法 》 第三十二条 第三款 （ 五 ） 项 的 规定 ， 判决 如下 ： 

何某某与魏某离婚纠纷案一审民事判决书.txt	依照 《 中华人民共和国 婚姻法 》 第三十二条 、 《 中华人民共和国 民事 诉讼法 》 第 一百四十四 条 、 第一百 六十条 之 规定 ， 判决 如下 ： 

何某某诉丁某某离婚纠纷一审民事判决书.txt	依照 《 中华人民共和国 婚姻法 》 第三十二条 第三款 、 《 最高人民法院 关于 民事诉讼 证据 的 若干 规定 》 第二条 之 规定 ， 判决 如下 ： 

何某甲与王某甲离婚纠纷一审民事判决书.txt	依照 《 中华人民共和国 婚姻法 》 第三十二条 第二款 及 《 最高人民法院 关于 民事诉讼 证据 的 若干 规定 》 第二条 、 第七十六条 之 规定 ， 判决 如下 ： 

何某甲与罗某甲离婚纠纷一审民事判决书.txt	依照 《 中华人民共和国 婚姻法 》 第三十二条 第二款 人民法院 审理 离婚 案件 ， 应当 进行 调解 ； 如 感情 确 已 破裂 ， 调解 无效 ， 应 准予 离婚 。 ， 《 中华人民共和国 民事 诉讼法 》 第六十四 条 第一款 当事人 对 自己 提出 的 主张 ， 有 责任 提供 证据 。 及 《 最高人民法院 ﹤ 关于 民事诉讼 证据 的 若干 规定 的 理解 与 适用 ﹥ 》 第二条 第二款 没有 证据 或者 证据 不足以 证明 当事人 的 事实 主张 的 ， 由 负 举证责任 的 当事人 承担 不利 后果 。 的 规定 ， 判决 如下 ： 

佘某卫与袁某离婚纠纷一审民事判决书.txt	据此 ， 为 维护 各方 当事人 的 合法权益 ， 根据 《 中华人民共和国 婚姻法 》 第三十二条 第二 、 三款 、 《 中华人民共和国 民事 诉讼法 》 第六十四 条 、 第六十五条 之 规定 ， 判决 如下 ： 

余某与罗某甲离婚纠纷一审民事判决书.txt	依照 《 中华人民共和国 民事 诉讼法 》 第六十四 条 、 第 一百四十四 条 和 《 最高人民法院 关于 适用 〈 中华人民共和国 民事 诉讼法 〉 的 司法解释 》 第九 十条 的 规定 ， 判决 如下 ： 

余某与雍某某离婚纠纷一审民事判决书.txt	依照 《 中华人民共和国 婚姻法 》 第三十二条 的 规定 ， 判决 如下 ： 

余某兰与张某斌离婚纠纷一审民事判决书.txt	据此 ， 为 保护 当事人 的 合法权益 ， 根据 《 中华人民共和国 民事 诉讼法 》 第六十四 条 第一款 、 《 中华人民共和国 婚姻法 》 第三十二条 、 最高人民法院 关于 适用 《 中华人民共和国 民事 诉讼法 》 的 解释 第九 十条 、 最高人民法院 《 关于 民事诉讼 证据 的 若干 规定 》 第二条 之 规定 ， 判决 如下 ： 

余某某与何某某离婚纠纷一审民事判决书.txt	依照 《 中华人民共和国 婚姻法 》 第三十二条 、 《 最高人民法院 关于 民事诉讼 证据 的 若干 规定 》 第二条 、 《 中华人民共和国 民事 诉讼法 》 第一百 四十二条 之 规定 ， 判决 如下 ： 

余某某与夏某甲离婚纠纷一审民事判决书.txt	据此 ， 依照 《 中华人民共和国 婚姻法 》 第三十二条 、 《 中华人民共和国 民事 诉讼法 》 第六十四 条 第一款 、 《 最高人民法院 关于 适用 〈 中华人民共和国 民事 诉讼法 〉 的 解释 》 第九 十条 第二款 之 规定 ， 判决 如下 ： 

余某某诉向某某离婚纠纷一审民事判决书.txt	据此 ， 依照 《 中华人民共和国 婚姻法 》 第三十二条 ， 《 中华人民共和国 民事 诉讼法 》 第 一百四十四 条 ， 《 最高人民法院 关于 适用 ＜ 中华人民共和国 民事 诉讼法 ＞ 的 解释 》 第九 十条 之 规定 ， 判决 如下 ： 

侯某某与刘某某离婚纠纷一审民事判决书.txt	据此 ， 依据 《 中华人民共和国 民事 诉讼法 》 第 一百四十四 条 ， 《 中华人民共和国 婚姻法 》 第三十二条 ， 《 最高人民法院 关于 民事诉讼 证据 的 若干 规定 》 第二条 的 规定 ， 判决 如下 ： 

侯某某与张某某离婚纠纷一审民事判决书.txt	据此 ， 依照 《 中华人民共和国 婚姻法 》 第三十二条 第二款 " 人民法院 审理 离婚 案件 ， 应当 进行 调解 ； 如 感情 确 已 破裂 ， 调解 无效 ， 应 准予 离婚 " 、 第三款 " 有 下列 情形 之一 ， 调解 无效 的 ， 应 准予 离婚 ： ...... （ 四 ） 因 感情 不 和 分居 满 二年 的 。 ...... " 、 《 中华人民共和国 民事 诉讼法 》 第 一百四十四 条 " 被告 经 传票 传唤 ， 无 正当理由 拒 不 到庭 的 ， 或者 未经 法庭 许可 中途 退庭 的 ， 可以 缺席判决 " 之 规定 ， 判决 如下 ： 

侯某某与张某某离婚纠纷案一审民事判决书.txt	依照 《 中华人民共和国 婚姻法 》 第三十二条 和 《 中华人民共和国 民事 诉讼法 》 第 一百四十四 条 、 第一百 六十条 之 规定 ， 判决 如下 ： 

傅某与汪某甲离婚纠纷一审民事判决书.txt	据此 ， 为 保护 当事人 的 合法权益 ， 维护 正常 婚姻家庭 秩序 ， 依照 《 中华人民共和国 民事 诉讼法 》 第六十四 条 和 《 最高人民法院 关于 适用 的 解释 》 第九 十条 的 规定 ， 判决 如下 ： 

兰某某与曹某某离婚纠纷民事一审民事判决书.txt	依照 《 中华人民共和国 婚姻法 》 第三十二条 第三款 " 有 下列 情形 之一 ， 调解 无效 的 ， 应 准予 离婚 ： （ 一 ） 重婚 或 有 配偶 者 与 他人 同居 的 ； （ 二 ） 实施 家庭暴力 或 虐待 、 遗弃 家庭成员 的 ； （ 三 ） 有 赌博 、 吸毒 等 恶习 屡教不改 的 ； （ 四 ） 因 感情 不 和 分居 满 二年 的 ； （ 五 ） 其他 导致 夫妻 感情破裂 的 情形 。 " 原告 没有 提供 能够 证明 有 上述 情形 之一 的 证据 来 证明 夫妻感情 确 已 破裂 的 事实 ， 故对 原告 的 离婚 请求 ， 本院 不予 支持 。 依照 《 中华人民共和国 婚姻法 》 第三十二条 第三款 、 最高人民法院 《 关于 适用 〈 中华人民共和国 婚姻法 〉 若干 问题 的 解释 （ 一 ） 》 第五条 、 最高人民法院 《 关于 适用 〈 中华人民共和国 民事 诉讼法 〉 的 解释 》 第九 十条 之 规定 ， 判决 如下 ： 

兰某某诉何某甲离婚纠纷一审民事判决书.txt	据此 ， 婚生女 由 原告 抚养 为 宜 ， 被告 应 依法 承担 子女 抚养费 。 依照 《 中华人民共和国 婚姻法 》 第三十二条 第二款 " 人民法院 审理 离婚 案件 ， 应当 进行 调解 ； 如 感情 确 已 破裂 ， 调解 无效 ， 应 准予 离婚 。 " 、 第三款 " 有 下列 情形 之一 ， 调解 无效 的 ， 应 准予 离婚 ： （ 四 ） 因 感情 不 和 分居 满 二年 的 ； " ， 第三十七条 第一款 " 离婚 后 ， 一方 抚养 的 子女 ， 另一方 应 负担 必要 的 生活费 和 教育费 的 一部 或 全部 ， 负担 费用 的 多少 和 期限 的 长短 ， 由 双方 协议 ； 协议 不成 时 ， 由 人民法院 判决 。 " 的 规定 ， 判决 如下 ： 

冉某与韩某离婚纠纷一审民事判决书.txt	依照 《 中华人民共和国 婚姻法 》 第三十二条 ， 《 最高人民法院 关于 民事诉讼 证据 的 若干 规定 》 第二条 的 规定 ， 判决 如下 ： 

冯某某与何某某离婚纠纷案一审民事判决书.txt	依照 《 中华人民共和国 婚姻法 》 第三十二条 ， 《 中华人民共和国 民事 诉讼法 》 第一百 四十二条 、 第一百 六十条 之 规定 ， 判决 如下 ： 

冯某某与侯某某离婚纠纷一案一审民事判决书.txt	据此 ， 依据 《 中华人民共和国 婚姻法 》 第三十二条 第二款 " 人民法院 审理 离婚 案件 ， 应当 进行 调解 ； 如 感情 已 破裂 ， 调解 无效 ， 应 准予 离婚 。 " 、 《 最高人民法院 关于 适用 ﹤ 中华人民共和国 婚姻法 若干 问题 的 解释 ﹥ （ 一 ） 》 第五条 第一款 " 1994 年 2 月 1 日 民政部 《 婚姻登记 管理条例 》 公布 实施 以前 ， 男女双方 已经 符合 结婚 实质 要件 的 ， 按 事实 婚姻 处理 。 " 、 《 最高人民法院 关于 人民法院 审理 未办理 结婚登记 而 以 夫妻 名义 同居 生活 案件 的 若干 规定 》 第六条 " 审理 事实 婚姻关系 的 离婚 案件 ， 应当 先 进行 调解 。 经 调解 和 好 或 撤诉 的 ， 确认 婚姻关系 有效 ， 发给 调解书 或 裁定书 ； 经 调解 不能 和 好 的 ， 应 调解 或 判决 准予 离婚 。 " 、 《 中华人民共和国 民事 诉讼法 》 第九十二 条 " 受 送达 人 下落不明 ， 或者 用 本节 规定 的 其他 方式 无法 送达 的 ， 公告送达 。 自 公告 之日起 ， 经过 六十日 ， 即 视为 送达 。 " 、 第 一百四十四 条 " 被告 经 本院 传票 传唤 ， 无 正当理由 拒 不 到庭 的 ， 或者 未经 法庭 许可 中途 退庭 的 ， 可以 缺席判决 。 " 之 规定 判决 如下 ： 

冯某某与张某某离婚纠纷案一审民事判决书.txt	根据 《 中华人民共和国 婚姻法 》 第三十二条 和 《 中华人民共和国 民事 诉讼法 》 第一百 四十二条 、 第一百 六十条 之 规定 ， 判决 如下 ： 

冯某某与曾某某离婚纠纷一审民事判决书.txt	据此 ， 依照 《 中华人民共和国 婚姻法 》 第三十二条 ， 《 最高人民法院 关于 适用 ﹤ 中华人民共和国 民事 诉讼法 ﹥ 的 解释 》 第九 十条 的 规定 ， 判决 如下 ： 

冯某某诉张甲离婚纠纷一审民事判决书.txt	依照 《 中华人民共和国 婚姻法 》 第三十二条 、 《 最高人民法院 关于 民事诉讼 证据 的 若干 规定 》 第二条 之 规定 ， 判决 如下 ： 

冯某某诉陈某某离婚纠纷一案一审民事判决书.txt	依照 《 中华人民共和国 婚姻法 》 第三十二条 、 《 中华人民共和国 民事 诉讼法 》 第一百 四十八条 之 规定 ， 判决 如下 ： 

冯某甲与曹某某离婚纠纷一审民事判决书.txt	依照 《 中华人民共和国 婚姻法 》 第三十二条 第二款 之 规定 ， 判决 如下 ： 

凌某某与凌某甲离婚纠纷一案一审民事判决书.txt	依照 《 中华人民共和国 婚姻法 》 第三十二条 第二款 " 人民法院 审理 离婚 案件 ， 应当 进行 调解 ； 如 感情 确 已 破裂 ， 调解 无效 ， 应 准予 离婚 " 和 最高人民法院 《 关于 民事诉讼 证据 的 若干 规定 》 第二条 " 当事人 对 自己 提出 的 诉讼请求 所 依据 的 事实 或者 反驳 对方 诉讼请求 所 依据 的 事实 有 责任 提供 证据 加以 证明 。 没有 证据 或者 证据 不足以 证明 当事人 的 事实 主张 的 ， 由 负有 举证责任 的 当事人 承担 不利 后果 " 之 规定 ， 判决 如下 ： 

凌某某与邱某某离婚纠纷一审民事判决书.txt	据此 认为 原 、 被告 夫妻关系 已 无 和 好 可能 ， 夫妻感情 确 已 破裂 。 原告 请求 与 被告 离婚 的 诉讼 主张 ， 理由 正当 合法 、 证据 充分 ， 本院 予以 支持 。 被告 答辩 要求 原告 返还 其 所 借款 项 ， 因 原告 称 该笔 款项 已 用于 家庭 生活 ， 被告 也 未 提供 充分 证据 予以 证明 ， 故 本案 不予认定 处理 ， 被告 可 另案 起诉 。 综上 ， 本院 依照 《 中华人民共和国 婚姻法 》 第三十二条 第二款 、 最高人民法院 《 关于 人民法院 审理 离婚 案件 如何 认定 夫妻感情 确 已 破裂 的 若干意见 》 第七条 规定 判决 如下 ： 

刘某与吴某某离婚纠纷案一审民事判决书.txt	依照 《 中华人民共和国 婚姻法 》 第三十二条 和 《 中华人民共和国 民事 诉讼法 》 第一百 四十二条 、 第一百 六十条 之 规定 ， 判决 如下 ： 

刘某与朱某离婚纠纷一审民事判决书.txt	依据 《 中华人民共和国 婚姻法 》 第三十二条 、 第三十六条 和 《 最高人民法院 》 第五条 之 规定 ， 判决 如下 ： 

刘某与牟某某离婚纠纷一审民事判决书.txt	据此 ， 依照 《 最高人民法院 关于 适用 ﹤ 中华人民共和国 民事 诉讼法 ﹥ 的 解释 》 第九 十条 之 规定 ， 判决 如下 ： 

刘某与陈某离婚纠纷一审民事判决书.txt	依照 《 中华人民共和国 婚姻法 》 第三十二条 、 第三十九 《 中华人民共和国 民事 诉讼法 》 第六十四 条 第一款 和 《 最高人民法院 关于 民事诉讼 证据 的 若干 规定 》 第二条 之 规定 ， 判决 如下 ： 

刘某某与代某某离婚纠纷一审民事判决书.txt	依照 《 中华人民共和国 婚姻法 》 第三十二条 第二款 、 第三款 的 规定 ， 判决 如下 ： 

刘某某与候某某离婚纠纷案一审民事判决书.txt	依照 《 中华人民共和国 婚姻法 》 第三十二条 和 《 中华人民共和国 民事 诉讼法 》 第一百 四十二条 、 第 一百四十四 条 之 规定 ， 判决 如下 ： 

刘某某与先某某离婚纠纷一审民事判决书.txt	据此 ， 依照 《 中华人民共和国 婚姻法 》 第三十二条 第二款 、 《 中华人民共和国 民事 诉讼法 》 第六十四 条 第一款 、 《 最高人民法院 关于 适用 〈 中华人民共和国 民事 诉讼法 〉 的 解释 》 第九 十条 第二款 之 规定 ， 判决 如下 ： 

刘某某与刘某离婚纠纷一案民事判决书.txt	依照 《 中华人民共和国 婚姻法 》 第三十二条 和 《 中华人民共和国 民事 诉讼法 》 第六十四 条 第一款 、 第 一百四十四 条 及 《 最高人民法院 关于 民事诉讼 证据 的 若干 规定 》 第二条 之 规定 ， 判决 如下 ： 

刘某某与吴某甲离婚纠纷一审民事判决书.txt	据此 ， 根据 《 中华人民共和国 婚姻法 》 第三十二条 第三款 第 （ 五 ） 项 、 第三十六条 、 第三十七条 、 《 中华人民共和国 民事 诉讼法 》 第六十四 条 第一款 、 最高人民法院 《 关于 人民法院 审理 离婚 案件 如何 认定 夫妻感情 确 已 破裂 的 若干 具体意见 》 第 7 条 、 最高人民法院 《 关于 适用 < 中华人民共和国 民事 诉讼法 > 的 解释 》 第九 十条 之 规定 ， 判决 如下 ： 

刘某某与唐某某离婚纠纷一审民事判决书.txt	据此 ， 依据 《 中华人民共和国 民事 诉讼法 》 第 一百四十四 条 、 《 中华人民共和国 婚姻法 》 第四条 、 第三十二条 第二款 之 规定 ， 判决 如下 ： 

刘某某与夏某甲离婚纠纷一审民事判决书.txt	据此 ， 依照 《 中华人民共和国 婚姻法 》 第二十六条 、 第三十二条 的 规定 ， 判决 如下 ： 

刘某某与康某离婚纠纷一审民事判决书.txt	依照 《 中华人民共和国 民事 诉讼法 》 第一百 四十二条 、 《 中华人民共和国 婚姻法 》 第三十二条 的 规定 ， 判决 如下 ： 

刘某某与张某某离婚纠纷一审民事判决书.txt	依照 《 中华人民共和国 民事 诉讼法 》 第六十四 条 第一款 、 《 最高人民法院 关于 民事诉讼 证据 的 若干 规定 》 第二条 、 《 最高人民法院 关于 适用 ﹤ 中华人民共和国 民事 诉讼法 ﹥ 的 解释 》 第九 十条 的 规定 ， 判决 如下 ： 

刘某某与李某甲离婚纠纷一审民事判决书.txt	据此 ， 依照 《 中华人民共和国 婚姻法 》 第三十二条 、 《 最高人民法院 关于 民事诉讼 证据 的 若干 规定 》 第二条 之 规定 ， 判决 如下 ： 

刘某某与李某离婚后财产纠纷一审民事判决书.txt	依照 《 中华人民共和国 婚姻法 》 第四十二条 、 《 最高人民法院 关于 适用 ﹤ 中华人民共和国 婚姻法 ﹥ 若干 问题 的 解释 （ 一 ） 》 第二十七条 之 规定 ， 判决 如下 ： 

刘某某与杜春某某离婚纠纷一审民事裁定书.txt	依照 《 中华人民共和国 民事 诉讼法 》 第六十二 条 、 第 一百四十 三条 、 第一百五十四条 第一款 （ 十一 ） 项之 规定 ， 裁定 如下 ： 

刘某某与汤某某离婚纠纷案一审民事判决书.txt	依照 《 中华人民共和国 婚姻法 》 第三十二条 、 第三十六条 、 第三十七条 、 第三十八条 、 第三十九条 、 第四十一条 ， 最高人民法院 关于 适用 《 中华人民共和国 婚姻法 》 若干 问题 的 二 ） 第十条 第一款 （ 三 ） 项 和 《 中华人民共和国 民事 诉讼法 》 第一百 四十二条 、 第一百 六十条 之 规定 ， 判决 如下 ： 

刘某某与白某某离婚纠纷案一审民事判决书.txt	依照 《 中华人民共和国 婚姻法 》 第三十二条 和 《 中华人民共和国 民事 诉讼法 》 第一百 四十二条 、 第一百 六十条 之 规定 ， 判决 如下 ： 

刘某某与赵某某离婚纠纷一审民事判决书.txt	依照 《 中华人民共和国 婚姻法 》 第十八条 第 （ 五 ） 项 、 第三十二条 第三款 第 （ 四 ） 项 、 第三十六条 、 第三十七条 第一款 、 《 最高人民法院 对 审理 离婚 案件 处理 子女 抚养 问题 的 若干 具体意见 》 第四条 、 第七条 、 第八条 、 第十一条 、 《 中华人民共和国 民事 诉讼法 》 第六十四 条 第一款 的 规定 ， 判决 如下 ： 

刘某某与阿仲某某离婚纠纷一审民事判决书.txt	据此 ， 依照 《 中华人民共和国 婚姻法 》 第三十一条 、 第三十二条 、 《 中华人民共和国 民事 诉讼法 》 第 一百四十四 条 之 规定 ， 判决 如下 ： 

刘某某与陈某甲离婚纠纷一案民事判决书.txt	依照 《 中华人民共和国 婚姻法 》 第三十二条 及 《 最高人民法院 关于 民事诉讼 证据 的 若干 规定 》 第二条 之 规定 ， 判决 如下 ： 

刘某某与陈某甲离婚纠纷案一审民事判决书.txt	根据 《 中华人民共和国 婚姻法 》 第三十二条 之 规定 ， 判决 如下 ： 

刘某某与马甲离婚纠纷一案一审民事判决书.txt	据此 ， 依照 《 中华人民共和国 婚姻法 》 第三十二条 、 《 最高人民法院 关于 适用 〈 中华人民共和国 民事 诉讼法 〉 的 解释 》 第九 十条 之 规定 ， 判决 如下 ： 

刘某某与黄某某离婚纠纷一审民事判决书.txt	根据 《 中华人民共和国 民事 诉讼法 法 》 第六十四 条 之 规定 ， 判决 如下 ： 

刘某某与黄某某离婚纠纷案一审民事判决书.txt	依照 《 中华人民共和国 婚姻法 》 第三十二条 和 《 中华人民共和国 民事 诉讼法 》 第 一百四十四 条 、 第一百 六十条 之 规定 ， 判决 如下 ： 

刘某某诉商某某离婚纠纷一审民事判决书.txt	依照 《 最高人民法院 关于 民事诉讼 证据 的 若干 规定 》 的 相关 规定 ， 当事人 对 自己 主张 的 事实 理由 及 诉讼请求 ， 有 责任 提出 证据 予以 证明 ， 本案 中 通过 原告 所 提交 的 证据 及 当庭 陈述 ， 仅 能 说明 原 、 被告 在 婚后 夫妻生活 期间 因 生活 琐事 发生 纠纷 ， 一定 程度 影响 了 夫妻感情 ， 但 并 不能 达到 证明 夫妻感情 确 已 破裂 的 目的 。 因其 亦 不 符合 其他 应当 准予 离婚 的 法定 情形 ， 故 原告 要求 离婚 的 诉讼请求 ， 本院 不予 支持 。 因此 ， 依照 《 中华人民共和国 婚姻法 》 第三十二条 ， 《 中华人民共和国 民事 诉讼法 》 第六十四 条 第一款 、 第一百 四十二条 、 第 一百四十四 条 之 规定 ， 判决 如下 ： 

刘某某诉曾某甲离婚纠纷一审民事判决书.txt	据此 ， 依照 《 中华人民共和国 婚姻法 》 第三十二条 第三款 第 （ 四 ） 项 、 第三十六条 、 第三十七条 ， 《 中华人民共和国 民事 诉讼法 》 第 一百四十四 条 之 规定 ， 判决 如下 ： 

刘某某诉李某某离婚纠纷一审民事裁定书.txt	依照 《 中华人民共和国 民事 诉讼法 》 第 一百四十 五条 第一款 、 第一百五十四条 第一款 第 （ 五 ） 项 的 规定 ， 裁定 如下 ： 

刘某某诉李某某离婚纠纷一案一审民事判决书.txt	依照 《 中华人民共和国 婚姻法 》 第四条 、 第三十二条 、 《 中华人民共和国 民事 诉讼法 》 第 一百四十四 条 之 规定 ， 判决 如下 ： 

刘某某诉查某某离婚纠纷民事一审判决书.txt	据此 ， 根据 《 中华人民共和国 婚姻法 》 第三十二条 之 规定 ， 判决 如下 ： 

刘某某诉邓某甲离婚纠纷一审民事判决书.txt	据此 ， 依照 《 中华人民共和国 婚姻法 》 第三十二条 ， 最高人民法院 《 关于 适用 ﹤ 中华人民共和国 民事 诉讼法 ﹥ 的 解释 》 第九 十条 之 规定 ， 判决 如下 ： 

刘某桃与韦某亭离婚纠纷一审民事判决书.txt	据此 ， 依照 《 中华人民共和国 婚姻法 》 第三十二条 第二款 和 《 最高人民法院 关于 人民法院 审理 离婚 案件 如何 认定 夫妻感情 确 已 破裂 的 若干 具体意见 》 第二条 之 规定 ， 判决 如下 ： 

刘某甲与曹某某离婚纠纷案一审民事判决书.txt	根据 《 中华人民共和国 婚姻法 》 第三十二条 第二款 " 人民法院 审理 离婚 案件 ， 应当 进行 调解 ； 如 感情 确 已 破裂 、 调解 无效 ， 应 准予 离婚 。 " 的 规定 ， 判决 如下 ： 

刘某甲与陶某甲离婚纠纷二审民事判决书.txt	依照 《 中华人民共和国 民事 诉讼法 》 第一百七十条 第一款 第 （ 二 ） 项 的 规定 ， 判决 如下 ： 

刘某甲与魏某某离婚纠纷一审民事判决书.txt	依照 《 中华人民共和国 婚姻法 》 第三十二条 第一 、 二 、 三款 和 最高人民法院 关于 适用 《 中华人民共和国 民事 诉讼法 》 的 解释 第九 十条 之 规定 ， 判决 如下 ： 

刘某甲诉唐某某离婚纠纷一案一审民事判决书.txt	据此 ， 依照 《 中华人民共和国 婚姻法 》 第三十二条 、 第四十二条 之 规定 ， 判决 如下 ： 

刘某诉杨某离婚纠纷一案一审民事判决书.txt	据此 ， 为 调整 社会 婚姻家庭 关系 ， 维护 婚姻 当事人 的 合法权益 ， 依照 《 中华人民共和国 婚姻法 》 第三十二条 和 《 中华人民共和国 民事 诉讼法 》 第 一百四十四 条 之 规定 ， 判决 如下 ： 

刘某诉王某某离婚纠纷一审民事判决书.txt	依照 《 中华人民共和国 婚姻法 》 第三十二条 、 第三十六条 ， 《 最高人民法院 关于 人民法院 审理 离婚 案件 如何 认定 夫妻感情 确 已 破裂 的 若干 具体意见 》 第七条 ， 《 中华人民共和国 民事 诉讼法 》 第六十四 条 、 第一百 四十二条 以及 《 最高人民法院 关于 民事诉讼 证据 的 若干 规定 》 第二条 之 规定 ， 判决 如下 ： 

刘正涵与董起赞离婚纠纷一审民事判决书.txt	依照 《 中华人民共和国 婚姻法 》 第三十二条 、 《 中华人民共和国 民事 诉讼法 》 第一百 四十二条 之 规定 ， 判决 如下 ： 

勾某某与曾某某离婚纠纷民事二审判决书.txt	依照 《 中华人民共和国 民事 诉讼法 》 第一百七十条 第一款 第 （ 一 ） 项 的 规定 ， 判决 如下 ： 

包某甲与张某甲离婚纠纷一案一审民事判决书.txt	根据 《 中华人民共和国 婚姻法 》 第十七条 " 夫妻 对 共同 所有 的 财产 ， 有 平等 的 处理权 " 、 第三十二条 第二款 " 人民法院 审理 离婚 案件 ， 应当 进行 调解 ； 如 感情 确 已 破裂 ， 调解 无效 ， 应 准予 离婚 " 、 第三十六条 " 父母 与 子女 间 的 关系 ， 不 因 父母 离婚 而 消除 。 离婚 后 ， 子女 无论 由 父 或 母 直接 抚养 ， 仍 是 父母 双方 的 子女 。 离婚 后 ， 父母 对于 子女 仍 有 抚养 和 教育 的 权利 和 义务 。 离婚 后 ， 哺乳期 内 的 子女 ， 以 随 哺乳 的 母亲 抚养 为 原则 。 哺乳期 后 的 子女 ， 如 双方 因 抚养 问题 发生争执 不能 达成协议 时 ， 由 人民法院 根据 子女 的 权益 和 双方 的 具体情况 判决 " 及 《 中华人民共和国 民事 诉讼法 》 第六十四 条 第一款 " 当事人 对 自己 的 主张 ， 有 责任 提供 证据 " 之 规定 ， 判决 如下 ： 

卓某甲与许某甲离婚纠纷一审民事判决书.txt	依据 《 中华人民共和国 婚姻法 》 第三十二条 ： 人民法院 审理 离婚 案件 ， 应该 进行 调解 ； 如 感情 确 已 破裂 ， 应 准予 离婚 。 、 《 中华人民共和国 民事 诉讼法 》 第一百 四十二条 ： 法庭 辩论 终结 ， 应当 依法 作出 判决 。 判决 前 能够 调解 的 ， 还 可以 进行 调解 ， 调解 不成 的 ， 应当 及时 判决 之 规定 ， 判决 如下 ： 

卢某某诉雷某某离婚纠纷一审民事判决书.txt	据此 ， 依照 《 中华人民共和国 民事 诉讼法 》 第六十四 条 第一款 、 《 最高人民法院 关于 民事诉讼 证据 的 若干 规定 》 第二条 之 规定 ， 判决 如下 ： 

原告任某与被告杨某离婚纠纷一案一审民事裁定书.txt	据此 ， 依照 《 中华人民共和国 婚姻法 》 第三十二条 第二款 第五项 、 第四十一条 、 最高人民法院 《 关于 人民法院 审理 离婚 案件 如何 认定 夫妻感情 确 已 破裂 的 若干 具体意见 》 第十一条 之 规定 ， 判决 如下 ： 

原告伍文容诉被告张兵离婚纠纷一案一审民事判决书.txt	据此 ， 依照 《 中华人民共和国 婚姻法 》 第三十二条 第二款 、 第三款 第 （ 四 ） 项 ， 第三十九条 ， 第四十一条 之 规定 ， 判决 如下 ： 

原告何某某与被告何某甲离婚纠纷一案一审民事判决书.txt	据此 ， 本院 依照 《 中华人民共和国 婚姻法 》 第三十二条 、 《 中华人民共和国 民事 诉讼法 》 第一百 四十二条 的 规定 ， 判决 如下 ： 

原告何某某与被告敬某甲离婚纠纷一案一审民事判决书.txt	据此 ， 依照 《 中华人民共和国 婚姻法 》 第三十二条 ， 《 中华人民共和国 民事 诉讼法 》 第一百 四十二条 的 规定 ， 判决 如下 ： 

原告何某某与被告杨某某离婚纠纷一案民事判决书.txt	据此 ， 依照 《 中华人民共和国 婚姻法 》 第三十二条 第三款 第四项 的 规定 ， 判决 如下 ： 

原告何某某与被告赵某某离婚纠纷一案一审民事判决书.txt	据此 ， 依照 《 中华人民共和国 婚姻法 》 第三十二条 第二款 人民法院 审理 离婚 案件 ， 应当 进行 调解 ， 如 感情 确 已 破裂 ， 调解 无效 ， 应 准予 离婚 、 第三十七条 离婚 后 ， 一方 抚养 子女 ， 另一方 应 负担 必要 的 生活费 和 教育费 的 一部 或 全部 ， 负担 费用 的 多少 和 期限 长短 ， 由 双方 协议 ； 协议 不成 时 ， 由 人民法院 判决 、 《 中华人民共和国 民事 诉讼法 》 第 一百四十四 条 被告 经 传票 传唤 ， 无 正当理由 拒 不 到庭 或 未经 法庭 许可 中途 退庭 的 ， 可以 缺席判决 的 规定 ， 判决 如下 ： 

原告何某某诉被告吴某甲离婚纠纷一审民事判决书.txt	据此 ， 依照 《 中华人民共和国 婚姻法 》 第三十二条 第二款 的 规定 ， 判决 如下 ： 

原告何某某诉被告吴某离婚纠纷案民事判决书.txt	依照 《 中华人民共和国 婚姻法 》 第三十二条 ， 《 中华人民共和国 民事 诉讼法 》 第六十四 条 第一款 、 第一百 四十二条 之 规定 ， 判决 如下 ： 

原告何某某诉被告郑某某离婚纠纷一审民事判决书.txt	依照 《 中华人民共和国 婚姻法 》 第三十二条 、 第三十七条 ， 判决 如下 ： 

原告何某某诉被告黄某某为离婚纠纷一案一审民事判决书.txt	依照 《 中华人民共和国 婚姻法 》 第三十二条 的 规定 ， 判决 如下 ： 

原告何某甲与被告钟某离婚纠纷一案一审民事判决书.txt	据此 ， 本院 依照 《 中华人民共和国 婚姻法 》 第三十二条 、 《 中华人民共和国 民事 诉讼法 》 第一百 四十二条 、 第 一百四十四 条 规定 ， 判决 如下 ： 

原告何某诉被告赵某离婚纠纷一审民事判决书.txt	依照 《 中华人民共和国 婚姻法 》 第三十二条 和 《 最高人民法院 关于 民事诉讼 证据 的 若干 规定 》 第二条 之 规定 ， 判决 如下 ： 

原告何某诉被告邬某某离婚纠纷一审民事判决书.txt	依照 《 中华人民共和国 婚姻法 》 第三十二条 、 第三十七条 、 第四十二条 的 规定 ， 判决 如下 ： 

原告冯某某与被告敬某某离婚纠纷一案一审民事判决书.txt	据此 ， 依照 《 中华人民共和国 婚姻法 》 第三十二条 第一款 、 《 中华人民共和国 民事 诉讼法 》 第一百 四十二条 之 规定 ， 判决 如下 ： 

原告冯某某诉被告付某某离婚纠纷一案一审民事判决书.txt	据此 ， 依照 《 中华人民共和国 婚姻法 》 第三十二条 、 第三十六条 之 规定 ， 判决 如下 ： 

原告刘某与被告巫某某离婚纠纷一审民事裁定书.txt	依照 《 中华人民共和国 民事 诉讼法 》 第 一百四十 三条 ： 原告 经 传票 传唤 ， 无 正当理由 拒 不 到庭 的 ， 或者 未经 法庭 许可 中途 退庭 的 ， 可以 按 撤诉 处理 ； 被告 反诉 的 ， 可以 缺席判决 。 之 规定 ， 裁定 如下 ： 

原告刘某某与被告张某某婚姻无效纠纷一案的民事判决书.txt	据此 ， 依照 《 中华人民共和国 婚姻法 》 第七条 第 （ 一 ） 项 、 第十条 第 （ 二 ） 项 、 第十二条 及 最高人民法院 《 关于 适用 〈 中华人民共和国 婚姻法 〉 若干 问题 的 解释 （ 一 ） 》 第九条 第一款 之 规定 ， 判决 如下 ： 

原告刘某某与被告王某某离婚纠纷一案民事裁定书.txt	依照 《 中华人民共和国 民事 诉讼法 》 第 一百四十 三条 " 原告 经 传票 传唤 ， 无 正当理由 拒 不 到庭 的 ， 或者 未经 法庭 许可 中途 退庭 的 ， 可以 按 撤诉 处理 ； 被告 反诉 的 ， 可以 缺席判决 。 " 的 规定 ， 裁定 如下 ： 

原告刘某某与被告邓某甲离婚纠纷一案一审民事判决书.txt	据此 ， 依照 《 中华人民共和国 婚姻法 》 第三十二条 ， 《 中华人民共和国 民事 诉讼法 》 第一百 四十二条 的 规定 ， 判决 如下 ： 

原告刘某某诉被告张某离婚纠纷一案的民事判决书.txt	据此 ， 为 维护 和谐 稳定 的 家庭 关系 ， 依照 《 中华人民共和国 婚姻法 》 第三十二条 之 规定 ， 判决 如下 ： 

原告刘某某诉被告谭某某离婚纠纷案一审民事判决书.txt	依照 《 中华人民共和国 婚姻法 》 第三十二条 、 第三十六条 、 第三十七条 、 《 中华人民共和国 民事 诉讼法 》 第 一百四十四 条 之 规定 ， 判决 如下 ： 

原告刘某甲与被告刘某乙离婚纠纷一案一审民事判决书.txt	据此 ， 本院 依照 《 中华人民共和国 婚姻法 》 第三十二条 、 《 中华人民共和国 民事 诉讼法 》 第一百 四十二条 、 第 一百四十四 条 的 规定 ， 判决 如下 ： 

原告刘某诉被告张某某离婚纠纷一案一审民事判决书.txt	据此 ， 依照 《 中华人民共和国 婚姻法 》 第三十二条 、 第三十九条 以及 《 中华人民共和国 民事 诉讼法 》 第 一百四十四 条 、 第一百 四十八条 之 规定 ： 

原告刘某诉被告肖某离婚纠纷一案一审民事判决书.txt	据此 ， 为 保护 当事人 合法权益 ， 依照 《 中华人民共和国 婚姻法 》 第三十二条 ， 《 中华人民共和国 民事 诉讼法 》 第六十四 条 第一款 、 第 一百四十四 条 之 规定 ， 缺席判决 如下 ： 

原告刘桂华诉被告曾义财离婚纠纷一案民事判决书.txt	据此 ， 依照 《 中华人民共和国 婚姻法 》 第三十二条 第二款 ， 《 中华人民共和国 民事 诉讼法 》 第 一百四十四 条 " 被告 经 传票 传唤 ， 无 正当理由 拒 不 到庭 的 ， 或者 未经 法院 许可 中途 退庭 的 ， 可以 缺席判决 。 " ， 以及 《 最高人民法院 关于 适用 ﹤ 中华人民共和国 民事 诉讼法 ﹥ 的 解释 》 第九 十条 之 规定 ， 判决 如下 ： 

原告华某诉被告彭某某离婚纠纷案一审判决书.txt	据此 ， 依照 《 中华人民共和国 婚姻法 》 第三十二条 、 《 中华人民共和国 民事 诉讼法 》 第六十四 条 第一款 以及 最高人民法院 《 关于 适用 ﹤ 中华人民共和国 民事 诉讼法 ﹥ 的 解释 》 第九 十条 第一款 的 规定 ， 判决 如下 ： 

原告卢某某与被告江某某离婚纠纷一案民事判决书.txt	据此 ， 依照 《 中华人民共和国 婚姻法 》 第三十二条 第二款 、 第三款 第四项 之 规定 ， 判决 如下 ： 

原告向某某诉被告税某甲离婚纠纷一审民事判决书.txt	依照 《 中华人民共和国 婚姻法 》 第三十二条 的 规定 ， 判决 如下 ： 

原告吴某某与被告向某甲离婚纠纷一审民事判决书.txt	依照 《 中华人民共和国 婚姻法 》 第三十二条 的 规定 ， 判决 如下 ： 

原告吴某某与被告吴某甲离婚纠纷一案一审民事判决书.txt	据此 ， 依照 《 中华人民共和国 婚姻法 》 第三十二条 、 《 中华人民共和国 民事 诉讼法 》 第一百 四十二条 之 规定 ， 判决 如下 ： 

原告吴某某与被告魏某某离婚纠纷一案的民事判决书.txt	依照 《 中华人民共和国 婚姻法 》 第四条 、 第二十条 、 第三十二条 之 规定 ， 判决 如下 ： 

原告吴某某诉被告张某某离婚纠纷一审民事判决书.txt	依据 《 中华人民共和国 婚姻法 》 第三十二条 之 规定 ， 判决 如下 ： 

原告吴腾英与被告岳瑞亭离婚纠纷一案民事判决书.txt	据此 ， 依照 《 中华人民共和国 婚姻法 》 第三十二 ， 《 最高人民法院 关于 适用 〈 中华人民共和国 民事 诉讼法 〉 的 解释 》 第九 十条 之 规定 ， 判决 如下 ： 

原告周某某与被告于某某离婚纠纷一案民事判决书.txt	据此 ， 依照 《 中华人民共和国 婚姻法 》 第三十二条 第二款 、 第三款 、 第三十七条 第一款 之 规定 ， 判决 如下 ： 

原告周某某与被告张某某离婚纠纷案一审民事判决书.txt	根据 《 中华人民共和国 婚姻法 》 第三十二条 、 《 最高人民法院 关于 民事诉讼 证据 的 若干 规定 》 第二条 之 规定 ， 判决 如下 ： 

原告周某某诉被告罗某某离婚纠纷案一审民事判决书.txt	依照 《 中华人民共和国 婚姻法 》 第三十二条 ， 《 中华人民共和国 民事 诉讼法 》 第六十四 条 第一款 ， 《 最高人民法院 关于 适用 ﹤ 中华人民共和国 民事 诉讼法 ﹥ 的 解释 》 第九 十条 的 规定 ， 判决 如下 ： 

原告唐某某与被告张某甲离婚纠纷案一审民事判决书.txt	依照 《 中华人民共和国 婚姻法 》 第三十二条 、 《 最高人民法院 关于 民事诉讼 证据 的 若干 规定 》 第二条 之 规定 ， 判决 如下 ： 

原告唐某某诉被告张某某为离婚纠纷一案一审民事判决书.txt	依照 《 中华人民共和国 婚姻法 》 第三十二条 的 规定 ， 判决 如下 ： 

原告唐某某诉被告王某某离婚纠纷一案一审民事判决书.txt	依照 《 中华人民共和国 婚姻法 》 第三十一条 、 第三十二条 、 第四十二条 、 第四十六 条 ， 《 中华人民共和国 民事 诉讼法 》 第六十四 条 、 第一百三十四条 之 规定 ， 判决 如下 ： 

原告喻某某诉被告李某某为离婚纠纷一案一审民事判决书.txt	依照 《 中华人民共和国 婚姻法 》 第三十二条 的 规定 ， 判决 如下 ： 

原告夏某某诉被告陈某离婚纠纷案一审民事判决书.txt	依据 《 中华人民共和国 婚姻法 》 第三十二条 第二款 、 《 中华人民共和国 民事 诉讼法 》 第六十四 条 第一款 之 规定 ， 判决 如下 ： 

原告姚某某诉被告刘某某离婚纠纷一案民事判决书.txt	据此 ， 依照 《 中华人民共和国 婚姻法 》 第三十二条 、 《 中华人民共和国 民事 诉讼法 》 第一百 四十二条 、 第 一百四十四 条 、 第一百五十二条 之 规定 ， 判决 如下 ： 

原告姜某某诉被告赵某某为离婚纠纷一案一审民事判决书.txt	依照 《 中华人民共和国 婚姻法 》 第三十二条 的 规定 ， 判决 如下 ： 

原告孔某某与被告顾某某离婚纠纷民事一审判决书.txt	根据 《 中华人民共和国 婚姻法 》 第三十二条 以及 《 中华人民共和国 民事 诉讼法 》 第六十四 条 之 规定 ， 判决 如下 ： 

原告孙某某诉被告徐某某离婚纠纷民事判决书.txt	依据 《 中华人民共和国 婚姻法 》 第三十二条 之 规定 ， 判决 如下 ： 

原告孙某诉被告邱某离婚纠纷一案一审民事判决书.txt	据此 ， 依照 《 中华人民共和国 婚姻法 》 第三十二条 第二款 第五项 、 第四十一条 、 最高人民法院 《 关于 人民法院 审理 离婚 案件 如何 认定 夫妻感情 确 已 破裂 的 若干 具体意见 》 第七条 、 《 中华人民共和国 民事 诉讼法 》 第六十四 条 第一款 之 规定 ， 判决 如下 ： 

原告岳晨与被告周勇离婚纠纷一案民事判决书.txt	根据 《 中华人民共和国 民事 诉讼法 》 第六十四 条 规定 ， 当事人 对 自己 提出 的 主张 ， 有 责任 提供 证据 。 故 原告 岳某 要求 与 被告 周某 甲 离婚 及 关于 子女 抚养 的 诉讼 主张 因 证据不足 ， 本院 不予 支持 。 综上所述 ， 根据 《 中华人民共和国 婚姻法 》 第三十二条 ， 《 中华人民共和国 民事 诉讼法 》 第六十四 条 ， 最高人民法院 《 关于 民事诉讼 证据 的 若干 规定 》 第六十九条 第一款 第 （ 二 ） 项之 规定 ， 判决 如下 ： 

原告张XX诉被告陈XX离婚纠纷一案一审民事判决书.txt	据此 ， 依照 《 中华人民共和国 婚姻法 》 第三十二条 、 第四十二条 之 规定 ， 判决 如下 ： 

原告张某与被告李某某离婚纠纷民事一审裁定书.txt	依照 《 中华人民共和国 民事 诉讼法 》 第 一百四十 三条 之 规定 ， 裁定 如下 ： 

原告张某某与被告万某离婚纠纷一审民事判决书.txt	据此 ， 根据 《 中华人民共和国 婚姻法 》 第三十二条 、 第三十七条 、 第三十八条 、 《 中华人民共和国 民事 诉讼法 》 第十三条 、 第六十四 条 之 规定 ， 判决 如下 ： 

原告张某某与被告彭某某离婚纠纷一案一审民事判决书.txt	据此 ， 依照 《 中华人民共和国 婚姻法 》 第三十二条 第二款 、 《 中华人民共和国 民事 诉讼法 》 第一百 四十二条 之 规定 ， 判决 如下 ： 

原告张某某与被告方某某“离婚纠纷”一案民事判决书.txt	据此 可 证明 原 、 被告 婚后 前期 的 夫妻关系 较 好 。 后原 、 被告 因 生活 琐事 ， 夫妻 产生矛盾 ， 2011 年 被告 便 离开 原告 及 女 ， 双方 互不 往来 和 履行 夫妻 义务 ， 现 被告 又 与 他人 同居 生活 并 生育 子女 ， 被告 的 行为 已 严重 伤害 了 原 、 被告 之间 的 夫妻感情 确 ， 夫妻关系 现已 名存实亡 ， 夫妻感情 已 破裂 ， 原告 要求 与 被告 离婚 ， 符合 法律 规定 ， 依法 予以 支持 。 婚生女 在 被告 离开 后 ， 长期 随 原告 生活 ， 被告 也 同意 婚生女 随 原告 生活 ， 根据 本案 实际 ， 随 原告 生活 为 宜 ， 依法 被告 享有 探望 权 。 原告 抚养 子女 ， 依法 被告 应 支付 抚养费 ， 原告 自愿 不要 被告 支付 抚养费 ， 是 当事人 对 自己 权利 的 处分 ， 不 违背 法律 规定 ， 应予以 准许 。 被告 虽 辩称 其 患有 精神 并 要求 原告 医治 和 有 夫妻 共同 债务 500 元 、 要求 原告 承担 的 主张 ， 但 均 未 向 法庭 提供 证据 予以 证明 ， 对 被告 的 辩称 主张 依法 不予 支持 。 为 保护 当事人 的 合法权益 ， 根据 《 中华人民共和国 婚姻法 》 第三十二条 第二款 、 第三十六条 、 第三十七条 、 第三十八条 的 规定 ， 判决 如下 ： 

原告张某某与被告王某甲离婚纠纷一案一审民事判决书.txt	据此 ， 依照 《 中华人民共和国 婚姻法 》 第三十二条 、 第三十六条 、 第三十七条 、 第三十八条 的 规定 ， 判决 如下 ： 

原告张某某与被告缪某某离婚纠纷一案民事判决书.txt	据此 ， 依照 《 中华人民共和国 婚姻法 》 第三十二条 第二款 " 人民法院 审理 离婚 案件 ， 应当 进行 调解 ； 如 感情 确 已 破裂 ， 调解 无效 ， 应 准予 离婚 。 " 的 规定 ， 判决 如下 ： 

原告张某某诉被告代某甲离婚纠纷案一审民事判决书.txt	依照 《 中华人民共和国 婚姻法 》 第三十二条 、 《 中华人民共和国 民事 诉讼法 》 第六十四 条 第一款 及 《 最高人民法院 关于 民事诉讼 证据 的 若干 规定 》 第二条 的 规定 ， 判决 如下 ： 

原告张某某诉被告刘某甲离婚纠纷一案一审民事判决书.txt	据此 ， 依照 《 中华人民共和国 婚姻法 》 第三十二条 、 第三十六条 、 第三十七条 、 第三十八条 之 规定 ， 判决 如下 ： 

原告张某某诉被告曹某离婚纠纷一审民事判决书.txt	被告 曹某 经 本院 传唤 未 到庭 参加 诉讼 ， 依据 前述 法律 及 《 中华人民共和国 民事 诉讼法 》 第 一百四十四 条 之 规定 ， 判决 如下 ： 

原告张某某诉被告李某某离婚纠纷一审民事判决书.txt	依照 《 中华人民共和国 婚姻法 》 第三十二条 的 规定 ， 判决 如下 ： 

原告张某某诉被告李某某离婚纠纷案民事判决书.txt	依照 《 中华人民共和国 婚姻法 》 第三十二条 ， 《 中华人民共和国 民事 诉讼法 》 第六十四 条 第一款 、 第一百 四十二条 之 规定 ， 判决 如下 ： 

原告张某某诉被告滕某某“离婚纠纷”一案民事判决书.txt	依照 《 中华人民共和国 婚姻法 》 第三十二条 、 第三十六条 、 第三十七条 、 第三十八条 、 第四十二条 的 规定 ， 判决 如下 ： 

原告张某某诉被告王甲离婚纠纷一审民事判决书.txt	据此 ， 依照 《 中华人民共和国 婚姻法 》 第三十二条 第二款 ： " 人民法院 审理 离婚 案件 ， 应当 进行 调解 ， 如 感情 确 已 破裂 ， 调解 无效 ， 应 准予 离婚 " 之 规定 ， 判决 如下 ： 

原告张某某诉被告赵某某离婚纠纷一案一审民事判决书.txt	依照 《 中华人民共和国 婚姻法 》 第三十二条 第二款 " 人民法院 审理 离婚 案件 ， 应当 进行 调解 ， 如 感情 确 已 破裂 ， 调解 无效 ， 应 准予 离婚 " 、 《 最高人民法院 关于 民事诉讼 证据 的 若干 规定 》 第二条 " 当事人 对 自己 提出 的 诉讼请求 所 依据 的 事实 或者 反驳 对方 诉讼请求 所 依据 的 事实 有 责任 提供 证据 加以 证明 。 没有 证据 或者 证据 不足以 证明 当事人 的 事实 主张 的 ， 由 负有 举证责任 的 当事人 承担 不利 后果 " 之 规定 ， 判决 如下 ： 

原告张某甲与被告张某乙离婚纠纷撤诉民事裁定书.txt	依照 《 中华人民共和国 民事 诉讼法 》 第 一百四十 五条 、 第一百五十四条 之 规定 ， 裁定 如下 ： 

原告彭某与被告严某离婚纠纷一案的民事判决书.txt	依照 《 中华人民共和国 婚姻法 》 第三十二条 、 第三十六条 、 第三十七条 、 第三十八条 ， 《 中华人民共和国 民事 诉讼法 》 第一百五十 三条 之 规定 ， 判决 如下 ： 

原告彭某某诉被告金某某离婚纠纷案一审判决书.txt	根据 《 中华人民共和国 民事 诉讼法 》 第六十四 条 第一款 以及 最高人民法院 《 关于 适用 ﹤ 中华人民共和国 民事 诉讼法 ﹥ 的 解释 》 第九 十条 第一款 之 规定 ， 判决 如下 ： 

原告彭某诉被告晏某离婚纠纷一案一审判决书.txt	据此 ， 依照 《 中华人民共和国 婚姻法 》 第三十二条 ， 《 中华人民共和国 民事 诉讼法 》 第六十四 条 第一款 ， 最高人民法院 《 关于 适用 ﹤ 中华人民共和国 民事 诉讼法 ﹥ 的 解释 》 第九 十条 之 规定 ， 判决 如下 ： 

原告彭某诉被告马某某离婚纠纷一案的民事判决书.txt	据此 ， 为 保护 当事人 合法权益 ， 依照 《 中华人民共和国 婚姻法 》 第三十二条 、 第三十六条 、 第三十七条 、 第三十八条 、 《 中华人民共和国 民事 诉讼法 》 第 一百四十四 条 之 规定 ， 判决 如下 ： 

原告徐某某与被告张某某离婚纠纷一审民事判决书.txt	据此 ， 为 维护 家庭 稳定 ， 依照 《 中华人民共和国 婚姻法 》 第三十二条 及 《 最高人民法院 关于 民事诉讼 证据 的 若干 规定 》 第二条 之 规定 ， 判决 如下 ： 

原告徐某某与被告王某某离婚纠纷一案民事判决书.txt	据此 ， 依照 《 中华人民共和国 婚姻法 》 第三十二条 第二款 " 人民法院 审理 离婚 案件 ， 应当 进行 调解 ； 如 感情 确 已 破裂 ， 调解 无效 ， 应 准予 离婚 。 " 的 规定 ， 判决 如下 ： 

原告徐某某与被告邵某某离婚纠纷一审民事判决书.txt	依照 《 中华人民共和国 婚姻法 》 第三十二条 的 规定 ， 判决 如下 ： 

原告徐某某诉被告张某某离婚纠纷一审民事判决书.txt	依照 《 中华人民共和国 婚姻法 》 第三十二条 、 第三十七条 的 规定 ， 判决 如下 ： 

原告文某诉被告郑某某离婚纠纷一审民事判决书.txt	依照 《 中华人民共和国 婚姻法 》 第三十二条 的 规定 ， 判决 如下 ： 

原告晏某某诉被告李某某离婚纠纷一审民事判决书.txt	依照 《 中华人民共和国 婚姻法 》 第三十二条 和 《 最高人民法院 关于 民事诉讼 证据 的 若干 规定 》 第二条 之 规定 ， 判决 如下 ： 

原告曾强与被告蒋青容离婚后财产纠纷一案民事判决书.txt	据此 ， 依照 《 中华人民共和国 民法通则 》 第八 十四条 " 债 是 按照 合同 的 约定 或者 依照 法律 的 规定 ， 在 当事人 之间 产生 的 特定 的 权利 和 义务 关系 。 享有 权利 的 人 是 债权人 ， 负有 义务 的 人 是 债务人 。 债权人 有权 要求 债务人 按照 合同 的 约定 或者 依照 法律 的 规定 履行义务 。 " 第 一百零八 条 " 债务 应当 清偿 。 暂时 无力 偿还 的 ， 经 债权人 同意 或者 人民法院 裁决 ， 可以 由 债务人 分期 偿还 。 有 能力 偿还 拒 不 偿还 的 ， 由 人民法院 判决 强制 偿还 。 " 之 规定 ， 判决 如下 ： 

原告曾某某诉被告陈某甲离婚纠纷一审民事判决书.txt	依照 《 中华人民共和国 婚姻法 》 第三十二条 的 规定 ， 判决 如下 ： 

原告朱某某诉被告勾某某离婚纠纷一审民事判决书.txt	依照 《 中华人民共和国 民事 诉讼法 》 第 一百四十四 条 " 被告 经 传票 传唤 ， 无 正当理由 拒 不 到庭 的 ， 或者 未经 法庭 许可 中途 退庭 的 ， 可以 缺席判决 " 之 规定 ， 判决 如下 ： 

原告李世勇与被告陶凤娟离婚纠纷一案一审裁定书.txt	依照 《 中华人民共和国 民事 诉讼法 》 第 一百四十 三条 的 规定 ， 裁定 如下 ： 

原告李伟诉被告黄小英离婚纠纷一案一审民事判决书.txt	据此 ， 依照 《 中华人民共和国 婚姻法 》 第三十二条 、 第三十九条 第一款 ， 《 最高人民法院 关于 人民法院 审理 离婚 案件 处理 财产 分割 问题 的 若干 具体意见 》 第 8 条 之 规定 ， 判决 如下 ： 

原告李某与被告徐某离婚纠纷民事一审判决书.txt	依照 《 中华人民共和国 婚姻法 》 第三十二条 、 第三十六条 之 规定 ， 判决 如下 ： 

原告李某某与被告周某离婚纠纷一案一审民事判决书.txt	依照 《 中华人民共和国 婚姻法 》 第三十二条 第三款 第 （ 五 ） 项 ， 《 中华人民共和国 民事 诉讼法 》 第 一百四十四 条 之 规定 ， 缺席判决 如下 ： 

原告李某某与被告唐某某离婚纠纷一案一审民事判决书.txt	据此 ， 依照 《 中华人民共和国 婚姻法 》 第三十二条 、 《 中华人民共和国 民事 诉讼法 》 第一百 四十二条 的 规定 ， 判决 如下 ： 

原告李某某与被告李某甲离婚纠纷一案一审民事判决书.txt	据此 ， 依照 《 中华人民共和国 婚姻法 》 第三十二条 、 《 中华人民共和国 民事 诉讼法 》 第一百 四十二条 的 规定 ， 判决 如下 ： 

原告李某某与被告梁某某离婚纠纷一案民事判决书.txt	据此 ， 依照 《 中华人民共和国 婚姻法 》 第三十二条 第二款 、 第三十九条 第一款 、 《 最高人民法院 关于 适用 〈 中华人民共和国 婚姻法 〉 若干 问题 的 解释 （ 三 ） 》 第十三条 、 的 规定 ， 判决 如下 ： 

原告李某某与被告蒋某某离婚纠纷一案民事判决书.txt	据此 ， 依照 《 中华人民共和国 婚姻法 》 第三十二条 第二款 、 第三款 第四项 的 规定 ， 判决 如下 ： 

原告李某某与被告陈某离婚纠纷一案一审民事判决书.txt	据此 ， 依照 《 中华人民共和国 婚姻法 》 第二十一条 、 第三十二条 、 第三十七条 、 第四十一条 、 最高人民法院 关于 适用 《 中华人民共和国 婚姻法 》 若干 问题 的 解释 （ 二 ） 第二十四条 、 《 中华人民共和国 民事 诉讼法 》 第一百 四十二条 之 规定 ， 判决 如下 ： 

原告李某某与被告魏某某离婚纠纷一案一审民事判决书.txt	据此 ， 依照 《 中华人民共和国 婚姻法 》 第三十二条 第三款 第 （ 四 ） 项 、 第四十条 ； 《 中华人民共和国 民事 诉讼法 》 第 一百四十四 条 的 规定 ， 判决 如下 ： 

原告李某某与被告龙某某离婚纠纷一审民事裁定书.txt	依照 《 中华人民共和国 民事 诉讼法 》 第 一百四十 三条 ： 原告 经 传票 传唤 ， 无 正当理由 拒 不 到庭 的 ， 或者 未经 法庭 许可 中途 退庭 的 ， 可以 按 撤诉 处理 ； 被告 反诉 的 ， 可以 缺席判决 。 之 规定 ， 裁定 如下 ： 

原告李某某诉被告张某某离婚纠纷案一审判决书.txt	据此 ， 依照 《 中华人民共和国 婚姻法 》 第三十二条 、 《 中华人民共和国 民事 诉讼法 》 第六十四 条 第一款 以及 最高人民法院 《 关于 适用 ﹤ 中华人民共和国 民事 诉讼法 ﹥ 的 解释 》 第九 十条 第一款 的 规定 ， 判决 如下 ： 

原告李某某诉被告罗某某离婚纠纷一案一审民事判决书.txt	依照 《 中华人民共和国 婚姻法 》 第三十二条 第二款 " 人民法院 审理 离婚 案件 ， 应当 进行 调解 ， 如 感情 确 已 破裂 ， 调解 无效 ， 应 准予 离婚 " 、 《 最高人民法院 关于 民事诉讼 证据 的 若干 规定 》 第二条 " 当事人 对 自己 提出 的 诉讼请求 所 依据 的 事实 或者 反驳 对方 诉讼请求 所 依据 的 事实 有 责任 提供 证据 加以 证明 。 没有 证据 或者 证据 不足以 证明 当事人 的 事实 主张 的 ， 由 负有 举证责任 的 当事人 承担 不利 后果 " 之 规定 ， 判决 如下 ： 

原告李某甲与被告廖某某离婚纠纷一案一审民事判决书.txt	据此 ， 依照 《 中华人民共和国 婚姻法 》 第三十二条 ， 《 中华人民共和国 民事 诉讼法 》 第一百 四十二条 的 规定 ， 判决 如下 ： 

原告李某诉被告李某某“离婚纠纷”一案民事判决书.txt	依照 《 中华人民共和国 婚姻法 》 第三十二条 、 第三十六条 、 第三十七条 、 第三十八条 的 规定 ， 判决 如下 ： 

原告李某诉被告詹某甲离婚纠纷一案一审判决书.txt	据此 ， 依照 《 中华人民共和国 婚姻法 》 第三十二条 第二款 、 第三十七条 、 第三十九 之 规定 ， 判决 如下 ： 

原告杜某某与被告汪某某离婚纠纷一案一审民事判决书.txt	据此 ， 依照 《 中华人民共和国 婚姻法 》 第三十二条 第二款 、 第三款 第二项 、 第三十六条 第一款 、 第三十七条 ， 《 中华人民共和国 民事 诉讼法 》 第一百 四十二条 之 规定 ， 判决 如下 ： 

原告杜某某与被告蒲某某离婚纠纷一案一审民事判决书.txt	据此 ， 根据 《 中华人民共和国 婚姻法 》 第三十二条 第二款 第五项 、 《 中华人民共和国 民事 诉讼法 》 第一百 四十二条 之 规定 ， 判决 如下 ： 

原告杜某某诉被告朱某甲离婚纠纷一审民事判决书.txt	依据 《 中华人民共和国 婚姻法 》 第三十二条 的 规定 ， 判决 如下 ： 

原告杨利诉被告吴井勇离婚纠纷一审民事判决书.txt	据此 ， 依照 《 中华人民共和国 婚姻法 》 第三十二条 第二款 的 规定 ， 判决 如下 ： 

原告杨子让诉被告饶建华离婚纠纷一案民事判决书.txt	据此 ， 依照 《 中华人民共和国 婚姻法 》 第三十二条 三款 （ 四 ） 项之 规定 ， 判决 如下 ： 

原告杨某某与被告李某某离婚纠纷一案一审民事判决书.txt	据此 ， 依照 《 中华人民共和国 婚姻法 》 第三十二条 、 《 中华人民共和国 民事 诉讼法 》 第一百 四十二条 的 规定 ， 判决 如下 ： 

原告杨某某与被告陈某某离婚纠纷一案一审民事判决书.txt	依据 《 中华人民共和国 婚姻法 》 第三十二条 和 《 中华人民共和国 民事 诉讼法 》 第一百 四十二条 、 第 一百四十四 条 的 规定 ， 判决 如下 ： 

原告杨某某诉被告夏某某离婚纠纷一案一审民事判决书.txt	据此 ， 依照 《 中华人民共和国 婚姻法 》 第三十二条 第二款 、 《 中华人民共和国 民事 诉讼法 》 第六十四 条 第一款 、 最高人民法院 《 关于 适用 ﹤ 中华人民共和国 民事 诉讼法 ﹥ 的 解释 》 第九 十条 之 规定 ， 判决 如下 ： 

原告杨某某诉被告张某某离婚纠纷一审民事判决书.txt	据此 ， 依照 《 中华人民共和国 婚姻法 》 第三十二条 第二款 ： " 人民法院 审理 离婚 案件 ， 应当 进行 调解 ， 如 感情 确 已 破裂 ， 调解 无效 ， 应 准予 离婚 " 之 规定 ， 判决 如下 ： 

原告杨某某诉被告赵某某离婚纠纷一案一审民事判决书.txt	依照 《 中华人民共和国 婚姻法 》 第三十二条 第二款 、 第四十六 条 ， 《 中华人民共和国 民事 诉讼法 》 第六十四 条 ， 《 最高人民法院 关于 适用 ﹤ 中华人民共和国 民事 诉讼法 ﹥ 的 解释 》 第九 十条 之 规定 ， 判决 如下 ： 

原告杨某某诉被告马某某“离婚纠纷”一案民事判决书.txt	依照 《 中华人民共和国 婚姻法 》 第三十二 的 规定 ， 判决 如下 ： 

原告查某某诉被告包某甲离婚纠纷一审民事判决书.txt	依照 《 中华人民共和国 婚姻法 》 第三十二条 第二款 、 第三款 第 （ 四 ） 项 及 第三十七条 第一款 的 规定 ， 判决 如下 ： 

原告梁某某诉被告张某甲离婚纠纷案一审民事判决书.txt	依照 《 中华人民共和国 婚姻法 》 第三十二条 、 《 中华人民共和国 民事 诉讼法 》 第六十四 条 及 《 最高人民法院 关于 民事诉讼 证据 的 若干 规定 》 第二条 之 规定 ， 判决 如下 ： 

原告江某某与被告杨某某离婚纠纷一案一审民事判决书.txt	据此 ， 本院 依照 《 中华人民共和国 婚姻法 》 第三十二条 、 《 中华人民共和国 民事 诉讼法 》 第一百 四十二条 之 规定 ， 判决 如下 ： 

原告汪某某诉被告何某某为离婚纠纷一案一审民事判决书.txt	依照 《 中华人民共和国 婚姻法 》 第三十二条 的 规定 ， 判决 如下 ： 

原告汪某某诉被告曾某某离婚纠纷一案一审民事判决书.txt	依照 《 中华人民共和国 婚姻法 》 第三十二条 与 《 中华人民共和国 民事 诉讼法 》 第一百 四十八条 之 规定 ， 判决 如下 ： 

原告沈某诉被告范某某离婚纠纷一审民事判决书.txt	依照 《 中华人民共和国 婚姻法 》 第三十二条 的 规定 ， 判决 如下 ： 

原告泉某某与被告李某某离婚纠纷一案一审民事判决书.txt	据此 本院 认定 原 、 被告 双方 感情 尚未 完全 破裂 。 原告 泉 某某 提出 离婚 的 诉讼请求 ， 本院 不予 支持 。 为 维护 婚姻家庭 的 和谐 稳定 ， 依照 《 中华人民共和国 婚姻法 》 第三十二条 之 规定 ， 判决 如下 ： 

原告涂某某与被告邓某某离婚纠纷一案一审民事判决书.txt	据此 ， 依照 《 中华人民共和国 婚姻法 》 第三十二条 、 《 中华人民共和国 民事 诉讼法 》 第一百 四十二条 的 规定 ， 判决 如下 ： 

原告熊某某与被告曾某某离婚纠纷一案民事判决书.txt	据此 ， 依照 《 中华人民共和国 婚姻法 》 第三十二条 第二款 、 第三款 之 规定 ， 判决 如下 ： 

原告熊某某诉被告何某某离婚纠纷一审民事判决书.txt	依照 《 中华人民共和国 婚姻法 》 第三十二条 ， 《 关于 人民法院 审理 离婚 案件 如何 认定 夫妻感情 确 已 破裂 的 若干 具体意见 》 第 7 条 的 规定 ， 判决 如下 ： 

原告熊某某诉被告唐某甲离婚纠纷一案一审民事判决书.txt	依照 《 中华人民共和国 婚姻法 》 第三十二条 、 第三十六条 之 规定 ， 判决 如下 ： 

原告王XX诉被告戴XX离婚纠纷一案一审民事判决书.txt	据此 ， 依照 《 中华人民共和国 婚姻法 》 第三十二条 第三款 第四项 之 规定 ， 判决 如下 ： 

原告王X诉被告吴XX离婚纠纷一案一审民事判决书.txt	据此 ， 依照 《 中华人民共和国 婚姻法 》 第三十二条 第三款 第 （ 五 ） 项 、 第三十六条 、 第三十七条 ， 最高人民法院 《 关于 人民法院 审理 离婚 案件 如何 认定 夫妻感情 确 已 破裂 的 若干 具体意见 》 第 7 条 、 最高人民法院 《 关于 人民法院 审理 离婚 案件 处理 子女 抚养 问题 的 若干 具体意见 》 第 5 条 、 最高人民法院 《 关于 适用 ﹤ 中华人民共和国 婚姻法 ﹥ 若干 问题 的 解释 》 （ 二 ） 第二十一条 之 规定 ， 判决 如下 ： 

原告王凤兰诉被告胡贵云离婚后财产纠纷一案一审民事判决书.txt	据此 ， 依照 《 中华人民共和国 合同法 》 第六十条 、 第一百零九条 ， 《 中华人民共和国 民法通则 》 第八 十四条 、 第 一百零八 条 之 规定 ， 判决 如下 ： 

原告王婷与被告何毅离婚纠纷一案民事判决书.txt	据此 ， 《 中华人民共和国 婚姻法 》 第三十二条 ， 《 中华人民共和国 民事 诉讼法 》 第六十四 条 ， 第之 规定 ， 判决 如下 ： 

原告王某与被告叶某甲离婚纠纷一审民事判决书.txt	据此 ， 依照 《 中华人民共和国 婚姻法 》 第三十二条 、 第三十七条 、 第三十八条 、 第三十九条 、 《 中华人民共和国 民事 诉讼法 》 第六十四 条 之 规定 ， 判决 如下 ： 

原告王某与被告张某离婚纠纷一审民事判决书.txt	根据 《 中华人民共和国 婚姻法 》 第三十二条 以及 《 中华人民共和国 民事 诉讼法 》 第六十四 条 之 规定 ， 判决 如下 ： 

原告王某与被告马某甲离婚纠纷一案一审民事判决书.txt	据此 ， 根据 《 中华人民共和国 婚姻法 》 第三十二条 " 人民法院 审理 离婚 案件 ， 应当 进行 调解 ； 如 感情 确 已 破裂 ， 调解 无效 ， 应 准予 离婚 " 、 《 最高人民法院 关于 民事诉讼 证据 的 若干意见 》 第二条 " 当事人 对 自己 提出 的 诉讼请求 所 依据 的 事实 或者 反驳 对方 诉讼请求 所 依据 的 事实 有 责任 提供 证据 加以 证明 。 没有 证据 或者 证据 不足以 证明 当事人 的 事实 主张 的 ， 由 负有 举证责任 的 当事人 承担 不利 后果 。 " 《 中华人民共和国 民事 诉讼法 》 第 一百四十四 条 之 规定 ， 判决 如下 ： 

原告王某某与被告何某某离婚纠纷一审民事判决书.txt	依照 《 中华人民共和国 婚姻法 》 第三十二条 、 第三十九条 ， 《 中华人民共和国 民事 诉讼法 》 第六十四 条 之 规定 ， 判决 如下 ： 

原告王某某与被告寇某某离婚纠纷一案一审民事判决书.txt	依据 《 中华人民共和国 婚姻法 》 第三十二条 、 第三十六条 、 第三十七条 和 《 中华人民共和国 民事 诉讼法 》 第 一百四十四 条 的 规定 ， 判决 如下 ： 

原告王某某与被告张某某离婚纠纷一案一审民事判决书.txt	据此 ， 依照 《 中华人民共和国 婚姻法 》 第三十二条 、 《 中华人民共和国 民事 诉讼法 》 第一百 四十二条 的 规定 ， 判决 如下 ： 

原告王某某与被告敬某某离婚纠纷一案一审民事判决书.txt	据此 ， 依照 《 中华人民共和国 婚姻法 》 第三十二条 、 《 中华人民共和国 民事 诉讼法 》 第一百 四十二条 的 规定 ， 判决 如下 ： 

原告王某诉被告欧某某离婚纠纷一案一审民事判决书.txt	据此 ， 为 保护 双方 当事人 的 合法权益 ， 依照 《 中华人民共和国 婚姻法 》 第三十二条 、 《 中华人民共和国 民事 诉讼法 》 第六十四 条 第一款 之 规定 ， 判决 如下 ： 

原告秦某诉被告陈某离婚纠纷一案一审民事判决书.txt	依照 《 中华人民共和国 婚姻法 》 第三十二条 、 《 中华人民共和国 民事 诉讼法 》 第一百 四十八条 之 规定 ， 判决 如下 ： 

原告罗某某诉被告刘某某离婚纠纷一案的民事判决书.txt	依据 《 中华人民共和国 婚姻法 》 第三十二条 、 第三十九条 、 第四十二条 之 规定 ， 判决 如下 ： 

原告罗泽辉诉被告高长江离婚纠纷一案民事判决书.txt	据此 ， 依照 《 中华人民共和国 婚姻法 》 第三十二条 第二款 、 《 最高人民法院 关于 适用 ﹤ 中华人民共和国 民事 诉讼法 ﹥ 的 解释 》 第九 十条 之 规定 ， 判决 如下 ： 

原告罗秀英诉被告王雪峰离婚纠纷一案民事判决书.txt	据此 ， 根据 《 中华人民共和国 婚姻法 》 第三十二条 第三款 第 （ 五 ） 项 、 第三十六条 第二款 、 第三款 、 第三十七条 以及 《 中华人民共和国 民事 诉讼法 》 第 一百四十四 条 之 规定 ， 判决 如下 ： 

原告肖乾英诉被告王新明离婚纠纷一案民事判决书.txt	据此 ， 依照 《 中华人民共和国 婚姻法 》 第三十二条 第二款 ， 《 中华人民共和国 民事 诉讼法 》 第 一百四十四 条 " 被告 经 传票 传唤 ， 无 正当理由 拒 不 到庭 的 ， 或者 未经 法院 许可 中途 退庭 的 ， 可以 缺席判决 。 " ， 以及 《 最高人民法院 关于 适用 ﹤ 中华人民共和国 民事 诉讼法 ﹥ 的 解释 》 第九 十条 之 规定 ， 判决 如下 ： 

原告肖某某为与被告张某某离婚纠纷一案的民事判决书.txt	依据 《 中华人民共和国 婚姻法 》 第三十二条 之 规定 ， 判决 如下 ： 

原告苏映忠与被告赵玉香离婚纠纷一案民事判决书.txt	据此 ， 依据 《 中华人民共和国 婚姻法 》 第三十二条 第三款 第 （ 五 ） 项 、 第三十六条 和 第三十九条 之 规定 ， 判决 如下 ： 

原告苏某某与被告汪某某离婚纠纷一案民事裁定书.txt	依照 《 中华人民共和国 民事 诉讼法 》 第 一百四十 三条 、 第一百五十四条 第一款 （ 十一 ） 项之 规定 ， 裁定 如下 ： 

原告苟某某与被告杨某离婚纠纷一案的民事判决书.txt	据此 ， 依照 《 》 第之 规定 ， 判决 如下 ： 

原告苟某某与被告熊某某“离婚纠纷”一案民事判决书.txt	依照 《 中华人民共和国 婚姻法 》 第三十二 的 规定 ， 判决 如下 ： 

原告范某某诉被告胡某某为离婚纠纷一案一审民事判决书.txt	依照 《 中华人民共和国 婚姻法 》 第三十二条 的 规定 ， 判决 如下 ： 

原告蓝某某诉被告邹某某离婚纠纷一案民事判决书.txt	根据 《 中华人民共和国 婚姻法 》 第三十二条 第二款 " 人民法院 审理 离婚 案件 ， 应当 进行 调解 ； 如 感情 确 已 破裂 ， 调解 无效 ， 应 准予 离婚 。 " 及 《 最高人民法院 关于 民事诉讼 证据 的 若干 规定 》 第二条 " 当事人 对 自己 提出 的 诉讼请求 所 依据 的 事实 或者 反驳 对方 诉讼请求 所 依据 的 事实 有 责任 提供 证据 加以 证明 。 没有 证据 或者 证据 不足以 证明 当事人 的 事实 主张 的 ， 由 负有 举证责任 的 当事人 承担 不利 后果 。 " 的 规定 ， 判决 如下 ： 

原告袁某某与被告陈某甲离婚纠纷一案一审民事判决书.txt	据此 ， 依照 《 中华人民共和国 婚姻法 》 第三十二条 第一款 、 《 中华人民共和国 民事 诉讼法 》 第一百 四十二条 之 规定 ， 判决 如下 ： 

原告袁某某诉被告张某离婚纠纷一案的民事判决书.txt	依照 《 中华人民共和国 婚姻法 》 第三十二条 、 第三十六条 、 第三十七条 、 第三十八条 之 规定 ， 判决 如下 ： 

原告詹某某诉被告李某某离婚纠纷案一审判决书.txt	据此 ， 依照 《 中华人民共和国 婚姻法 》 第三十二条 、 《 中华人民共和国 民事 诉讼法 》 第六十四 条 第一款 以及 最高人民法院 《 关于 适用 ﹤ 中华人民共和国 民事 诉讼法 ﹥ 的 解释 》 第九 十条 第一款 的 规定 ， 判决 如下 ： 

原告谢某某诉被告卢某某离婚纠纷一案一审民事判决书.txt	依照 《 中华人民共和国 婚姻法 》 第三十二条 、 《 中国 人民共和国 民事 诉讼法 》 第六十四 条 、 第 一百四十四 条 之 规定 ， 判决 如下 ： 

原告谭某某与被告胡某“离婚纠纷”一案民事判决书.txt	依照 《 中华人民共和国 婚姻法 》 第三十二 的 规定 ， 判决 如下 ： 

原告谭某某诉被告郑某某离婚纠纷一案民事裁定书.txt	依照 《 中华人民共和国 婚姻法 》 第三十二条 及 《 中华人民共和国 民事 诉讼法 》 第六十四 条 第一款 、 第一百 四十二条 之 规定 ， 判决 如下 ： 

原告贺某某诉被告严某某离婚纠纷一审民事判决书.txt	依照 《 中华人民共和国 婚姻法 》 第三十二条 第三款 （ 五 ） 项 、 第三十七条 第一款 和 《 中华人民共和国 民事 诉讼法 》 第 一百四十四 条 的 规定 ， 判决 如下 ： 

原告贺某某诉被告杨某某为离婚纠纷一案一审民事判决书.txt	依照 《 中华人民共和国 婚姻法 》 第三十二条 的 规定 ， 判决 如下 ： 

原告贺某甲诉被告严某某离婚纠纷一案一审民事判决书.txt	依照 《 中华人民共和国 婚姻法 》 第三十二条 第三款 （ 五 ） 项 、 第三十七条 第一款 和 《 中华人民共和国 民事 诉讼法 》 第 一百四十四 条 的 规定 ， 判决 如下 ： 

原告赵XX诉被告蒙XX离婚纠纷一案一审民事判决书.txt	据此 ， 依据 《 中华人民共和国 婚姻法 》 第三十二条 第三款 和 《 中华人民共和国 民事 诉讼法 》 第六十四 条 第一款 、 最高人民法院 《 关于 适用 ﹤ 中华人民共和国 民事 诉讼法 ﹥ 的 解释 》 第九 十条 之 规定 ， 判决 如下 ： 

原告赵某与被告孙某离婚纠纷一案一审民事判决书.txt	据此 ， 本院 依照 《 中华人民共和国 婚姻法 》 第三十二条 、 《 中华人民共和国 民事 诉讼法 》 第一百 四十二条 的 规定 ， 判决 如下 ： 

原告赵某某与被告张某某离婚纠纷一案一审民事判决书.txt	据此 ， 依照 《 中华人民共和国 婚姻法 》 第三十二条 ， 《 最高人民法院 关于 适用 〈 中华人民共和国 民事 诉讼法 〉 的 解释 》 第九 十条 ， 《 中华人民共和国 民事 诉讼法 》 第一百 四十二条 的 规定 ， 判决 如下 ： 

原告赵某某与被告蒲某甲离婚纠纷一案一审民事判决书.txt	据此 ， 依照 《 中华人民共和国 婚姻法 》 第三十二条 、 《 中华人民共和国 民事 诉讼法 》 第一百 四十二条 之 规定 ， 判决 如下 ： 

原告赵某某与被告黄某某离婚纠纷一案一审民事判决书.txt	据此 ， 本院 依照 《 中华人民共和国 婚姻法 》 第三十二条 ， 《 最高人民法院 关于 适用 〈 中华人民共和国 民事 诉讼法 〉 的 解释 》 第九 十条 ， 《 中华人民共和国 民事 诉讼法 》 第一百 四十二条 的 规定 ， 判决 如下 ： 

原告赵某甲与被告母某离婚纠纷一案一审民事判决书.txt	根据 《 中华人民共和国 婚姻法 》 第三十二条 、 《 最高人民法院 关于 民事诉讼 证据 的 若干意见 》 第二条 之 规定 ， 判决 如下 ： 

原告赵菊容诉被告黄永安离婚一审民事判决书.txt	据此 ， 依照 《 中华人民共和国 婚姻法 》 第三十二条 第二款 、 第三款 第 （ 四 ） 项 及 《 中华人民共和国 民事 诉讼法 》 第 一百四十四 条 之 规定 ， 判决 如下 ： 

原告辜某诉被告赵某某“离婚纠纷”一案民事判决书.txt	依照 《 中华人民共和国 婚姻法 》 第三十二 的 规定 ， 判决 如下 ： 

原告邓某某与被告李某离婚纠纷一案的民事判决书.txt	依据 《 中华人民共和国 婚姻法 》 第三十二条 之 规定 ， 判决 如下 ： 

原告邓某某与被告衡某某离婚纠纷一案民事判决书.txt	据此 ， 依照 《 中华人民共和国 婚姻法 》 第三十二条 第二款 " 人民法院 审理 离婚 案件 ， 应当 进行 调解 ； 如 感情 确 已 破裂 ， 调解 无效 ， 应 准予 离婚 。 " 的 规定 ， 判决 如下 ： 

原告邓某某诉被告宋某某离婚纠纷一案一审民事判决书.txt	据此 ， 为 保护 双方 当事人 的 合法权益 ， 依照 《 中华人民共和国 婚姻法 》 第三十二条 、 《 中华人民共和国 民事 诉讼法 》 第六十四 条 第一款 之 规定 ， 判决 如下 ： 

原告邓某某诉被告詹某某离婚纠纷一案一审判决书.txt	据此 ， 依照 《 中华人民共和国 婚姻法 》 第三十二条 ， 《 中华人民共和国 民事 诉讼法 》 第六十四 条 第一款 ， 最高人民法院 《 关于 适用 ﹤ 中华人民共和国 民事 诉讼法 ﹥ 的 解释 》 第九 十条 之 规定 ， 判决 如下 ： 

原告邓某某诉被告贺某某离婚纠纷一案一审民事判决书.txt	依照 《 中华人民共和国 婚姻法 》 第三十二条 、 第三十七条 、 《 最高人民法院 关于 人民法院 审理 离婚 案件 如何 认定 夫妻感情 确 已 破裂 的 若干 具体意见 》 第七条 、 《 最高人民法院 关于 人民法院 审理 离婚 案件 子女 抚养 问题 的 若干 具体意见 》 第三条 、 《 中华人民共和国 民事 诉讼法 》 第六十四 条 、 第 一百四十四 条 之 规定 ， 判决 如下 ： 

原告邓某某诉被告赵某某离婚纠纷一案的民事判决书.txt	依照 《 中华人民共和国 婚姻法 》 第三十二条 、 第三十六条 、 第三十七条 、 第三十八条 、 第三十九条 、 第四十一条 之 规定 ， 判决 如下 ： 

原告邱某某诉被告于某甲离婚纠纷一审民事判决书.txt	据此 ， 依照 《 中华人民共和国 婚姻法 》 第三十二条 第二款 的 规定 ， 判决 如下 ： 

原告邹某某诉被告王某某离婚纠纷一案一审民事判决书.txt	据此 ， 依据 《 中华人民共和国 婚姻法 》 第三十二条 、 第三十七条 以及 《 中华人民共和国 民事 诉讼法 》 第一百 四十八条 第一款 之 规定 ， 判决 如下 ： 

原告郭某诉被告庞某离婚纠纷一案一审民事判决书.txt	依照 《 中华人民共和国 婚姻法 》 第三十二条 " 男女 一方 要求 离婚 的 ， 可 由 有关 部门 进行 调解 或 直接 向 人民法院 提出 离婚 诉讼 。 人民法院 审理 离婚 案件 ， 应当 进行 调解 ； 如 感情 确 已 破裂 ， 调解 无效 ， 应 准予 离婚 。 " 之 规定 ， 判决 如下 ： 

原告鄢某某诉被告周某某离婚纠纷一案的民事判决书.txt	依据 《 中华人民共和国 婚姻法 》 第三十二条 、 第三十六条 、 第三十七条 、 第三十八条 、 第三十九条 、 第四十一条 之 规定 ， 判决 如下 ： 之 规定 ， 判决 如下 ： 

原告钟某某诉被告刘某某离婚纠纷一案一审民事裁定书.txt	依照 《 中华人民共和国 民事 诉讼法 》 第一百 二十四条 第 （ 七 ） 项 及 最高人民法院 关于 适用 《 中华人民共和国 民事 诉讼法 》 的 解释 第二百 零 八条 第三款 的 规定 ， 裁定 如下 ： 

原告钱某某诉被告江某某离婚纠纷一审民事判决书.txt	依照 《 中华人民共和国 婚姻法 》 第三十二条 的 规定 ， 判决 如下 ： 

原告阮某与被告杨某某离婚纠纷一案民事判决书.txt	据此 ， 依照 《 中华人民共和国 婚姻法 》 第三十二条 第二款 " 人民法院 审理 离婚 案件 ， 应当 进行 调解 ； 如 感情 确 已 破裂 ， 调解 无效 ， 应 准予 离婚 。 " 的 规定 ， 判决 如下 ： 

原告阳某某与被告马某某离婚纠纷一案一审民事判决书.txt	依据 《 中华人民共和国 婚姻法 》 第三十二条 和 《 中华人民共和国 民事 诉讼法 》 第一百 四十二条 的 规定 ， 判决 如下 ： 

原告陈某某与被告张某某离婚纠纷一案一审民事判决书.txt	据此 ， 本院 依照 《 中华人民共和国 婚姻法 》 第三十二条 第二款 、 《 中华人民共和国 民事 诉讼法 》 第一百 四十二条 的 规定 ， 判决 如下 ： 

原告陈某某与被告徐某某“离婚纠纷”一案民事判决书.txt	依照 《 中华人民共和国 民事 诉讼法 》 第六十四 条 、 《 最高人民法院 关于 民事诉讼 证据 的 若干 规定 》 第六十五条 第 （ 一 ） 项 、 第六十九条 第 （ 四 ） 项 、 《 中华人民共和国 婚姻法 》 第三十二条 之 规定 ， 判决 如下 ： 

原告陈某某与被告樊某离婚纠纷一案的民事判决书.txt	据此 ， 依照 《 》 第之 规定 ， 判决 如下 ： 

原告陈某某诉被告胡某某为离婚纠纷一案一审民事判决书.txt	依照 《 中华人民共和国 婚姻法 》 第三十二条 的 规定 ， 判决 如下 ： 

原告陈某甲与被告王某甲离婚纠纷一案一审民事判决书.txt	据此 ， 依照 《 中华人民共和国 婚姻法 》 第三十二条 第二款 " 人民法院 审理 离婚 案件 ， 应当 进行 调解 ； 如 感情 确 已 破裂 ， 调解 无效 ， 应 准予 离婚 。 " 的 规定 ， 判决 如下 ： 

原告陈某甲与被告龙某某离婚纠纷一案一审民事判决书.txt	依照 《 中华人民共和国 婚姻法 》 第三十二条 、 第三十九 的 规定 ， 判决 如下 ： 

原告陈某甲诉被告杨某某离婚纠纷一案一审民事判决书.txt	据此 ， 本院 认定 原被告 夫妻感情 确 已 破裂 ， 原告 要求 离婚 的 诉讼请求 本院 予以 支持 。 对于 婚生女 陈某乙 的 抚养 问题 ， 鉴于 被告 无 稳定 的 收入 来源 ， 原告 自愿 放弃 被告 给付 抚养费 ， 且 结合 原 、 被告 经济 能力 、 居住 环境 、 年龄 等 综合 因素 考虑 ， 本院认为 ， 原 、 被告 婚生女 陈某乙 由 原告 抚养 更 有利于 小孩 的 教育 及 成长 。 被告 辩称 位于 河北省 三河市 燕郊 镇雷捷 时代广场 3 号 楼 2 单元 2710 室 的 房产 属于 原 、 被告 夫妻 共同财产 的 部分 ， 因 被告 未 到庭 应诉 ， 无法 对 该 房屋 的 共同财产 部分 进行 议价 和 评估 ， 本次 诉讼 中 不予 处理 。 被告 主张 的 其他 夫妻 共同财产 因 未 提供 相关 证据 佐证 ， 待 被告 收集 证据 后 可 另行 主张 权利 。 被告 称 原告 在 婚姻 存续 期间 与 他人 同居 ， 违反 夫妻 忠诚 ， 应当 给予 被告 损害赔偿 20 万元 的 请求 ， 因 未 提供 相关 证据 ， 因此 ， 该 请求 本院 亦 不予 支持 。 对于 被告 提出 原告 涉嫌 重婚罪 ， 因 牵涉 刑事诉讼 ， 且 被告 亦 未 提供 相关 证据 ， 不 属于 本案 诉讼 处理 范畴 。 另 ， 经查 被告 邮寄 " 管辖异议 申请书 " 的 时间 为 2016 年 2 月 12 日 ， 是 本 案庭审 日期 2016 年 2 月 4 日 之后 ， 已 过 管辖权 异议 申请 时限 。 据此 ， 根据 《 中华人民共和国 民事 诉讼法 》 第三十八条 ， 《 中华人民共和国 婚姻法 》 第二十一条 、 第三十二条 之 规定 ， 判决 如下 ： 

原告陈某诉被告王某某离婚纠纷一审民事判决书.txt	依照 《 中华人民共和国 婚姻法 》 第三十二条 的 规定 ， 判决 如下 ： 

原告雍某某与被告汪某某离婚纠纷一案一审民事判决书.txt	据此 ， 依照 《 中华人民共和国 婚姻法 》 第三十二条 、 《 中华人民共和国 民事 诉讼法 》 第一百 四十二条 的 规定 ， 判决 如下 ： 

原告韩云诉被告吴学林离婚纠纷一案民事判决书.txt	依照 《 中华人民共和国 婚姻法 》 第三十二条 二款 （ 四 ） 项 、 第三十六条 三款 、 三十七 条 一款 之 规定 ， 判决 如下 ： 

原告韩某甲诉被告刘某某离婚纠纷一审民事判决书.txt	据此 ， 依照 《 中华人民共和国 婚姻法 》 第三十二条 第二款 的 规定 ， 判决 如下 ： 

原告马某某与被告伏某某离婚纠纷一案一审民事判决书.txt	依据 《 中华人民共和国 婚姻法 》 第三十二条 和 《 中华人民共和国 民事 诉讼法 》 第一百 四十二条 的 规定 ， 判决 如下 ： 

原告马某某与被告王某某离婚纠纷一案民事判决书.txt	据此 ， 依照 《 中华人民共和国 婚姻法 》 第三十二条 第二款 、 第三十六条 第三款 的 规定 ， 判决 如下 ： 

原告马某某诉被告李某某离婚纠纷一案一审民事判决书.txt	依照 《 中华人民共和国 婚姻法 》 第三十二条 与 《 中华人民共和国 民事 诉讼法 》 第一百 四十八条 之 规定 ， 判决 如下 ： 

原告高某诉被告董某某、庞某婚约财产纠纷一案一审民事判决书.txt	据此 ， 依照 《 中华人民共和国 婚姻法 》 第三条 第一款 、 《 最高人民法院 关于 适用 ﹤ 中华人民共和国 婚姻法 ﹥ 若干 问题 的 解释 （ 二 ） 》 第十条 第一款 第 （ 一 ） 项 和 《 中华人民共和国 共和国 民事 诉讼法 》 第六十四 条 第一款 之 规定 ， 判决 如下 ： 

原告魏某某诉被告高某某离婚纠纷一审民事判决书.txt	综上 ， 判决 如下 ： 

原告黄某与被告陈某离婚纠纷一案民事判决书.txt	据此 ， 依照 《 中华人民共和国 婚姻法 》 第三十二条 第二款 、 第三款 第 （ 四 ） 项 、 第三十六条 第二款 、 第三十七条 第一款 、 《 最高人民法院 〈 关于 人民法院 审理 离婚 案件 处理 子女 抚养 问题 的 若干 具体意见 〉 》 第 1 条 、 第 7 条 之 规定 ， 判决 如下 ： 

原告黄某某与被告邱某某离婚纠纷一案一审民事判决书.txt	据此 ， 依照 《 中华人民共和国 婚姻法 》 第三十二条 、 《 中华人民共和国 民事 诉讼法 》 第一百 四十二条 的 规定 ， 判决 如下 ： 

原告黄某某诉被告徐某某离婚纠纷一案的民事判决书.txt	据此 ， 为 保护 当事人 合法权益 ， 依照 《 中华人民共和国 婚姻法 》 第三十二条 、 第三十六条 、 第三十七条 、 《 中华人民共和国 民事 诉讼法 》 第六十四 条 第一款 、 《 最高人民法院 关于 适用 〈 中华人民共和国 民事 诉讼法 〉 的 解释 》 第九 十条 之 规定 ， 判决 如下 ： 

原告黄泽英诉被告余金泽离婚纠纷一案民事判决书.txt	据此 ， 依照 《 最高人民法院 关于 适用 ﹤ 中华人民共和国 婚姻法 ﹥ 若干 问题 的 解释 （ 一 ） 》 第五条 、 《 中华人民共和国 婚姻法 》 第三十二条 第二款 、 《 最高人民法院 关于 人民法院 审理 未办 结婚登记 而 以 夫妻 名义 同居 生活 案件 的 若干意见 》 第六条 、 《 中华人民共和国 民事 诉讼法 》 第 一百四十四 条 、 《 最高人民法院 关于 适用 ﹤ 中华人民共和国 民事 诉讼法 ﹥ 的 解释 》 第九 十条 之 规定 ， 判决 如下 ： 

原告龙某某与被告郑某甲离婚纠纷一案一审民事判决书.txt	据此 ， 根据 《 中华人民共和国 婚姻法 》 第三十二条 第二款 、 《 最高人民法院 关于 民事诉讼 证据 的 若干 规定 》 第二条 第二款 之 规定 ， 判决 如下 ： 

原告龙某诉被告黄某甲离婚纠纷一审民事判决书.txt	据此 ， 本院 可以 认定 原 、 被告 双方 夫妻感情 已 彻底 破裂 ， 无 和 好 之 可能 ， 对 原告 的 离婚 诉讼请求 ， 本院 予以 支持 。 对于 子女 抚养 问题 ， 考虑 到 原 、 被告 双方 及 子女 的 实际 生活 情况 以及 我国 的 传统习俗 ， 本院认为 ， 婚生 女 跟随 原告 生活 、 婚生子 跟随 被告 生活 较为 适宜 。 对于 原告 提出 的 婚后 共同财产 及 婚前 财产 ， 因 双方 均 未 提供 证据 予以 支持 ， 对此 两项 请求 ， 在 本案 中 不予 处理 。 据此 ， 依据 《 中华人民共和国 婚姻法 》 第三十二条 、 第三十六条 之 规定 ， 判决 如下 ： 

史某某与李某某离婚纠纷一审民事判决书.txt	据此 ， 依照 《 中华人民共和国 婚姻法 》 第三十二条 、 第三十七条 ， 《 最高人民法院 关于 人民法院 审理 离婚 案件 如何 认定 夫妻感情 确 已 破裂 的 若干意见 》 第 7 条 之 规定 ， 判决 如下 ： 

叶某与何某某离婚纠纷一审民事判决书.txt	据此 ， 依照 《 中华人民共和国 婚姻法 》 第三十二条 第三款 第 （ 五 ） 项 、 第三十七条 第一款 ， 《 最高人民法院 关于 人民法院 审理 离婚 案件 如何 认定 夫妻感情 确 已 破裂 的 若干 具体意见 》 第 7 项 ， 《 中华人民共和国 民事 诉讼法 》 第一百 四十二条 、 第 一百四十四 条 的 规定 ， 判决 如下 ： 

叶某某与廖某某离婚纠纷案一审民事判决书.txt	依照 《 中华人民共和国 婚姻法 》 第三十二条 ， 《 中华人民共和国 民事 诉讼法 》 第一百 四十二条 、 第一百 六十条 之 规定 ， 判决 如下 ： 

叶某某与郭某某离婚纠纷二审民事判决书.txt	据此 ， 根据 《 中华人民共和国 民事 诉讼法 》 第一百七十条 第一款 第 （ 一 ） 项 " 第二审 人民法院 对 上诉 案件 ， 经过 审理 ， 按照 下列 情形 ， 分别 处理 ： （ 一 ） 、 原 判决 、 裁定 认定 事实清楚 ， 适用法律 正确 的 ， 以 判决 、 裁定 方式 驳回上诉 ， 维持原判 决 、 裁定 ； ...... " 之 规定 ， 判决 如下 ： 

叶某诉肖某某离婚纠纷一审判决书.txt	据此 ， 依照 《 中华人民共和国 婚姻法 》 第三十二条 、 《 中华人民共和国 民事 诉讼法 》 第六十四 条 第一款 、 《 最高人民法院 关于 民事诉讼 证据 的 若干 规定 》 第二条 、 第七十六条 的 规定 ， 判决 如下 ： 

向某与陈某离婚纠纷一审民事判决书.txt	依照 《 中华人民共和国 婚姻法 》 第三十二条 一 、 二款 " 男女 一方 要求 离婚 的 ， 可 由 有关 部门 进行 调解 或 直接 向 人民法院 提出 离婚 诉讼 。 人民法院 审理 离婚 案件 ， 应当 进行 调解 ； 如 感情 确 已 破裂 ， 调解 无效 ， 应 准予 离婚 。 " 之 规定 ， 判决 如下 ： 

向某某与补某甲离婚纠纷一审民事判决书.txt	据此 ， 依照 《 中华人民共和国 婚姻法 》 第三十二条 、 第三十七条 、 《 最高人民法院 关于 人民法院 审理 离婚 案件 如何 认定 夫妻感情 确 已 破裂 的 若干 具体意见 》 第七条 之 规定 ， 判决 如下 ： 

向某某与陈某某离婚纠纷一审民事判决书.txt	据此 ， 依照 《 中华人民共和国 婚姻法 》 第三十二条 第三款 第五项 、 最高人民法院 《 关于 人民法院 审理 离婚 案件 如何 认定 夫妻感情 确 已 破裂 的 若干 具体意见 》 第十二条 、 《 中华人民共和国 民事 诉讼法 》 第 一百四十四 条 之 规定 ， 判决 如下 ： 

吕某与刘某甲离婚纠纷一审民事判决书.txt	据此 ， 依照 《 中华人民共和国 民事 诉讼法 》 第六十四 条 和 《 最高人民法院 关于 适用 ﹤ 中华人民共和国 民事 诉讼法 ﹥ 的 解释 》 第九 十条 的 规定 ， 判决 如下 ： 

吕某某与何某甲离婚纠纷一审民事判决书.txt	依照 《 中华人民共和国 婚姻法 》 第三十二条 、 《 中华人民共和国 民事 诉讼法 》 第六十四 条 第一款 以及 《 最高人民法院 关于 适用 ﹤ 中华人民共和国 民事 诉讼法 ﹥ 的 解释 》 第九 十条 之 规定 ， 判决 如下 ： 

吕某某与刘某某离婚纠纷一审民事判决书.txt	据此 ， 本院 依照 《 中华人民共和国 婚姻法 》 第三十二条 之 规定 ， 判决 如下 ： 

吕某诉曾某某离婚纠纷一审民事判决书.txt	据此 ， 依照 《 中华人民共和国 婚姻法 》 第三十二条 第二款 、 《 中华人民共和国 民事 诉讼法 》 第六十四 条 第一款 、 第六十五条 第一款 、 第 一百四十四 条 、 《 最高人民法院 关于 民事诉讼 证据 的 若干 规定 》 第二条 、 第七十六条 的 规定 ， 判决 如下 ： 

吴某与朱某甲离婚纠纷一审民事判决书.txt	依照 《 中华人民共和国 婚姻法 》 第三十二条 、 《 中华人民共和国 民事 诉讼法 》 第六十四 条 第一款 、 《 最高人民法院 关于 民事诉讼 证据 的 若干 规定 》 第二条 和 《 中华人民共和国 民事 诉讼法 》 第 一百四十四 条 之 规定 ， 判决 如下 ： 

吴某某与周某某离婚纠纷一案民事判决书.txt	据此 ， 依照 《 中华人民共和国 婚姻法 》 第三十二条 、 最高人民法院 《 关于 民事诉讼 证据 的 若干 规定 》 第二条 之 规定 ， 判决 如下 ： 

吴某某与朱某某离婚纠纷一审民事判决书.txt	据此 ， 依照 《 中华人民共和国 婚姻法 》 第三十二条 ， 《 最高人民法院 关于 适用 〈 中华人民共和国 民事 诉讼法 〉 的 解释 》 第九 十条 之 规定 ， 判决 如下 ： 

吴某某与熊某某离婚纠纷一审民事判决书.txt	据此 ， 依照 《 中华人民共和国 婚姻法 》 第三十二条 、 第三十七条 第一款 ， 《 最高人民法院 关于 人民法院 审理 离婚 案件 如何 认定 夫妻感情 确 已 破裂 的 若干 具体意见 》 第 7 条 、 第 8 条 ， 《 最高人民法院 关于 适用 〈 中华人民共和国 婚姻法 〉 若干 问题 的 解释 （ 一 ） 》 第二十条 之 规定 ， 判决 如下 ： 

吴某某与邓某某离婚纠纷一审民事判决书.txt	据此 ， 依照 《 中华人民共和国 婚姻法 》 第三十二条 ， 最高人民法院 《 关于 民事诉讼 证据 的 若干 规定 》 第二条 的 规定 ， 判决 如下 ： 

吴某某诉伍某某离婚纠纷一审民事判决书.txt	据此 ， 依照 《 中华人民共和国 婚姻法 》 第三十二条 、 第三十六条 、 第三十七条 ， 最高人民法院 《 关于 民事诉讼 证据 若干 规定 》 第二条 的 规定 ， 判决 如下 ： 

吴某某诉王某某离婚纠纷一审民事判决书.txt	据此 ， 依照 《 中华人民共和国 婚姻法 》 第三十二条 第三款 第 （ 五 ） 项之 规定 ， 判决 如下 ： 

吴某甲与何某某离婚纠纷一案二审民事判决书.txt	依照 《 中华人民共和国 民事 诉讼法 》 第一百七十条 第一款 第 （ 一 ） 项 " 原 判决 、 裁定 认定 事实清楚 ， 适用法律 正确 的 ， 以 判决 、 裁定 方式 驳回上诉 ， 维持原判 决 、 裁定 " 之 规定 ， 判决 如下 ： 

吴欢与王杰虹离婚纠纷一审判决书.txt	依照 《 中华人民共和国 婚姻法 》 第三十二条 第二款 、 《 最高人民法院 关于 适用 〈 中华人民共和国 民事 诉讼法 〉 的 解释 》 第九 十条 第二款 之 规定 ， 判决 如下 ： 

周小慧与胡勇军离婚纠纷一审民事判决书.txt	据此 ， 依照 《 中华人民共和国 婚姻法 》 第三十二条 、 《 中华人民共和国 民事 诉讼法 》 第六十四 条 第一款 ， 《 中华人民共和国 民事 诉讼法 》 第 一百四十四 条 ， 《 最高人民法院 关于 民事诉讼 证据 的 若干 规定 》 第二条 之 规定 ， 判决 如下 ： 

周某与唐某甲离婚纠纷一审民事判决书.txt	依照 《 中华人民共和国 婚姻法 》 第三十二条 和 最高人民法院 《 关于 民事诉讼 证据 的 若干 规定 》 第二条 之 规定 ， 判决 如下 ： 

周某与宋某甲离婚纠纷案一审民事判决书.txt	据此 ， 依照 《 中华人民共和国 婚姻法 》 第三十二条 第二款 人民法院 审理 离婚 案件 ， 应当 进行 调解 ； 如 感情 确 已 破裂 ， 调解 无效 ， 应 准予 离婚 之 规定 ， 判决 如下 ： 

周某与曾某离婚纠纷一审民事判决书.txt	依照 《 中华人民共和国 婚姻法 》 第三十二条 、 《 中华人民共和国 民事 诉讼法 》 第六十四 条 和 《 最高人民法院 关于 民事诉讼 证据 的 若干 规定 》 第二条 之 规定 ， 判决 如下 ： 

周某与蒋某某离婚纠纷一审民事判决书.txt	依照 《 中华人民共和国 婚姻法 》 第三十二条 的 规定 ， 判决 如下 ： 

周某与邱某甲离婚纠纷一审民事判决书.txt	据此 ， 为 保护 当事人 的 合法权益 ， 维护 正常 婚姻家庭 秩序 ， 依照 《 中华人民共和国 婚姻法 》 第三十二条 的 规定 ， 判决 如下 ： 

周某某与张某甲离婚纠纷二审民事判决书.txt	据此 ， 依照 《 中华人民共和国 民事 诉讼法 》 第一百七十条 第一款 第 （ 一 ） 项之 规定 ， 判决 如下 ： 

周某某与李某甲离婚纠纷一审民事判决书.txt	据此 ， 依照 《 中华人民共和国 婚姻法 》 第二十一条 、 第三十二条 、 《 最高人民法院 关于 适用 《 中华人民共和国 婚姻法 》 若干 问题 的 解释 （ 一 ） 》 第二十条 、 《 最高人民法院 民一庭 关于 婚姻关系 存续 期间 夫妻 一方 以 个人 名义 所负 债务 性质 如何 认定 的 答复 》 、 《 中华人民共和国 民事 诉讼法 》 第六十四 条 之 规定 ， 判决 如下 ： 

周某某与李某离婚纠纷一审民事判决书.txt	据此 ， 依照 《 中华人民共和国 婚姻法 》 第三十二条 、 《 中华人民共和国 民事 诉讼法 》 第六十四 条 、 《 最高人民法院 关于 民事诉讼 证据 的 若干 规定 》 第二条 之 规定 判决 如下 ： 

周某某与李某离婚纠纷一案一审民事判决书.txt	依照 《 中华人民共和国 婚姻法 》 第三十二条 ， 《 中华人民共和国 民事 诉讼法 》 第六十四 条 、 第一百 四十二条 之 规定 ， 判决 如下 ： 

周某某与王某某离婚纠纷一审民事判决书.txt	根据 《 中华人民共和国 婚姻法 》 第三十二条 、 第四十二条 和 《 最高人民法院 关于 民事诉讼 证据 的 若干 规定 》 第二条 之 规定 ， 判决 如下 ： 

周某某与胡某离婚纠纷一审民事判决书.txt	据此 ， 依照 《 中华人民共和国 民事 诉讼法 》 第一百 四十二条 、 《 中华人民共和国 婚姻法 》 第三十二条 之 规定 ， 判决 如下 ： 

周某某与陈某甲离婚纠纷一审民事判决书.txt	依照 《 中华人民共和国 婚姻法 》 第三十二条 的 规定 ， 判决 如下 ： 

周某某诉孙某某离婚纠纷案一审民事判决书.txt	依照 《 中华人民共和国 婚姻法 》 第三十二条 的 规定 ， 判决 如下 ： 

周某某诉被告王某某离婚纠纷一审民事判决书.txt	根据 《 中华人民共和国 婚姻法 》 第三十二条 " 人民法院 审理 离婚 案件 ， 应当 进行 调解 ； 如 感情 确 已 破裂 ， 调解 无效 ， 应 准予 离婚 " 及 《 中华人民共和国 民事 诉讼法 》 第 一百四十四 条 " 被告 经 传票 传唤 ， 无 正当理由 拒 不 到庭 的 ， 或者 未经 法庭 许可 中途 退庭 的 ， 可以 缺席判决 " 之 规定 ， 判决 如下 ： 

周某某诉黄某某离婚纠纷一审民事判决书.txt	据此 ， 本院 依照 《 中华人民共和国 婚姻法 》 第三十二条 、 《 中华人民共和国 民事 诉讼法 》 第六十四 条 、 《 最高人民法院 关于 民事诉讼 证据 的 若干 规定 》 第二条 之 规定 ， 判决 如下 ： 

周某甲与罗某离婚纠纷一审民事判决书.txt	依照 《 中华人民共和国 婚姻法 》 第三十二条 第三款 第五项 、 第三十六条 之 规定 ， 判决 如下 ： 

周某甲诉熊某某离婚纠纷一案一审民事判决书.txt	据此 ， 依照 《 中华人民共和国 婚姻法 》 第三十二条 第三款 第 （ 四 ） 项 、 第三十六条 ， 《 最高人民法院 关于 人民法院 审理 离婚 案件 处理 子女 抚养 问题 的 若干 具体意见 》 第 3 条 第 （ 2 ） 项 、 第 5 条 和 《 中华人民共和国 民事 诉讼法 》 第六十四 条 第一款 、 第 一百四十四 条 之 规定 ， 判决 如下 ： 

唐小惠与杨大城离婚纠纷一审民事判决书.txt	依照 《 中华人民共和国 婚姻法 》 第三十二条 第三款 第四项 、 第三十六条 ， 《 中华人民共和国 民事 诉讼法 》 第 一百四十四 条 之 规定 ， 判决 如下 ： 

唐某与曾某离婚纠纷一审民事裁定书.txt	依照 《 中华人民共和国 民事 诉讼法 》 第 一百四十 三条 之 规定 ， 裁定 如下 ： 

唐某容与段某青离婚纠纷一审民事判决书.txt	依照 《 中华人民共和国 婚姻法 》 第三十二条 第二款 、 最高人民法院 关于 《 人民法院 审理 离婚 案件 如何 认定 夫妻感情 确 已 破裂 的 若干 具体意见 》 第七条 、 最高人民法院 关于 《 人民法院 审理 离婚 案件 处理 子女 抚养 问题 的 若干 具体意见 》 第五条 和 第七条 之 规定 ， 判决 如下 ： 

唐某某与何某某离婚纠纷一审民事判决书.txt	据此 ， 依照 《 中华人民共和国 婚姻法 》 第三十二条 、 《 中华人民共和国 民事 诉讼法 》 第六十四 条 及 《 最高人民法院 关于 民事诉讼 证据 的 若干 规定 》 第二条 之 规定 ， 判决 如下 ： 

唐某某与卿某某离婚纠纷案一审民事判决书.txt	依照 《 中华人民共和国 婚姻法 》 第三十二条 和 《 中华人民共和国 民事 诉讼法 》 第一百 六十条 、 第 一百四十四 条 之 规定 ， 判决 如下 ： 

唐某某与周某甲离婚纠纷一审民事判决书.txt	据此 ， 依照 《 中华人民共和国 婚姻法 》 第三十二条 第二款 、 《 中华人民共和国 民事 诉讼法 》 第六十四 条 第一款 、 最高人民法院 《 关于 适用 < 中华人民共和国 民事 诉讼法 > 的 解释 》 第九 十条 之 规定 ， 判决 如下 ： 

唐某某与安某某离婚纠纷案一审民事判决书.txt	依照 《 中华人民共和国 婚姻法 》 第三十二条 和 《 中华人民共和国 民事 诉讼法 》 第六十四 条 、 第一百 四十二条 、 第一百 六十条 之 规定 ， 判决 如下 ： 

唐某某与张某某离婚纠纷案一审民事判决书.txt	依照 《 中华人民共和国 婚姻法 》 第三十二条 ， 最高人民法院 《 关于 民事诉讼 证据 的 若干 规定 》 第二条 和 《 中华人民共和国 民事 诉讼法 》 第六十四 条 、 第 一百四十四 条 、 第一百 六十条 之 规定 ， 判决 如下 ： 

唐某某与张某离婚纠纷案一审民事判决书.txt	依照 《 中华人民共和国 婚姻法 》 第三十二条 和 《 中华人民共和国 民事 诉讼法 》 第一百 四十二条 、 第一百 六十条 之 规定 ， 判决 如下 ： 

唐某某与王某甲离婚纠纷一审民事判决书.txt	依照 《 中华人民共和国 婚姻法 》 第三十二条 、 最高人民法院 《 关于 民事诉讼 证据 若干 问题 的 规定 》 第二条 第二款 之 规定 ， 判决 如下 ： 

唐某某与胡某某离婚纠纷一审民事判决书.txt	依照 《 中华人民共和国 民事 诉讼法 》 第一百 四十二条 和 《 中华人民共和国 婚姻法 》 第三十二条 的 规定 ， 判决 如下 ： 

唐某某与谢某某离婚纠纷二审民事判决书.txt	依照 《 中华人民共和国 民事 诉讼法 》 第一百七十条 第一款 第 （ 一 ） 项之 规定 ， 判决 如下 ： 

唐某某与谢某甲离婚纠纷一审民事判决书.txt	依照 《 中华人民共和国 婚姻法 》 第四条 、 第三十二条 第二款 ， 《 最高人民法院 关于 民事诉讼 证据 的 若干 规定 》 第二条 之 规定 ， 判决 如下 ： 

唐某某与邓某某离婚纠纷一审民事裁定书.txt	据此 ， 依据 《 中华人民共和国 民事 诉讼法 》 第 一百一十 九条 、 《 最高人民法院 关于 适用 简易程序 审理 民事案件 的 若干 规定 》 第八条 第 （ 二 ） 项 的 规定 ， 裁定 如下 ： 

唐某某与邓某甲离婚纠纷一审民事判决书.txt	依照 《 中华人民共和国 婚姻法 》 第三十二条 的 规定 ， 判决 如下 ： 

唐某某诉张某某离婚纠纷一审民事判决书.txt	据此 ， 依照 《 中华人民共和国 婚姻法 》 第三十二条 第二款 、 《 中华人民共和国 民事 诉讼法 》 第十三条 、 第六十四 条 第一款 、 第六十五条 第一款 、 《 最高人民法院 关于 民事诉讼 证据 的 若干 规定 》 第二条 、 第七十六条 的 规定 ， 判决 如下 ： 

唐某某诉袁某离婚纠纷一案一审民事判决书.txt	据此 ， 依照 《 中华人民共和国 婚姻法 》 第三十二条 第二款 、 《 中华人民共和国 民事 诉讼法 》 第六十四 条 第一款 、 最高人民法院 《 关于 适用 〈 中华人民共和国 民事 诉讼法 〉 的 解释 》 第九 十条 之 规定 ， 判决 如下 ： 

唐某某诉被告周某某离婚纠纷一审民事判决书.txt	根据 《 中华人民共和国 婚姻法 》 第三十二条 之 规定 ， 判决 如下 ： 

唐某甲诉谢某某离婚纠纷一审民事判决书.txt	依照 《 中华人民共和国 婚姻法 》 第三十二条 第二款 、 第三款 第五项 、 第三十六条 、 第三十七条 、 第三十九条 第一款 、 第四十二条 以及 《 最高人民法院 关于 贯彻执行 民事 政策 法律 若干 问题 的 意见 》 第二十三条 之 规定 判决 如下 ： 

唐某甲诉赵某某离婚纠纷一审民事判决书.txt	依照 《 中华人民共和国 民事 诉讼法 》 第六十四 条 " 当事人 对 自己 提出 的 主张 ， 有 责任 提供 证据 " 、 《 最高人民法院 关于 民事诉讼 证据 的 若干 规定 》 第二条 " 当事人 对 自己 提出 的 诉讼请求 所 依据 的 事实 或者 反驳 对方 诉讼请求 所 依据 的 事实 有 责任 提供 证据 加以 证明 。 没有 证据 或者 证据 不足以 证明 当事人 的 事实 主张 的 ， 由 负有 举证责任 的 当事人 承担 不利 后果 " 和 《 中华人民共和国 民事 诉讼法 》 第 一百四十四 条 " 被告 经 传票 传唤 ， 无 正当理由 拒 不 到庭 的 ， 或者 未经 法庭 许可 中途 退庭 的 ， 可以 缺席判决 " 之 规定 ， 缺席判决 如下 ： 

唐某芬与唐甲离婚纠纷一审民事判决书.txt	依照 《 中华人民共和国 婚姻法 》 第三十二条 第二款 、 《 中华人民共和国 民事 诉讼法 》 第六十四 条 第一款 以及 《 最高人民法院 关于 民事诉讼 证据 的 若干 规定 》 第二条 之 规定 ， 判决 如下 ： 

夏某与王某离婚纠纷一审民事判决书.txt	依照 《 中华人民共和国 婚姻法 》 第三十二条 、 《 中华人民共和国 民事 诉讼法 》 第 一百四十四 条 、 《 中华人民共和国 民事 诉讼法 》 第六十四 条 第一款 、 《 最高人民法院 关于 民事诉讼 证据 的 若干 规定 》 第二条 之 规定 ， 判决 如下 ： 

夏某某与张某某离婚纠纷一审民事判决书.txt	据此 ， 依照 《 中华人民共和国 婚姻法 》 第三十二条 、 《 中华人民共和国 民事 诉讼法 》 第六十四 条 第一款 、 最高人民法院 《 关于 民事诉讼 证据 若干 问题 的 规定 》 第二条 之 规定 ， 判决 如下 ： 

夏某某与杨某某离婚纠纷一审民事裁定书.txt	依照 《 中华人民共和国 民事 诉讼法 》 第一百 二十四条 第 （ 七 ） 项 、 第一百五十四条 第三项 ， 最高人民法院 《 关于 适用 〈 中华人民共和国 民事 诉讼法 〉 若干 问题 的 意见 》 第 一百三十 九条 的 规定 ， 裁定 如下 ： 

夏某某与魏某甲离婚纠纷案一审民事判决书.txt	根据 《 中华人民共和国 婚姻法 》 第三十二条 第二款 " 人民法院 审理 离婚 案件 ， 应当 进行 调解 ； 如 感情 确 已 破裂 、 调解 无效 ， 应 准予 离婚 。 " 的 规定 ， 判决 如下 ： 

夏某某与黎某甲离婚纠纷案二审民事判决书.txt	据此 ， 本院 依据 《 中华人民共和国 民事 诉讼法 》 第一百七十条 第一款 第 （ 一 ） 项之 规定 ， 判决 如下 ： 

奂某某与杨某某离婚纠纷一审民事判决书.txt	据此 ， 依照 《 中华人民共和国 婚姻法 》 第三十二条 、 《 中华人民共和国 民事 诉讼法 》 第六十四 条 第一款 、 《 最高人民法院 关于 民事诉讼 证据 的 若干 规定 》 第二条 、 《 最高人民法院 关于 适用 ﹤ 中华人民共和国 民事 诉讼法 ﹥ 的 解释 》 第九 十条 的 规定 ， 判决 如下 ： 

姚某与张某甲离婚纠纷一审民事判决书.txt	据此 ， 为 保护 当事人 的 合法权益 ， 维护 正常 婚姻家庭 秩序 ， 依照 《 中华人民共和国 婚姻法 》 第三十二条 和 《 中华人民共和国 民事 诉讼法 》 第六十四 条 和 《 最高人民法院 关于 适用 ﹤ 中华人民共和国 民事 诉讼法 ﹥ 的 解释 》 第九 十条 的 规定 ， 判决 如下 ： 

姚某某与林某某离婚纠纷一审民事判决书.txt	综上所述 ， 依照 我国 《 婚姻法 》 第三十二条 第三款 第 （ 四 ） 项 、 第三十七条 ， 《 民事 诉讼法 》 第十三条 第二款 、 第六十四 条 第一款 ， 《 最高人民法院 关于 适用 〈 中华人民共和国 民事 诉讼法 〉 的 解释 》 第九 十条 、 第九十 一条 第 （ 一 ） 项 、 第九十二 条 第一款 之 规定 判决 如下 ： 

姜某与贺某离婚纠纷一审民事判决书.txt	据此 ， 依照 《 中华人民共和国 婚姻法 》 第三十二条 第二款 " 人民法院 审理 离婚 案件 ， 应当 进行 调解 ； 如 感情 确 已 破裂 ， 调解 无效 ， 应 准予 离婚 。 " 之 规定 ， 判决 如下 ： 

姜某某与杨某某离婚纠纷一审民事判决书.txt	据此 ， 依照 《 中华人民共和国 婚姻法 》 第三十二条 第二款 、 第三十六 、 第三十七条 和 《 中华人民共和国 民事 诉讼法 》 第 一百四十四 条 之 规定 ， 判决 如下 ： 

姜某某与黎某某离婚纠纷一审民事判决书.txt	据此 ， 依照 《 中华人民共和国 婚姻法 》 第三十二条 第二款 、 《 中华人民共和国 民事 诉讼法 》 第 一百四十四 条 、 《 最高人民法院 关于 适用 ﹤ 中华人民共和国 民事 诉讼法 ﹥ 的 解释 》 第九 十条 之 规定 ， 判决 如下 ： 

孙某与杨某离婚纠纷一审民事判决书.txt	依照 《 中华人民共和国 婚姻法 》 第三十二条 第二款 和 《 最高人民法院 关于 民事诉讼 证据 的 若干 规定 》 第二条 之 规定 ， 判决 如下 ： 

孙某某与罗某某离婚纠纷一案二审民事裁定书.txt	依照 《 中华人民共和国 民事 诉讼法 》 第一百七 十三条 关于 第二审 人民法院 判决 宣告 前 ， 上诉人 申请 撤回 上诉 的 ， 是否 准许 ， 由 第二审 人民法院 裁定 之 规定 ， 裁定 如下 ： 

孙某某与马某某离婚纠纷一审民事裁定书.txt	根据 《 中华人民共和国 婚姻法 》 第三十二条 、 第三十七条 及 《 最高人民法院 关于 审理 离婚 案件 处理 子女 抚养 问题 的 若干 具体意见 》 第七条 之 规定 ， 判决 如下 ： 

孙某某诉侯某某离婚纠纷一审民事判决书.txt	据此 ， 依照 《 中华人民共和国 婚姻法 》 第三十二条 、 《 最高人民法院 关于 民事诉讼 证据 的 若干 规定 》 第二条 、 《 中华人民共和国 民事 诉讼法 》 第六十四 条 之 规定 ， 判决 如下 ： 

孟芹与罗锟离婚纠纷一审民事判决书.txt	据此 ， 依照 《 中华人民共和国 婚姻法 》 第三十二条 、 《 最高人民法院 ＜ 关于 民事诉讼 证据 的 若干 规定 ＞ 》 第二条 、 《 中华人民共和国 民事 诉讼法 》 第六十四 条 之 规定 ， 判决 如下 ： 

宁某某与王某离婚纠纷案一审民事判决书.txt	依照 《 中华人民共和国 婚姻法 》 第三十二条 和 《 中华人民共和国 民事 诉讼法 》 第一百 六十条 、 第一百 四十二条 之 规定 ， 判决 如下 ： 

宋某与李某甲离婚纠纷一审民事判决书.txt	据此 ， 依照 《 中华人民共和国 婚姻法 》 第三十二条 、 《 中华人民共和国 民事 诉讼法 》 第六十四 条 、 《 最高人民法院 关于 适用 ﹤ 中华人民共和国 民事 诉讼法 ﹥ 的 解释 》 第九 十条 之 规定 ， 判决 如下 ： 

宋某某与刘某离婚纠纷一审民事判决书.txt	据此 ， 依照 《 中华人民共和国 婚姻法 》 第三十二条 、 第三十七条 第二款 ， 《 最高人民法院 关于 人民法院 审理 离婚 案件 处理 子女 抚养 问题 的 若干 具体意见 》 第 7 条 第二款 ， 《 最高人民法院 关于 适用 < 中华人民共和国 民事 诉讼法 > 的 解释 》 第九 十条 的 规定 ， 判决 如下 ： 

宋某某与李某某离婚纠纷一审民事判决书.txt	据此 ， 为了 保护 当事人 的 合法权益 ， 维护 家庭 及 社会 的 稳定 ， 依照 《 中华人民共和国 民事 诉讼法 》 第六十四 条 第一款 ， 最高人民法院 关于 适用 《 中华人民共和国 民事 诉讼法 》 的 解释 第九 十条 ， 《 中华人民共和国 婚姻法 》 第三十二条 第二款 ， 《 最高人民法院 关于 民事诉讼 证据 的 若干 规定 》 第二条 的 规定 ， 判决 如下 ： 

宋某某与杨某甲离婚纠纷一审民事判决书.txt	据此 ， 依照 《 中华人民共和国 婚姻法 》 第三十二条 、 第三十六条 、 第三十七条 之 规定 ， 判决 如下 ： 

宋某某与王某甲离婚纠纷案一审民事判决书.txt	据此 ， 本院 根据 《 中华人民共和国 婚姻法 》 第三十二条 第二款 " 人民法院 审理 离婚 案件 ， 应当 进行 调解 ； 如 感情 确 已 破裂 、 调解 无效 ， 应 准予 离婚 " 的 规定 ， 判决 如下 ： 

宋某某与郑某甲离婚纠纷一审民事判决书.txt	根据 《 中华人民共和国 婚姻法 》 第三十二条 第二款 之 规定 ， 判决 如下 ： 

宋某某诉杨某某离婚纠纷一审民事判决书.txt	据此 ， 依照 《 中华人民共和国 婚姻法 》 第三十二条 、 第三十九条 之 规定 ， 判决 如下 ： 

宋某甲与张某甲离婚纠纷案一审民事判决书.txt	依照 《 中华人民共和国 婚姻法 》 第三十二条 第二款 " 人民法院 审理 离婚 案件 ， 应当 进行 调解 ； 如 感情 确 已 破裂 ， 调解 无效 ， 应 准予 离婚 " 的 规定 ， 判决 如下 ： 

尚某某与杨某离婚纠纷一审民事判决书.txt	依照 《 中华人民共和国 婚姻法 》 第三十二条 第二款 之 规定 ， 判决 如下 ： 

尧某与张某离婚纠纷一审民事判决书.txt	据此 ， 原 告诉 请 离婚 的 证据不足 ， 理由 不 充分 ， 本院 不予 支持 。 依照 《 中华人民共和国 婚姻法 》 第三十二条 ， 《 中华人民共和国 民事 诉讼法 》 第六十四 条 第一款 和 《 最高人民法院 关于 适用 〈 中华人民共和国 民事 诉讼法 〉 的 解释 》 第九 十条 的 规定 ， 判决 如下 ： 

尹某与唐某甲离婚纠纷一审民事判决书.txt	依照 《 中华人民共和国 婚姻法 》 第三十二条 和 最高人民法院 《 关于 民事诉讼 证据 的 若干 规定 》 第二条 之 规定 ， 判决 如下 ： 

尹某与陈某离婚纠纷一审民事判决书.txt	依照 《 中华人民共和国 婚姻法 》 第三十二条 和 最高人民法院 《 关于 民事诉讼 证据 的 若干 规定 》 第二条 之 规定 ， 判决 如下 ： 

尹某甲与唐某某离婚纠纷案一审民事判决书.txt	根据 《 中华人民共和国 婚姻法 》 第三十二条 第二款 " 人民法院 审理 离婚 案件 ， 应当 进行 调解 ； 如 感情 确 已 破裂 、 调解 无效 ， 应 准予 离婚 。 " 的 规定 ， 判决 如下 ： 

崔某与王某华离婚纠纷一审民事裁定书.txt	依据 《 中华人民共和国 民事 诉讼法 》 第 一百四十 三条 、 一百四十 五条 之 规定 ， 裁定 如下 ： 

左某某与王某某离婚纠纷一审民事判决书.txt	依照 《 中华人民共和国 婚姻法 》 第三十二条 一 、 二款 之 规定 ， 判决 如下 ： 

巫映彩与蔡汶江离婚纠纷一审民事判决书.txt	根据 《 中华人民共和国 婚姻法 》 第三十二条 、 《 最高人民法院 关于 民事诉讼 证据 的 若干 规定 》 第二条 之 规定 ， 判决 如下 ： 

庞某某与杨某甲离婚纠纷一审民事判决书.txt	据此 ， 依照 《 中华人民共和国 婚姻法 》 第三十二条 、 《 中华人民共和国 民事 诉讼法 》 第六十四 条 第一款 、 《 最高人民法院 关于 适用 〈 中华人民共和国 民事 诉讼法 〉 的 解释 》 第九 十条 第二款 之 规定 ， 判决 如下 ： 

庞某某诉于某某离婚纠纷一审民事判决书.txt	依照 《 中华人民共和国 婚姻法 》 第三十二条 、 《 最高人民法院 关于 民事诉讼 证据 的 若干 规定 》 第二条 之 规定 ， 判决 如下 ： 

康某某与陈某某离婚纠纷纷一审民事判决书.txt	据此 ， 依照 《 中华人民共和国 婚姻法 》 第三十二条 、 《 最高人民法院 关于 适用 ﹤ 中华人民共和国 民事 诉讼法 ﹥ 的 解释 》 第九 十条 之 规定 ， 判决 如下 ： 

康某某与高某某离婚纠纷一案民事判决书.txt	依照 《 中华人民共和国 婚姻法 》 第十七条 、 第三十二条 、 第三十六条 、 第三十七条 、 第三十九条 第一款 、 第四十一条 ， 《 最高人民法院 关于 适用 ＜ 中华人民共和国 婚姻法 ＞ 若干 问题 的 解释 （ 二 ） 》 第十一条 第二项 、 第二十四条 ， 《 最高人民法院 关于 人民法院 审理 离婚 案件 处理 子女 抚养 问题 的 若干 具体意见 》 第 3 条 、 第 7 条 、 第 8 条 及 《 中华人民共和国 民事 诉讼法 》 第六十四 条 第一款 、 第一百五十 三条 之 规定 ， 判决 如下 ： 

廖某与李某离婚纠纷一审民事判决书.txt	依照 《 中华人民共和国 婚姻法 》 第三十二条 、 《 中华人民共和国 民事 诉讼法 》 第六十四 条 、 《 最高人民法院 关于 民事诉讼 证据 的 若干 规定 》 第二条 之 规定 ， 判决 如下 ： 

廖某与汪某某离婚纠纷一审民事判决书.txt	据此 ， 依照 《 中华人民共和国 婚姻法 》 第三十二条 第三款 、 最高人民法院 关于 适用 《 中华人民共和国 民事 诉讼法 》 的 解释 第九 十条 、 第二条 《 中华人民共和国 民事 诉讼法 》 第 一百四十四 条 之 规定 ， 判决 如下 ： 

廖某某与张某某离婚纠纷一审民事判决书.txt	根据 《 中华人民共和国 婚姻法 》 第三十二条 第二款 的 规定 ， 判决 如下 ： 

廖某某与朱某某离婚纠纷一审民事判决书.txt	依照 《 中华人民共和国 婚姻法 》 第三十二条 第二款 、 第三十六条 第三款 、 《 最高人民法院 关于 适用 ﹤ 中华人民共和国 民事 诉讼法 ﹥ 的 解释 》 第九 十条 之 规定 ， 判决 如下 ： 

廖某某与陈某某离婚纠纷案一审民事判决书.txt	依照 《 中华人民共和国 婚姻法 》 第三十二条 和 《 中华人民共和国 民事 诉讼法 》 第一百 四十二条 、 第一百 六十条 之 规定 ， 判决 如下 ： 

廖某某诉李某某离婚纠纷一审民事判决书.txt	据此 ， 依照 《 中华人民共和国 婚姻法 》 第三十二条 、 第三十七条 、 第三十九条 之 规定 ， 判决 如下 ： 

廖某甲诉周某甲离婚纠纷一案民事一审判决书.txt	据此 ， 依照 《 中华人民共和国 婚姻法 》 第三十二条 ， 最高人民法院 《 关于 人民法院 审理 离婚 案件 如何 认定 夫妻感情 确 已 破裂 的 若干 问题 的 意见 》 的 相关 规定 ， 判决 如下 ： 

廖某贵与王某来离婚纠纷一审民事判决书.txt	据此 ， 为 保护 当事人 的 合法权益 ， 维护 社会 、 家庭 的 和谐 稳定 ， 依照 《 中华人民共和国 婚姻法 》 第三十二条 第二款 、 《 中华人民共和国 民事 诉讼法 》 第六十四 条 、 《 最高人民法院 关于 民事诉讼 证据 的 若干 规定 》 第二条 的 规定 ， 判决 如下 ： 

张某与唐某某离婚纠纷案一审民事判决书.txt	依照 《 中 某 人民共和国 婚姻法 》 第三十二条 和 《 中 某 人民共和国 民事 诉讼法 》 第一百 四十二条 、 第一百 六十条 之 规定 ， 判决 如下 ： 

张某与杨某离婚纠纷一审民事判决书.txt	依照 《 中华人民共和国 婚姻法 》 第三十二条 及 《 最高人民法院 关于 民事诉讼 证据 的 若干 规定 》 第二条 之 规定 ， 判决 如下 ： 

张某与王某离婚纠纷一审民事判决书.txt	依照 《 中华人民共和国 婚姻法 》 第三十二条 ， 第三十七条 以及 《 中华人民共和国 民事 诉讼法 》 第 一百四十四 条 之 规定 ， 判决 如下 ： 

张某与魏某甲离婚纠纷一案一审民事判决书.txt	依据 《 中华人民共和国 婚姻法 》 第三十二条 之 规定 ， 判决 如下 ： 

张某与黄某某离婚纠纷案一审民事判决书.txt	依照 《 中华人民共和国 婚姻法 》 第三十二条 和 《 中华人民共和国 民事 诉讼法 》 第一百 四十二条 、 第一百 六十条 之 规定 ， 判决 如下 ： 

张某某与何某某离婚纠纷一案一审民事判决书.txt	依照 《 中华人民共和国 婚姻法 》 第三十二条 、 《 中华人民共和国 民事 诉讼法 》 第一百 四十八条 之 规定 ， 判决 如下 ： 

张某某与唐某甲离婚纠纷一审民事判决书.txt	依照 《 中华人民共和国 婚姻法 》 第三十二条 、 第三十六条 、 第三十七条 、 第三十八条 、 第三十九条 ， 《 最高人民法院 关于 民事诉讼 证据 的 若干 规定 》 第二条 之 规定 ， 判决 如下 ： 

张某某与姚某某离婚纠纷一审裁定书.txt	依照 《 中华人民共和国 民事 诉讼法 》 第 一百四十 三条 的 规定 ， 裁定 如下 ： 

张某某与孙某某离婚纠纷一审民事判决书.txt	依照 《 中华人民共和国 婚姻法 》 第三十二条 的 规定 ， 判决 如下 ： 

张某某与张某离婚纠纷一审民事判决书.txt	据此 ， 依照 《 中华人民共和国 婚姻法 》 第三十二条 、 第三十六条 第三款 、 第三十九条 第一款 之 规定 ， 判决 如下 ： 

张某某与李某某离婚纠纷案一审民事判决书.txt	依照 《 中华人民共和国 婚姻法 》 第三十二条 、 第三十六条 、 第三十七条 ， 《 中华人民共和国 民事 诉讼法 》 第一百 四十二条 、 第一百 六十条 之 规定 ， 判决 如下 ： 

张某某与李某甲离婚纠纷一审民事判决书.txt	依照 《 中华人民共和国 婚姻法 》 第三十二条 、 《 最高人民法院 关于 民事诉讼 证据 的 若干 规定 》 第二条 之 规定 ， 判决 如下 ： 

张某某与温某甲离婚纠纷案一审民事判决书.txt	据此 ， 本院 根据 《 中华人民共和国 婚姻法 》 第三十二条 第二款 " 人民法院 审理 离婚 案件 ， 应当 进行 调解 ； 如 感情 确 已 破裂 、 调解 无效 ， 应 准予 离婚 " 的 规定 ， 判决 如下 ： 

张某某与潘某甲婚姻无效纠纷一审民事判决书.txt	依照 《 中华人民共和国 婚姻法 》 第七条 、 第十条 ， 判决 如下 ： 

张某某与王某甲离婚纠纷一审民事判决书.txt	据此 ， 依据 《 中华人民共和国 婚姻法 》 第三十二条 之 规定 ， 判决 如下 ： 

张某某与田某甲离婚纠纷一审民事判决书.txt	依照 《 中华人民共和国 婚姻法 》 第三十二条 ， 《 中华人民共和国 民事 诉讼法 》 第六十四 条 ， 《 最高人民法院 关于 民事诉讼 证据 的 若干 规定 》 第二条 ， 之 规定 ， 判决 如下 ： 

张某某与祝某某离婚纠纷一审民事判决书.txt	据此 ， 依照 《 中华人民共和国 婚姻法 》 第三十二条 、 第三十六条 、 第三十七条 、 第三十八条 、 第四十一条 ， 《 最高人民法院 关于 人民法院 审理 离婚 案件 处理 子女 抚养 问题 的 若干 具体意见 》 第 7 条 之 规定 ， 判决 如下 ： 

张某某与罗某某离婚纠纷一审民事判决书.txt	根据 《 中华人民共和国 婚姻法 》 第三十二条 ， 《 最高人民法院 关于 民事诉讼 证据 的 若干 规定 》 第二条 之 规定 ， 判决 如下 ： 

张某某与苏某某离婚纠纷一审民事判决书.txt	依照 《 中华人民共和国 婚姻法 》 第三十二条 第三款 第 （ 五 ） 项 、 第三十六条 、 第三十八条 及 最高人民法院 《 关于 人民法院 审理 离婚 案件 如何 认定 夫妻感情 确 已 破裂 的 若干 具体意见 》 第十一条 ： 一方 依法 被 判处 长期 徒刑 或其 违法 、 犯罪行为 严重 伤害 夫妻感情 的 ， 经 调解 无效 ， 视为 夫妻感情 已 破裂 ， 可 准予 离婚 。 之 规定 ， 判决 如下 ： 

张某某与范某某离婚纠纷案一审民事判决书.txt	据此 ， 为 维护 当事人 合法权益 ， 依照 《 中华人民共和国 婚姻法 》 第三十二条 和 《 中华人民共和国 民事 诉讼法 》 第一百 四十二条 之 规定 ， 判决 如下 ： 

张某某与董某某离婚纠纷一审民事判决书.txt	依照 《 中华人民共和国 婚姻法 》 第三十二条 、 第四十二条 、 《 中华人民共和国 民事 诉讼法 》 第 一百四十四 条 及 最高人民法院 《 关于 民事诉讼 证据 的 若干 规定 》 第二条 之 规定 ， 判决 如下 ： 

张某某与赵某甲离婚纠纷一审民事判决书.txt	依照 《 中华人民共和国 婚姻法 》 第三十二条 ， 《 最高人民法院 关于 民事诉讼 证据 的 若干 规定 》 第二条 ， 《 中华人民共和国 民事 诉讼法 》 第六十四 条 、 第 一百四十四 条 之 规定 ， 判决 如下 ： 

张某某与郭某某离婚纠纷一事民事判决书.txt	据此 ， 依照 《 中华人民共和国 婚姻法 》 第三十二条 ， 《 中华人民共和国 民事 诉讼法 》 第一百 四十二条 之 规定 ， 判决 如下 ： 

张某某与陈某离婚纠纷一审民事判决书.txt	依照 《 中华人民共和国 婚姻法 》 第三十二条 、 《 中华人民共和国 民事 诉讼法 》 第 一百四十四 条 、 最高人民法院 《 关于 适用 〈 中华人民共和国 民事 诉讼法 〉 的 解释 》 第九 十条 之 规定 ， 判决 如下 ： 

张某某与颜某甲离婚纠纷一案一审民事判决书.txt	依照 《 中华人民共和国 婚姻法 》 第三十二条 第二款 " 人民法院 审理 离婚 案件 ， 应当 进行 调解 ； 如 感情 确 已 破裂 ， 调解 无效 ， 应 准予 离婚 " 、 第三款 第四项 " 有 下列 情形 之一 ， 调解 无效 的 ， 应 准予 离婚 ： （ 四 ） 因 感情 不 和 分居 满 二年 的 " 、 第三十七条 " 离婚 后 ， 一方 抚养 的 子女 ， 另一方 应 负担 必要 的 生活费 和 教育费 的 一部 或 全部 ， 负担 费用 的 多少 和 期限 的 长短 ， 由 双方 协议 ； 协议 不成 时 ， 由 人民法院 判决 " 之 规定 ， 判决 如下 ： 

张某某与高某离婚纠纷一审民事判决书.txt	据此 ， 依照 《 中华人民共和国 婚姻法 》 第三十二条 、 《 最高人民法院 关于 适用 〈 中华人民共和国 民事 诉讼法 〉 的 解释 》 第九 十条 之 规定 ， 判决 如下 ： 

张某某与黄某某离婚纠纷一审民事判决书.txt	依照 《 中华人民共和国 婚姻法 》 第三十二条 、 第三十六条 第一 、 二款 、 第三十七条 第一款 ， 最高人民法院 《 关于 适用 〈 中华人民共和国 民事 诉讼法 〉 的 解释 》 第九 十条 的 规定 ， 判决 如下 ： 

张某某与黄某甲离婚纠纷一审民事判决书.txt	依据 《 中华人民共和国 婚姻法 》 第三十二条 之 规定 ， 判决 如下 ： 

张某某诉何某某离婚纠纷一审民事判决书.txt	据此 ， 依照 《 中华人民共和国 婚姻法 》 第三十二条 第三款 第 （ 五 ） 项 、 第三十六条 第三款 、 《 中华人民共和国 民事 诉讼法 》 第十三条 第二款 、 《 最高人民法院 关于 人民法院 审理 离婚 案件 处理 子女 抚养 问题 的 若干 具体意见 》 第 3 条 第 （ 2 ） 项 的 规定 ， 判决 如下 ： 

张某某诉康某某离婚纠纷一案一审民事判决书.txt	据此 ， 依照 《 中华人民共和国 婚姻法 》 第三十二条 第三款 第 （ 三 ） 项 、 第三十六条 、 最高人民法院 《 关于 人民法院 审理 离婚 案件 处理 子女 抚养 问题 的 若干 具体意见 》 第一条 、 第四条 、 《 中华人民共和国 民事 诉讼法 》 第六十四 条 第一款 、 最高人民法院 《 关于 民事诉讼 证据 的 若干 规定 》 第二条 、 第七十六条 之 规定 ， 判决 如下 ： 

张某某诉赵某某离婚纠纷一审民事判决书.txt	依照 《 中华人民共和国 婚姻法 》 第三十二条 第二款 第 （ 四 ） 项 ， 第三十九条 之 规定 ， 判决 如下 ： 

张某梅与黄某均离婚纠纷一审民事判决书.txt	据此 ， 为 维护 各方 当事人 的 合法权益 ， 根据 《 中华人民共和国 婚姻法 》 第三十二条 、 第三十六条 、 第三十七条 之 规定 ， 判决 如下 ： 

张某甲与张某乙离婚纠纷一审民事判决书.txt	依据 《 中华人民共和国 婚姻法 》 第三十二条 之 规定 ， 判决 如下 ： 

张某甲与徐某某离婚纠纷一审民事判决书.txt	依照 《 中华人民共和国 婚姻法 》 第三十二条 第三款 第 （ 四 ） 项 和 《 中华人民共和国 民事 诉讼法 》 第十三条 第二款 之 规定 ， 判决 如下 ： 一 、 准予 原告 张某甲 与 被告 徐 某某 离婚 。 

张某甲与欧某某离婚纠纷一审民事判决书.txt	据此 ， 依照 《 中华人民共和国 婚姻法 》 第三十二条 、 《 中华人民共和国 民事 诉讼法 》 第六十四 条 和 《 最高人民法院 关于 民事诉讼 证据 的 若干 规定 》 第二条 的 规定 ， 判决 如下 ： 

张某甲与江某某离婚纠纷一审民事判决书.txt	据此 ， 依照 《 中华人民共和国 婚姻法 》 三十二条 之 规定 ， 判决 如下 ： 

张某甲与罗某某离婚纠纷一审民事判决书.txt	据此 ， 依照 《 中华人民共和国 民事 诉讼法 》 第六十四 条 第一款 、 《 最高人民法院 关于 民事诉讼 证据 的 若干 规定 》 第二条 之 规定 ， 判决 如下 ： 

张某甲与葛某甲离婚纠纷一审民事判决书.txt	依照 《 中华人民共和国 婚姻法 》 第三十二条 、 最高人民法院 《 关于 民事诉讼 证据 的 若干 规定 》 第二条 的 规定 ， 判决 如下 ： 

张某甲与陈某某离婚纠纷二审民事判决书.txt	依照 《 中华人民共和国 民事 诉讼法 》 第一百七十条 第一款 第 （ 二 ） 项之 规定 ， 判决 如下 ： 

张某甲诉李某甲离婚纠纷一案民事一审判决书.txt	据此 ， 依照 《 中华人民共和国 婚姻法 》 第三十二条 、 第三十六条 、 第三十七条 ， 最高人民法院 《 关于 人民法院 审理 离婚 案件 如何 认定 夫妻感情 确 已 破裂 的 若干 问题 的 意见 》 的 相关 规定 ， 判决 如下 ： 

张清凤与程元华离婚纠纷一审民事判决书.txt	依照 《 中华人民共和国 婚姻法 》 第三十二条 、 《 中华人民共和国 民事 诉讼法 》 第一百 四十二条 之 规定 ， 判决 如下 ： 

张莉与车晓辉离婚纠纷一审民事判决书.txt	依据 《 中华人民共和国 民事 诉讼法 》 第六十四 条 第一款 " 当事人 对 自己 提出 的 主张 ， 有 责任 提供 证据 。 " 和 《 最高人民法院 关于 民事诉讼 证据 的 若干 规定 》 第二条 " 当事人 对 自己 提出 的 诉讼请求 所 依据 的 事实 或者 反驳 对方 诉讼请求 所 依据 的 事实 有 责任 提供 证据 加以 证明 。 没有 证据 或者 证据 不足以 证明 当事人 的 事实 主张 的 ， 由 负有 举证责任 的 当事人 承担 不利 后果 " 之 规定 ， 判决 如下 ： 

张雷与唐凤飞离婚纠纷二审民事判决书.txt	依照 《 中华人民共和国 婚姻法 》 第三十二条 、 《 中华人民共和国 民事 诉讼法 》 第一百七十条 第一款 第 （ 二 ） 项 、 第一百七 十五条 之 规定 ， 判决 如下 ： 

强某某与马某某离婚纠纷一审民事判决书.txt	依照 《 中华人民共和国 婚姻法 》 第三十二条 第二款 、 《 中华人民共和国 民事诉讼 》 第 一百四十四 条 的 规定 ， 判决 如下 ： 

彭某与张某离婚纠纷一审民事判决书.txt	依照 《 中华人民共和国 婚姻法 》 第三十二条 第二款 的 规定 ， 判决 如下 ： 

彭某某与田某甲离婚纠纷案一审民事判决书.txt	根据 《 中华人民共和国 婚姻法 》 第三十二条 第二款 " 人民法院 审理 离婚 案件 ， 应当 进行 调解 ； 如 感情 确 已 破裂 、 调解 无效 ， 应 准予 离婚 " 的 规定 ， 判决 如下 ： 

彭某某与赖某某离婚纠纷案一审民事判决书.txt	据此 ， 为 维护 当事人 合法权益 ， 依照 《 中华人民共和国 婚姻法 》 第三十二条 和 《 中华人民共和国 民事 诉讼法 》 第一百 四十二条 之 规定 ， 判决 如下 ： 

彭某诉刘某离婚纠纷一案一审民事判决书.txt	依照 《 中华人民共和国 婚姻法 》 第三十二条 、 《 最高人民法院 关于 民事诉讼 证据 的 若干 规定 》 第二条 的 规定 ， 判决 如下 ： 

徐某与马某离婚纠纷一审民事判决书.txt	据此 ， 为 保护 当事人 的 合法权益 ， 维护 正常 婚姻家庭 秩序 ， 依照 《 中华人民共和国 民事 诉讼法 》 第六十四 条 和 《 最高人民法院 关于 适用 的 解释 》 第九 十条 的 规定 ， 判决 如下 ： 

徐某与黄某离婚纠纷一审民事判决书.txt	据此 ， 为 保护 当事人 的 合法权益 ， 维护 社会 、 家庭 的 和谐 稳定 ， 依照 《 中华人民共和国 婚姻法 》 第三十二条 第二款 、 《 中华人民共和国 民事 诉讼法 》 第六十四 条 、 《 最高人民法院 关于 民事诉讼 证据 的 若干 规定 》 第二条 的 规定 ， 判决 如下 ： 

徐某某与刘某某离婚纠纷一审民事判决书.txt	依照 《 中华人民共和国 婚姻法 》 第三十二条 、 《 中华人民共和国 民事 诉讼法 》 第六十四 条 、 《 最高人民法院 关于 民事诉讼 证据 的 若干 规定 》 第二条 之 规定 判决 如下 ： 

徐某某与郑某甲离婚纠纷一审民事判决书.txt	依照 《 中华人民共和国 婚姻法 》 第三十二条 ， 《 最高人民法院 关于 适用 ﹤ 中华人民共和国 民事 诉讼法 ﹥ 的 解释 》 第九 十条 的 规定 ， 判决 如下 ： 

徐某某与郝某某离婚纠纷一审民事判决书.txt	据此 ， 依照 《 中华人民共和国 民事 诉讼法 》 第六十四 条 第一款 、 《 最高人民法院 关于 民事诉讼 证据 的 若干 规定 》 第二条 之 规定 ， 判决 如下 ： 

徐某贵与贾某英离婚纠纷一审民事判决书.txt	据此 ， 为 保护 当事人 的 合法权益 ， 维护 正常 的 婚姻家庭 关系 ， 依照 《 中华人民共和国 婚姻法 》 第三十二条 第二款 的 规定 ， 判决 如下 ： 

戴某某与赖某某离婚纠纷案一审民事判决书.txt	依照 《 中华人民共和国 婚姻法 》 第三十二条 和 《 中华人民共和国 民事 诉讼法 》 第一百 四十二条 、 第一百 六十条 之 规定 ， 判决 如下 ： 

才某某与张某某离婚纠纷一审民事判决书.txt	依照 《 中华人民共和国 婚姻法 》 第三十二条 第一款 的 规定 ， 判决 如下 ： 

敬某某与梁某某离婚一审民事判决书.txt	依照 《 中华人民共和国 婚姻法 》 第三十二条 、 最高人民法院 关于 适用 《 中华人民共和国 民事 诉讼法 》 的 解释 第九 十条 之 规定 ， 判决 如下 ： 

敬某某诉税某某离婚纠纷一审民事判决书.txt	依照 《 中华人民共和国 婚姻法 》 第三十二条 的 规定 ， 判决 如下 ： 

敬某甲与敬某乙离婚纠纷一审民事判决书.txt	据此 ， 根据 《 中华人民共和国 婚姻法 》 第三十二条 、 《 中华人民共和国 民事 诉讼法 》 第六十四 条 及 《 最高人民法院 关于 民事诉讼 证据 的 若干 规定 》 第二条 之 规定 ， 判决 如下 ： 

敬某甲诉黄某离婚纠纷一审民事判决书.txt	依照 《 中华人民共和国 婚姻法 》 第三十二条 的 规定 ， 判决 如下 ： 

敬某诉冯某甲婚姻无效纠纷一审民事判决书.txt	据此 ， 依照 《 中华人民共和国 民法通则 》 第五十八 条 第一款 第 （ 一 ） 项 、 第二款 、 《 中华人民共和国 婚姻法 》 第十条 第一款 第 （ 三 ） 项 、 《 中华人民共和国 母婴 保健法 》 第八条 第 （ 三 ） 项 、 第九条 、 最高人民法院 关于 适用 《 中华人民共和国 婚姻法 》 若干 问题 的 解释 （ 二 ） 第三条 之 规定 ， 判决 如下 ： 

文某某与廖某某离婚纠纷案一审民事判决书.txt	依照 《 中华人民共和国 婚姻法 》 第三十二条 和 《 中华人民共和国 民事 诉讼法 》 第 一百四十四 条 、 第一百 六十条 之 规定 ， 判决 如下 ： 

文某某与杜某离婚纠纷一审民事判决书.txt	依照 《 中华人民共和国 婚姻法 》 第三十二条 、 《 中华人民共和国 民事 诉讼法 》 第六十四 条 第一款 、 《 最高人民法院 关于 适用 〈 中华人民共和国 民事 诉讼法 〉 的 解释 》 第九 十条 、 《 中华人民共和国 民事 诉讼法 》 第 一百四十四 条 之 规定 ， 判决 如下 ： 

文某某诉陈某离婚纠纷一审民事判决书.txt	依照 《 中华人民共和国 婚姻法 》 第三十二条 第二款 、 《 最高人民法院 关于 民事诉讼 证据 的 若干 规定 》 第二条 第二款 之 规定 ， 判决 如下 ： 

方某某与刘某甲离婚纠纷案一审民事判决书.txt	依据 《 中华人民共和国 婚姻法 》 第三十二条 第二款 、 第三款 、 第三十六条 、 第三十七条 第一款 的 规定 ， 判决 如下 ： 

易某与廖某某离婚纠纷案一审民事判决书.txt	依照 《 中华人民共和国 婚姻法 》 第三十二条 和 《 中华人民共和国 民事 诉讼法 》 第 一百四十四 条 、 第一百 六十条 之 规定 ， 判决 如下 ： 

易某某与雷某某离婚纠纷一审民事判决书.txt	据此 ， 依照 《 中华人民共和国 婚姻法 》 三十 一条 、 第四十六 条 、 《 最高人民法院 关于 适用 ﹤ 中华人民共和国 民事 诉讼法 ﹥ 的 解释 》 第九 十条 之 规定 ， 判决 如下 ： 

易某某诉顾某甲离婚纠纷一审民事判决书.txt	据此 ， 依照 《 中华人民共和国 婚姻法 》 第三十二条 ， 《 中华人民共和国 民事 诉讼法 》 第 一百四十四 条 ， 最高人民法院 《 关于 适用 ﹤ 中华人民共和国 民事 诉讼法 ﹥ 的 解释 》 第九 十条 之 规定 ， 判决 如下 ： 

曹某某与周某某离婚纠纷一审民事判决书.txt	依照 《 中华人民共和国 婚姻法 》 第三十二条 、 《 中华人民共和国 民事 诉讼法 》 第 一百四十四 条 及 最高人民法院 《 关于 民事诉讼 证据 的 若干 规定 》 第二条 第二款 的 规定 ， 判决 如下 ： 

曹某某与方某离婚纠纷一审民事判决书.txt	据此 ， 依照 《 中华人民共和国 婚姻法 》 第三十二条 ， 《 中华人民共和国 民事 诉讼法 》 第六十四 条 、 第一百 四十二条 ， 《 最高人民法院 关于 审理 民事诉讼 证据 的 若干 规定 》 第二条 之 规定 ， 判决 如下 ： 

曹某某与谢某某离婚后财产纠纷一审民事判决书.txt	据此 ， 为 保护 当事人 的 合法权益 ， 根据 《 中华人民共和国 物权法 》 第九条 、 第三十九条 ， 《 中华人民共和国 婚姻法 》 第三十九条 、 第四十一条 之 规定 ， 判决 如下 ： 

曹某某诉杨某某离婚纠纷一案一审民事判决书.txt	据此 ， 依照 《 中华人民共和国 婚姻法 》 第三十二条 第二款 、 《 中华人民共和国 民事 诉讼法 》 第六十四 第一款 、 第 一百四十四 条 、 最高人民法院 《 关于 民事诉讼 证据 的 若干 规定 》 第二条 、 第七十六条 之 规定 ， 判决 如下 ： 

曹某甲与李某某离婚纠纷一审民事判决书.txt	据此 ， 依照 《 中华人民共和国 婚姻法 》 第三十二条 、 《 最高人民法院 关于 适用 〈 中华人民共和国 民事 诉讼法 〉 的 解释 》 第九 十条 之 规定 ， 判决 如下 ： 

曹某甲与柳某某离婚纠纷一审民事判决书.txt	据此 ， 依照 《 中华人民共和国 婚姻法 》 第三十二条 ， 《 中华人民共和国 民事 诉讼法 》 第 一百四十四 条 ， 《 最高人民法院 关于 适用 〈 中华人民共和国 民事 诉讼法 〉 的 解释 》 第九 十条 之 规定 ， 判决 如下 ： 

曾某与袁某离婚纠纷一审民事判决书.txt	据此 ， 依照 《 中华人民共和国 婚姻法 》 第三十二条 、 《 中华人民共和国 民事 诉讼法 》 第六十四 条 、 《 最高人民法院 关于 适用 ﹤ 中华人民共和国 民事 诉讼法 ﹥ 的 解释 》 第九 十条 之 规定 ， 判决 如下 ： 

曾某与陈某甲离婚纠纷一审民事判决书.txt	依照 《 中华人民共和国 婚姻法 》 第三十二条 、 第三十九条 、 第四十一条 之 规定 ， 判决 如下 ： 

曾某某与徐某某离婚纠纷一审民事书.txt	据此 ， 为 维护 稳定 的 婚姻家庭 关系 ， 依照 《 中华人民共和国 婚姻法 》 第三十二条 ， 最高人民法院 《 关于 适用 〈 中华人民共和国 民事 诉讼法 〉 的 解释 》 第九 十条 的 规定 ， 判决 如下 ： 

曾某某与祝某某离婚纠纷一审民事判决书.txt	依照 《 中华人民共和国 婚姻法 》 第三十二条 第二款 、 第三款 第 （ 四 ） 项 、 第四十二条 、 最高人民法院 关于 适用 《 中华人民共和国 婚姻法 》 若干 问题 的 解释 （ 一 ） 第二十七条 第一款 、 第二款 的 规定 ， 判决 如下 ： 

曾某某诉刘某某离婚纠纷一审判决书.txt	据此 ， 依照 《 中华人民共和国 婚姻法 》 第三十二条 第一款 、 第二款 、 第三款 ， 最高人民法院 《 关于 人民法院 审理 离婚 案件 如何 认定 夫妻感情 确 已 破裂 的 若干 具体意见 》 第 1 条 ， 最高人民法院 《 关于 适用 ﹤ 中华人民共和国 民事 诉讼法 ﹥ 的 解释 》 第九 十条 之 规定 ， 判决 如下 ： 

曾某某诉刘某某离婚纠纷一审民事判决书.txt	依照 《 中华人民共和国 婚姻法 》 第三十二条 、 最高人民法院 《 关于 民事诉讼 证据 的 若干 规定 》 第二条 ， 《 中华人民共和国 民事 诉讼法 》 第 一百四十四 条 之 规定 ， 判决 如下 ： 

曾某某诉王某某离婚纠纷一审民事判决书.txt	依照 《 中华人民共和国 婚姻法 》 第三十二条 的 规定 ， 判决 如下 ： 

曾某甲与杨某甲离婚纠纷一审民事判决书.txt	据此 ， 依照 《 中华人民共和国 婚姻法 》 第三十二条 、 第三十六条 、 第三十七条 第一款 、 第三十八条 、 第三十九条 、 第四十一条 、 《 关于 人民法院 审理 离婚 案件 处理 子女 抚养 问题 的 若干 具体意见 》 第 7 条 的 规定 ， 判决 如下 ： 

曾然与朱永方离婚纠纷案一审民事判决书.txt	据此 ， 依照 《 中华人民共和国 婚姻法 》 第三十二条 第二款 人民法院 审理 离婚 案件 ， 应当 进行 调解 ； 如 感情 确 已 破裂 ， 调解 无效 ， 应 准予 离婚 。 的 规定 ， 判决 如下 ： 

未某与杨某甲离婚纠纷一审民事判决书.txt	依照 《 中华人民共和国 婚姻法 》 第三十二条 第二款 、 第三款 第 （ 五 ） 项之 规定 ， 判决 如下 ： 

朱某与刘某离婚纠纷一审民事判决书.txt	据此 ， 依据 《 中华人民共和国 婚姻法 》 第三十二条 、 最高人民法院 《 关于 民事诉讼 证据 的 若干 规定 》 第二条 和 《 中华 人民法院 于 民事 诉讼法 》 第 一百四十四 条 之 规定 ， 判决 如下 ： 

朱某与杜某离婚纠纷一审民事判决书.txt	据此 ， 依照 《 中华人民共和国 婚姻法 》 第三十二条 、 第三十六条 、 第三十七条 、 《 中华人民共和国 民事 诉讼法 》 第 一百四十四 条 和 《 最高人民法院 关于 民事诉讼 证据 的 若干 规定 》 第二条 之 规定 ， 判决 如下 ： 

朱某某与刘某某离婚纠纷一审民事判决书.txt	依照 《 中华人民共和国 婚姻法 》 第三十二条 第三款 （ 五 ） 项 的 规定 ， 判决 如下 ： 

朱某某与刘某某离婚纠纷一案一审民事判决书.txt	依照 《 中华人民共和国 婚姻法 》 第三十二条 " 男女 一方 要求 离婚 的 ， 可 由 有关 部门 进行 调解 或 直接 向 人民法院 提出 离婚 诉讼 。 人民法院 审理 离婚 案件 ， 应当 进行 调解 ； 如 感情 确 已 破裂 ， 调解 无效 ， 应 准予 离婚 。 有 下列 情形 之一 ， 调解 无效 的 ， 应 准予 离婚 ： （ 一 ） 重婚 或 有 配偶 者 与 他人 同居 的 ； （ 二 ） 实施 家庭暴力 或 虐待 、 遗弃 家庭成员 的 ； （ 三 ） 有 赌博 、 吸毒 等 恶习 屡教不改 的 ； （ 四 ） 因 感情 不 和 分居 满 二年 的 ； （ 五 ） 其他 导致 夫妻 感情破裂 的 情形 " 和 第四十一条 " 离婚 时 ， 原 为 夫妻 共同 生活 所负 的 债务 ， 应当 共同 偿还 。 共同财产 不足 清偿 的 ， 或 财产 归 各自 所有 的 ， 由 双方 协议 清偿 ； 协议 不成 时 ， 由 人民法院 判决 " 的 规定 ， 判决 如下 ： 

朱某某与杨某某离婚纠纷案一审民事判决书.txt	根据 《 中华人民共和国 婚姻法 》 第三十二条 、 第三十九条 ， 《 中华人民共和国 民事 诉讼法 》 第 一百四十四 条 的 规定 ， 缺席判决 如下 ： 

朱某某与沈某某离婚纠纷二审民事判决书.txt	依照 《 中华人民共和国 民事 诉讼法 》 第一百七十条 第一款 第 （ 二 ） 项 " 原 判决 、 裁定 认定 事实 错误 或者 适用法律 错误 的 ， 以 判决 、 裁定 方式 依法 改判 、 撤销 或者 变更 " 之 规定 ， 判决 如下 ： 

朱某某与王某某离婚纠纷一审民事判决书.txt	据此 ， 依照 《 中华人民共和国 婚姻法 》 第二十六条 、 第三十二条 的 规定 ， 判决 如下 ： 

朱某某与黄某某离婚纠纷一审民事判决书.txt	据此 ， 原告 请求 离婚 不 符合 婚姻法 的 规定 ， 本院 不予 支持 。 原告 对 其 起诉 主张 的 事实 ， 依照 民事 诉讼法 的 规定 负有 举证 证明 责任 ， 其 未 提供 充分 证据 证明 其 主张 ， 应当 依法 承担 相应 不利 的 法律 后果 。 据此 ， 依照 《 中华人民共和国 民事 诉讼法 》 第六十四 条 第一款 之 规定 ， 判决 如下 ： 

朱某某诉张某某离婚纠纷一审判决书.txt	据此 ， 依照 《 中华人民共和国 婚姻法 》 第三十二条 ， 《 中华人民共和国 民事 诉讼法 》 第 一百四十四 条 ， 最高人民法院 《 关于 民事诉讼 证据 若干 规定 》 第二条 的 规定 ， 判决 如下 ： 

朱某某诉黄某某离婚纠纷一审民事判决书.txt	据此 ， 本院 依照 《 中华人民共和国 婚姻法 》 第四条 、 第三十二条 ， 《 最高人民法院 关于 民事诉讼 证据 的 若干 规定 》 第二条 的 规定 ， 判决 如下 ： 

权某某与刘某甲离婚纠纷案一审民事判决书.txt	据此 ， 依照 《 中华人民共和国 婚姻法 》 第三十二条 第二款 " 人民法院 审理 离婚 案件 ， 应当 进行 调解 ； 如 感情 确 已 破裂 ， 调解 无效 ， 应 准予 离婚 。 " 之 规定 ， 判决 如下 ： 

李某与何某甲离婚纠纷一案二审民事判决书.txt	依照 《 中华人民共和国 民事 诉讼法 》 第一百七十条 第一款 第 （ 一 ） 项之 规定 ， 判决 如下 ： 

李某与刘某离婚纠纷一审民事判决书.txt	依照 《 中华人民共和国 婚姻法 》 第三十二条 第二款 、 第三款 、 《 最高人民法院 关于 民事诉讼 证据 的 若干 规定 》 第二条 及 《 中华人民共和国 民事 诉讼法 》 第 一百四十四 条 之 规定 ， 判决 如下 ： 

李某与安某离婚纠纷案一审民事判决书.txt	据此 ， 为 维护 当事人 合法权益 ， 依照 《 中华人民共和国 婚姻法 》 第三十二条 和 《 中华人民共和国 民事 诉讼法 》 第一百 四十二条 之 规定 ， 判决 如下 ： 

李某与张某某离婚纠纷一审民事判决书.txt	据此 ， 依照 《 中华人民共和国 婚姻法 》 第三十二条 、 第三十六条 的 规定 ， 判决 如下 ： 

李某与曹某甲离婚纠纷一审民事判决书.txt	依据 《 中华人民共和国 婚姻法 》 第三十二条 之 规定 ， 判决 如下 ： 

李某与曾某甲离婚纠纷一审民事判决书.txt	据此 ， 依照 《 中华人民共和国 民事 诉讼法 》 第六十四 条 、 第 一百四十四 条 和 《 最高人民法院 关于 适用 的 解释 》 第九 十条 的 规定 ， 判决 如下 ： 

李某与杨某离婚纠纷一审民事判决书.txt	据此 ， 依照 《 中华人民共和国 婚姻法 》 第三十二条 、 《 中华人民共和国 民事 诉讼法 》 第六十四 条 、 《 最高人民法院 关于 适用 ﹤ 中华人民共和国 民事 诉讼法 ﹥ 的 解释 》 第九 十条 之 规定 ， 判决 如下 ： 

李某与王某某离婚纠纷一审民事裁定书.txt	根据 《 中华人民共和国 民事 诉讼法 》 第 一百一十 九条 第 （ 二 ） 项 的 规定 ， 裁定 如下 ： 

李某与程某某离婚纠纷一审民事判决书.txt	据此 ， 依照 《 中华人民共和国 婚姻法 》 第三十二条 、 《 最高人民法院 关于 适用 〈 中华人民共和国 民事 诉讼法 〉 的 解释 》 第九 十条 之 规定 ， 判决 如下 ： 

李某与赵某离婚纠纷一审民事判决书.txt	依照 《 中华人民共和国 婚姻法 》 第三十二条 和 《 最高人民法院 关于 民事诉讼 证据 的 若干 规定 》 第二条 之 规定 ， 判决 如下 ： 

李某与阿某某离婚纠纷一审民事判决书.txt	据此 ， 依照 《 中华人民共和国 婚姻法 》 第三十二条 、 《 最高人民法院 关于 适用 〈 中华人民共和国 民事 诉讼法 〉 的 解释 》 第九 十条 之 规定 ， 判决 如下 ： 

李某与陈某离婚纠纷一审民事判决书.txt	依照 《 中华人民共和国 婚姻法 》 第三十二条 、 最高人民法院 《 关于 适用 〈 中华人民共和国 民事 诉讼法 〉 的 解释 》 第九 十条 之 规定 ， 判决 如下 ： 

李某与陈某离婚纠纷一审民事裁定书.txt	依照 《 中华人民共和国 民事 诉讼法 》 第 一百四十 五条 之 规定 ， 裁定 如下 ： 

李某冬与李某芳离婚纠纷一审民事判决书.txt	依照 《 中华人民共和国 民事 诉讼法 》 第 一百四十 三条 之 规定 ， 裁定 如下 ： 

李某某与严某某离婚纠纷案一审民事判决书.txt	依照 《 中华人民共和国 婚姻法 》 第三十二条 、 最高人民法院 《 关于 民事诉讼 证据 的 若干 规定 》 第二条 和 《 中华人民共和国 民事 诉讼法 》 第 一百四十四 条 、 第六十四 条 、 第一百 六十条 之 规定 ， 判决 如下 ： 

李某某与付某甲离婚纠纷案一审民事判决书.txt	根据 《 中华人民共和国 婚姻法 》 第三十二条 第二款 " 人民法院 审理 离婚 案件 ， 应当 进行 调解 ； 如 感情 确 已 破裂 、 调解 无效 ， 应 准予 离婚 。 " 的 规定 ， 判决 如下 ： 

李某某与任某某离婚纠纷一审民事判决书.txt	据此 ， 依照 《 中华人民共和国 婚姻法 》 第三十二条 三款 有 下列 情形 之一 ， 调解 无效 的 ， 应 准予 离婚 ： hellip ; hellip ; （ 五 ） 其他 导致 夫妻 感情破裂 的 情形 之 规定 ， 判决 如下 ： 

李某某与刘某某离婚纠纷一审民事判决书.txt	据此 ， 依照 《 中华人民共和国 婚姻法 》 第三十二条 、 《 最高人民法院 关于 民事诉讼 证据 的 若干 规定 》 第二条 之 规定 ， 判决 如下 ： 

李某某与姜某甲离婚纠纷案一审民事判决书.txt	据此 ， 本院 根据 《 中华人民共和国 婚姻法 》 第三十二条 第二款 " 人民法院 审理 离婚 案件 ， 应当 进行 调解 ； 如 感情 确 已 破裂 、 调解 无效 ， 应 准予 离婚 " 的 规定 ， 判决 如下 ： 

李某某与孟某甲离婚纠纷一审民事判决书.txt	依照 《 中华人民共和国 婚姻法 》 第三十二条 第二款 、 第三十六条 第三款 之 规定 ， 判决 如下 ： 

李某某与宋某某离婚纠纷一审民事判决书.txt	依照 《 中华人民共和国 婚姻法 》 第三十二条 、 第三十七条 ， 《 最高人民法院 关于 民事诉讼 证据 的 若干 规定 》 第二条 之 规定 ， 判决 如下 ： 

李某某与彭某某离婚纠纷一审民事判决书.txt	依照 《 中华人民共和国 婚姻法 》 第三十二条 ， 《 中华人民共和国 民事 诉讼法 》 第六十四 条 及 《 最高人民法院 关于 民事诉讼 证据 的 若干 规定 》 第二条 之 规定 ， 判决 如下 ： 

李某某与杨某甲离婚纠纷一审民事判决书.txt	依照 《 中华人民共和国 婚姻法 》 第三十二条 、 最高人民法院 《 关于 民事诉讼 证据 的 若干 规定 》 第二条 的 规定 ， 判决 如下 ： 

李某某与杨某离婚纠纷案一审民事判决书.txt	依照 《 中华人民共和国 婚姻法 》 第三十二条 和 《 中华人民共和国 民事 诉讼法 》 第一百 四十二条 、 第 一百四十四 条 之 规定 ， 判决 如下 ： 

李某某与王某某离婚纠纷一审民事判决书.txt	据此 ， 为 保护 当事人 合法权益 ， 依照 《 中华人民共和国 婚姻法 》 第三十二条 第二款 第四项 、 最高人民法院 《 关于 人民法院 审理 离婚 案件 如何 认定 夫妻感情 确 已 破裂 的 若干 具体意见 》 第七条 之 规定 ， 判决 如下 : 

李某某与肖某某离婚纠纷一审民事判决书.txt	据此 ， 为了 保护 当事人 的 合法权益 ， 维护 家庭 及 社会 的 稳定 ， 依照 《 中华人民共和国 民事 诉讼法 》 第六十四 条 第一款 ， 《 中华人民共和国 婚姻法 》 第三十二条 第二款 ， 《 最高人民法院 关于 民事诉讼 证据 的 若干 规定 》 第二条 的 规定 ， 判决 如下 ： 

李某某与肖甲离婚纠纷一审民事判决书.txt	依照 《 中华人民共和国 婚姻法 》 第三十二条 ， 最高人民法院 《 关于 适用 ﹤ 中华人民共和国 民事 诉讼法 ﹥ 的 解释 》 第九 十条 之 规定 ， 判决 如下 ： 

李某某与莫某甲离婚纠纷一审民事判决书.txt	据此 ， 依照 《 中华人民共和国 婚姻法 》 第三十二条 第三款 第 （ 五 ） 项 、 第三十六条 、 第三十七条 、 《 中华人民共和国 民事 诉讼法 》 第六十四 条 第一款 、 最高人民法院 《 关于 适用 < 中华人民共和国 民事 诉讼法 > 的 解释 》 第九 十条 之 规定 ， 判决 如下 ： 

李某某与蒋某某离婚纠纷一审民事判决书.txt	据此 ， 依照 《 中华人民共和国 民事 诉讼法 》 第 一百四十四 条 、 《 最高人民法院 关于 适用 ﹤ 中华人民共和国 民事 诉讼法 ﹥ 的 解释 》 第九 十条 之 规定 ， 判决 如下 ： 

李某某与薛某某离婚纠纷一审民事判决书.txt	据此 ， 依照 《 中华人民共和国 婚姻法 》 第三十二条 、 第三十七条 之 规定 ， 判决 如下 ： 

李某某与许某某离婚纠纷一审民事判决书.txt	依据 《 中华人民共和国 婚姻法 》 第十八条 、 三十二条 之 规定 判决 如下 ： 

李某某与贺某甲离婚纠纷一审民事判决书.txt	依照 《 中华人民共和国 婚姻法 》 第三十二条 的 规定 ， 判决 如下 ： 

李某某与陈某甲离婚纠纷一审民事判决书.txt	据此 ， 依照 《 中华人民共和国 婚姻法 》 第三十二条 、 《 中华人民共和国 民事 诉讼法 》 第六十四 条 第一款 、 第 一百四十四 条 、 《 最高人民法院 关于 适用 〈 中华人民共和国 民事 诉讼法 〉 的 解释 》 第九 十条 第二款 之 规定 ， 判决 如下 ： 

李某某与马某甲离婚纠纷一案一审民事判决书.txt	据此 ， 依照 《 中华人民共和国 婚姻法 》 第三十二条 第二款 、 第三十六条 第一款 、 第三款 、 第三十七条 第一款 之 规定 ， 判决 如下 ： 

李某某与黄某甲离婚纠纷一审民事判决书.txt	据此 ， 依照 《 中华人民共和国 婚姻法 》 第三十二条 、 《 中华人民共和国 民事 诉讼法 》 第六十四 条 第一款 以及 《 最高人民法院 关于 适用 〈 中华人民共和国 民事 诉讼法 〉 的 解释 》 第九 十条 之 规定 ， 判决 如下 ： 

李某某与黄某甲离婚纠纷案一审民事判决书.txt	依照 《 中华人民共和国 婚姻法 》 第三十二条 第二款 " 人民法院 审理 离婚 案件 ， 应当 进行 调解 ； 如 感情 确 已 破裂 ， 调解 无效 ， 应 准予 离婚 " 的 规定 ， 判决 如下 ： 

李某某芬诉袁某离婚纠纷一审民事判决书.txt	依照 《 中华人民共和国 婚姻法 》 第三十二条 的 规定 ， 判决 如下 ： 

李某某诉吉某某离婚纠纷一审民事判决书.txt	据此 ， 对 原告 李 某某 的 诉讼请求 ， 本院 不予 支持 ， 依照 《 中华人民共和国 婚姻法 》 第三十二条 之 规定 ， 判决 如下 ： 

李某某诉张某某离婚纠纷一审民事判决书.txt	依照 《 中华人民共和国 婚姻法 》 第三十二条 ， 《 最高人民法院 关于 民事诉讼 证据 的 若干 规定 》 第二条 ， 《 中华人民共和国 民事 诉讼法 》 第一百 四十二条 之 规定 ， 判决 如下 ： 

李某某诉曹某甲离婚纠纷一审民事判决书.txt	据此 ， 依照 《 中华人民共和国 婚姻法 》 第三十二条 、 第三十七条 第一款 之 规定 ， 判决 如下 ： 

李某某诉王某某离婚纠纷一审判决书.txt	据此 ， 依照 《 中华人民共和国 婚姻法 》 第三十二条 、 最高人民法院 《 关于 适用 ﹤ 中华人民共和国 民事 诉讼法 ﹥ 的 解释 》 第九 十条 之 规定 ， 判决 如下 ： 

李某某诉王某某离婚纠纷判决书.txt	根据 《 中华人民共和国 婚姻法 》 第三十二条 的 规定 ， 判决 如下 ： 

李某某诉罗某某离婚纠纷一审判决书.txt	据此 ， 依照 《 中华人民共和国 婚姻法 》 第三十二条 、 《 中华人民共和国 民事 诉讼法 》 第六十四 条 第一款 、 《 最高人民法院 关于 民事诉讼 证据 的 若干 规定 》 第二条 、 第七十六条 的 规定 ， 判决 如下 ： 

李某某诉胡某某离婚纠纷一审民事判决书.txt	依照 《 中华人民共和国 婚姻法 》 第三十二条 、 最高人民法院 《 关于 民事诉讼 证据 的 若干 规定 》 第二条 之 规定 ， 判决 如下 ： 

李某某诉陈某某离婚纠纷一审民事判决书.txt	依照 《 中华人民共和国 婚姻法 》 第二十五条 第二款 、 第三十二条 第二款 、 第三款 第四项 、 第三十六条 第三款 、 第三十九条 第一款 ， 《 中华人民共和国 民事 诉讼法 》 第 一百四十四 条 ， 最高人民法院 《 关于 适用 < 中华人民共和国 民事 诉讼法 > 的 解释 》 第九 十条 之 规定 ， 判决 如下 ： 

李某波与邓某燕离婚纠纷一审民事判决书.txt	据此 ， 为 保护 当事人 的 合法权益 ， 维护 社会 、 家庭 的 和谐 稳定 ， 依照 《 中华人民共和国 婚姻法 》 第三十二条 第二款 、 《 中华人民共和国 民事 诉讼法 》 第六十四 条 、 《 最高人民法院 关于 民事诉讼 证据 的 若干 规定 》 第二条 的 规定 ， 判决 如下 ： 

李某甲与冯某甲离婚纠纷一审民事判决书.txt	依照 《 中华人民共和国 婚姻法 》 第三十二条 、 第三十六条 、 第三十七条 、 《 中华人民共和国 民事 诉讼法 》 第六十四 条 第一款 以及 《 最高人民法院 关于 适用 ﹤ 中华人民共和国 民事 诉讼法 ﹥ 的 解释 》 第九 十条 之 规定 ， 判决 如下 ： 

李某甲与卢某某离婚纠纷一审判决书.txt	据此 ， 依照 《 中华人民共和国 婚姻法 》 第三十二条 第二款 、 第三十六条 、 第三十七条 的 规定 ， 判决 如下 ： 

李某甲与欧某某离婚纠纷案一审民事判决书.txt	根据 《 中华人民共和国 婚姻法 》 第三十二条 第二款 、 第三款 、 第三十六条 第三款 、 之 规定 ， 判决 如下 ： 

李某甲与被告李某乙离婚纠纷一审民事裁定书.txt	依照 《 中华人民共和国 民事 诉讼法 》 第 一百四十 五条 的 规定 ， 裁定 如下 ： 

李某甲与黄某某离婚纠纷一案一审民事判决书.txt	根据 《 中华人民共和国 婚姻法 》 第十七条 第一款 " 夫妻 在 婚姻关系 存续 期间 所得 的 下列 财产 ， 归 夫妻 共同 所有 ： （ 二 ） 生产 、 经营 的 收益 ； （ 五 ） 其他 应当 归 共同 所有 的 财产 " 、 第三十二条 第三款 第 （ 四 ） 项 " 有 下列 情形 之一 ， 调解 无效 的 ， 应 准予 离婚 ： （ 四 ） 因 感情 不合 分居 满 两年 的 " 、 第三十六条 " 父母 与 子女 间 的 关系 ， 不 因 父母 离婚 而 消除 。 离婚 后 ， 子女 无论 由 父 或 母 直接 抚养 ， 仍 是 父母 双方 的 子女 。 离婚 后 ， 父母 对于 子女 仍 有 抚养 和 教育 的 权利 和 义务 " 、 第三十八条 " 离婚 后 ， 不 直接 抚养 子女 的 父 或 母 ， 有 探望 子女 的 权利 ， 另一方 有 协助 的 义务 " ； 第三十九条 ： " 离婚 时 ， 夫妻 的 共同财产 由 双方 协议 处理 ； 协议 不成 时 ， 由 人民法院 根据 财产 的 具体情况 ， 照顾 子女 和 女方 权益 的 原则 判决 " 、 第四十一条 " 离婚 时 ， 原 为 夫妻 共同 生活 所负 的 债务 ， 应当 共同 偿还 。 共同财产 不足 清偿 的 ， 或 财产 归 各自 所有 的 ， 由 双方 协议 清偿 ； 协议 不成 时 ， 由 人民法院 判决 " 、 《 中华人民共和国 民事 诉讼法 》 第六十四 条 第一款 " 当事人 对 自己 提出 的 主张 ， 有 责任 提供 证据 " 的 规定 判决 如下 ： 

李某甲诉李某乙离婚纠纷一审民事判决书.txt	根据 《 中华人民共和国 婚姻法 》 第三十二条 第二款 ， 《 中华人民共和国 民事 诉讼法 》 第六十四 条 第一款 ， 《 最高人民法院 关于 适用 ﹤ 中华人民共和国 民事 诉讼法 ﹥ 的 解释 》 第九十 一条 ， 《 最高人民法院 关于 民事诉讼 证据 的 若干 规定 》 第二条 之 规定 ， 判决 如下 ： 

李某甲诉陈某甲离婚纠纷一审民事判决书.txt	据此 ， 依照 《 中华人民共和国 婚姻法 》 第三十二条 ， 最高人民法院 《 关于 适用 ﹤ 中华人民共和国 民事 诉讼法 ﹥ 的 解释 》 第九 十条 之 规定 ， 判决 如下 ： 

李某诉夏某离婚纠纷判决书.txt	依照 《 中华人民共和国 婚姻法 》 第三十二条 之 规定 ， 判决 如下 ： 本案 经 本院 主持 调解 ， 双方 当事人 自愿 达成 如下 协议 ： 

李良伟与雷东梅离婚纠纷一案民事判决书.txt	依照 《 中华人民共和国 婚姻法 》 第三十二条 、 第二十一条 ， 《 最高人民法院 关于 人民法院 审理 离婚 案件 如何 认定 夫妻感情 确 已 破裂 的 若干 具体意见 》 第 12 条 ， 《 中华人民共和国 民事 诉讼法 》 第 一百四十四 条 之 规定 ， 判决 如下 ： 

杜某某与于某某离婚纠纷一审民事判决书.txt	依照 《 中华人民共和国 婚姻法 》 第三十二条 、 《 中华人民共和国 民事 诉讼法 》 第六十四 第一款 、 第 一百四十四 条 、 最高人民法院 《 关于 适用 〈 中华人民共和国 民事 诉讼法 〉 的 解释 》 第九 十条 之 规定 ， 判决 如下 ： 

杜某某与李某某离婚纠纷案一审民事判决书.txt	依照 《 中华人民共和国 婚姻法 》 第三十二条 和 《 中华人民共和国 民事 诉讼法 》 第一百 四十二条 、 第一百五十 三条 、 第一百 六十条 之 规定 ， 判决 如下 ： 

杜某某与罗某甲离婚纠纷一案一审民事判决书.txt	据此 ， 依照 《 中华人民共和国 婚姻法 》 第三十二条 " ...... 人民法院 审理 离婚 案件 ， 应当 进行 调解 ； 如 感情 确 已 破裂 ， 调解 无效 ， 应 准予 离婚 。 " 之 规定 ， 判决 如下 ： 

杜某某与袁某某离婚纠纷一审民事判决书.txt	依照 《 最高人民法院 关于 〈 人民法院 审理 未办 结婚登记 而 以 夫妻 名义 同居 生活 案件 〉 的 若干意见 》 第六条 之 规定 ： " 审理 事实 婚姻关系 的 离婚 案件 ， 应当 先 进行 调解 。 经 调解 和 好 或 撤诉 的 ， 确认 婚姻关系 有效 ， 发给 调解书 或 裁定书 ； 经 调解 不能 和 好 的 ， 应 调解 或 判决 准予 离婚 。 " 。 本案 中 ， 被告 外出 至今 不 归 ， 不 履行 夫妻 、 家庭 义务 ， 原告 及其 子女 与 被告 无法 取得联系 ， 本院 依法 向 被告 公告送达 开庭 传票 ， 但 被告 拒 不 出庭 参与 诉讼 ， 本院 无法 组织 原 、 被告 双方 调解 ， 且 原告 也 未 向 本院 递交 撤诉 申请书 ， 故对 原告 要求 与 被告 离婚 的 诉请 本院 依法 予以 支持 。 原告 主张 夫妻 共同财产 依法 分割 ， 因 原告 未 向 法庭 提供 证据 证明 存在 夫妻 共同财产 ， 故对 原告 的 该项 诉请 ， 本院 依法 不予 支持 。 依照 《 最高人民法院 关于 适用 〈 中华人民共和国 婚姻法 〉 若干 问题 的 解释 （ 一 ） 》 第五条 、 《 最高人民法院 关于 〈 人民法院 审理 未办 结婚登记 而 以 夫妻 名义 同居 生活 案件 〉 的 若干意见 》 第六条 、 《 中华人民共和国 民事 诉讼法 》 第六十四 条 、 第 一百四十四 条 之 规定 ， 判决 如下 ： 

杜某某与郑某某离婚纠纷一案二审民事裁定书.txt	依照 《 中华人民共和国 民事 诉讼法 》 第一百七 十三条 关于 第二审 人民法院 判决 宣告 前 ， 上诉人 申请 撤回 上诉 的 ， 是否 准许 ， 由 第二审 人民法院 裁定 之 规定 ， 裁定 如下 ： 

杜某某与龚某某离婚纠纷案一审民事判决书.txt	据此 ， 为 维护 当事人 合法权益 ， 依照 《 中华人民共和国 婚姻法 》 第三十二条 和 《 中华人民共和国 民事 诉讼法 》 第 一百四十四 条 之 规定 ， 判决 如下 ： 

杜某某诉何某某离婚纠纷一审民事裁定书.txt	依照 《 中华人民共和国 民事 诉讼法 》 第 一百四十 三条 " 原告 经 传票 传唤 ， 无 正当理由 拒 不 到庭 的 ， 或者 未经 法庭 许可 中途 退庭 的 ， 可以 按 撤诉 处理 ； 被告 反诉 的 ， 可以 缺席判决 " 之 规定 ， 裁定 如下 ： 

杜某某诉牟某甲离婚纠纷判决书.txt	根据 《 中华人民共和国 民事 诉讼法 》 第 一百四十四 条 、 《 中华人民共和国 婚姻法 》 第三十二条 的 规定 ， 判决 如下 ： 

杜某甲与田某某离婚纠纷一审民事判决书.txt	据此 ， 依照 《 中华人民共和国 婚姻法 》 第三十二条 、 第三十七条 ， 《 最高人民法院 关于 人民法院 审理 离婚 案件 处理 子女 抚养 问题 的 若干 具体意见 》 第 5 条 、 《 最高人民法院 关于 人民法院 审理 离婚 案件 处理 财产 分割 问题 的 若干 具体意见 》 第 20 条 、 《 最高人民法院 关于 适用 ﹤ 中华人民共和国 民事 诉讼法 ﹥ 的 解释 》 第九 十条 之 规定 ， 判决 如下 ： 

杨光仙诉彭代金离婚纠纷一审民事判决书.txt	根据 《 中华人民共和国 婚姻法 》 第三十二条 " 有 下列 情形 之一 ， 调解 无效 的 ， 应 准予 离婚 ： （ 四 ） 因 感情 不 和 满 二年 的 ； （ 五 ） 其他 导致 夫妻 感情破裂 的 情形 " 之 规定 ， 应 视为 夫妻感情 确 已 破裂 。 原告 坚持 离婚 ， 经 调解 和 好 无效 ， 原告 的 离婚 诉讼请求 ， 本院 予以 支持 。 对 共同财产 房屋 ， 因 原告 自愿 放弃 其 应得 部分 并 赠与 被告 所有 ， 本院 予以 支持 。 被告 辩称 共同 收入 余额 应有 十几万元 ， 但 未 提供 证据 证明 ， 本院 不予 支持 。 对 被告 辩称 若 离婚 原告 应 给 被告 15 万元 补偿款 ， 于法无据 ， 本院 不予 支持 。 本院 在 查明 事实 ， 分清是非 责任 的 基础 上 ， 经 调解 和 好 无效 ， 根据 《 中华人民共和国 婚姻法 》 第三十二条 、 第三十九条 之 规定 ， 判决 如下 : 

杨小莉与陈阆离婚纠纷一审民事判决书.txt	据此 ， 依照 《 中华人民共和国 婚姻法 》 第十七条 第 （ 一 ） 项 、 第三十二条 、 第三十七条 、 第三十八条 之 规定 ， 判决 如下 ： 

杨晓龙与刘彩玉离婚纠纷一审民事判决书.txt	据此 ， 依照 《 中华人民共和国 婚姻法 》 第三十二条 第二款 " 人民法院 审理 离婚 案件 ， 应当 进行 调解 ； 如 感情 确 已 破裂 ， 调解 无效 ， 应 准予 离婚 ...... " 、 《 中华人民共和国 民事 诉讼法 》 第九十二 条 " 受 送达 人 下落不明 ， 或者 用 本节 规定 的 其他 方式 无法 送达 的 ， 公告送达 。 自 发出 公告 之日起 经过 六十日 ， 即 视为 送达 。 " 和 第 一百四十四 条 " 被告 经 传票 传唤 ， 无 正当理由 拒 不 到庭 的 ， 或者 未经 法庭 许可 中途 退庭 的 ， 可以 缺席判决 " 之 规定 ， 判决 如下 ： 

杨某与刘某离婚纠纷一审民事判决书.txt	依照 《 中华人民共和国 婚姻法 》 第三十二条 第二款 之 规定 ， 判决 如下 ： 

杨某与卓某甲离婚纠纷一审民事判决书.txt	据此 ， 依照 《 中华人民共和国 民事 诉讼法 》 第六十四 条 和 《 最高人民法院 关于 适用 的 解释 》 第九 十条 的 规定 ， 判决 如下 ： 

杨某与吴某某离婚纠纷一审民事判决书.txt	据此 ， 依照 《 中华人民共和国 婚姻法 》 第三十二条 第 （ 五 ） 款 、 第三十六条 第三款 之 规定 ， 判决 如下 ： 

杨某与唐某离婚纠纷一审民事判决书.txt	判决 如下 ： 

杨某与夏某某离婚纠纷一审民事裁定书.txt	据此 ， 依照 《 中华人民共和国 民事 诉讼法 》 第 一百四十 五条 第一款 、 第一百五十四条 第一款 第 （ 五 ） 项之 规定 ， 裁定 如下 ： 

杨某与廖某某离婚纠纷案一审民事判决书.txt	依照 《 中华人民共和国 婚姻法 》 第三十二条 和 《 中华人民共和国 民事 诉讼法 》 第 一百四十四 条 、 第一百 六十条 之 规定 ， 判决 如下 ： 

杨某与成某某离婚纠纷一审民事判决书.txt	依照 《 中华人民共和国 民事诉讼 》 第 一百二十八 条 和 《 中华人民共和国 婚姻法 》 第三十二条 之 规定 ， 判决 如下 ： 

杨某与李某离婚纠纷一审民事判决书.txt	依照 《 中华人民共和国 婚姻法 》 第三十二条 第一款 男女 一方 要求 离婚 的 ， 可 由 有关 部门 进行 调解 或 直接 向 人民法院 提出 离婚 诉讼 。 之 规定 ， 故 对于 原告 杨某 提出 与 被告 李某 离婚 的 诉讼 ， 本院 应予 受理 。 原告 杨某 请求 与 被告 李某 离婚 ， 但 未 提供 证明 夫妻感情 确 已 破裂 的 证据 ， 依照 《 最高人民法院 关于 适用 ﹤ 中华人民共和国 民事 诉讼法 ﹥ 的 解释 》 第九 十条 ： 当事人 对 自己 提出 的 诉讼请求 所 依据 的 事实 或者 反驳 对方 诉讼请求 所 依据 的 事实 ， 应当 提供 证据 加以 证明 ， 但 法律 另 有 规定 的 除外 。 在 作出 判决 前 ， 当事人 未能 提供 证据 或者 证据 不足以 证明 其 事实 主张 的 ， 由 负有 举证 证明 责任 的 当事人 承担 不利 的 后果 。 之 规定 ， 对 原告 的 诉讼请求 ， 故 本院 不予 支持 。 被告 李某 经 本院 传票 传唤 未 到庭 参加 诉讼 ， 依照 《 中华人民共和国 民事 诉讼法 》 第 一百四十四 条 被告 经 传票 传唤 ， 无下 当 理由 拒 不 到庭 的 ， 或 未经 法庭 许何 中途 退庭 的 ， 可以 缺席判决 ， 被告 经 人民法院 传唤 ， 无 正当理由 拒 不 到庭 ， 不 影响 对 本案 公正 审理 ， 由此 可能 产生 的 不利 后果 由其 自行 承担 。 为 保护 当事人 的 合法权益 ， 维护 正常 的 婚姻家庭 关系 ， 依照 《 中华人民共和国 婚姻法 》 第三十二条 第二款 之 规定 ， 判决 如下 ： 

杨某与程某甲离婚纠纷一审民事判决书.txt	据此 ， 依照 《 中华人民共和国 民事 诉讼法 》 第六十四 条 、 第 一百四十四 条 和 《 最高人民法院 关于 适用 的 解释 》 第九 十条 的 规定 ， 判决 如下 ： 

杨某与罗某甲离婚纠纷一审民事判决书.txt	依照 《 中华人民共和国 婚姻法 》 第三十二条 和 最高人民法院 《 关于 民事诉讼 证据 的 若干 规定 》 第二条 之 规定 ， 判决 如下 ： 

杨某与陈某离婚纠纷一审民事判决书.txt	依照 《 中华人民共和国 婚姻法 》 第三十二条 、 第三十六条 、 《 中华人民共和国 民事 诉讼法 》 第六十四 条 第一款 、 《 最高人民法院 关于 民事诉讼 证据 的 若干 规定 》 第二条 及 《 中华 人民法院 于 民事 诉讼法 》 第 一百四十四 条 之 规定 ， 判决 如下 ： 

杨某会与李某离婚纠纷一审民事判决书.txt	依照 《 中华人民共和国 婚姻法 》 第三十二条 第二款 、 《 最高人民法院 关于 民事诉讼 证据 的 若干 规定 》 第二条 之 规定 ， 判决 如下 ： 

杨某某与何某某离婚纠纷案一审民事判决书.txt	依照 《 中华人民共和国 婚姻法 》 第三十二条 和 《 中华人民共和国 民事 诉讼法 》 第 一百四十四 条 、 第一百 六十条 之 规定 ， 判决 如下 ： 

杨某某与司某离婚纠纷一审民事判决书.txt	据此 ， 依照 《 中华人民共和国 婚姻法 》 第三十二条 " 男女 一方 要求 离婚 的 ， 可 由 有关 部门 进行 调解 或 直接 向 人民法院 提出 离婚 诉讼 。 人民法院 审理 离婚 案件 ， 应当 进行 调解 ； 如 感情 确 已 破裂 ， 调解 无效 ， 应 准予 离婚 " 之 规定 ， 判决 如下 ： 

杨某某与吕某离婚纠纷案一审民事判决书.txt	依照 《 中华人民共和国 婚姻法 》 第三十二条 和 《 中华人民共和国 民事 诉讼法 》 第一百 四十二条 、 第一百 六十条 之 规定 ， 判决 如下 ： 

杨某某与吴某某离婚纠纷一审民事判决书.txt	据此 ， 依照 《 中华人民共和国 婚姻法 》 第三十二条 、 《 中华人民共和国 民事 诉讼法 》 第六十四 条 、 第 一百四十四 条 及 《 最高人民法院 关于 民事诉讼 证据 的 若干 规定 》 第二条 之 规定 ， 判决 如下 ： 

杨某某与唐某某离婚纠纷一审民事判决书.txt	据此 ， 依照 《 中华人民共和国 婚姻法 》 第三十二条 （ 五 ） 项 、 《 最高人民法院 关于 人民法院 审理 离婚 案件 如何 认定 夫妻感情 已 破裂 的 若干 具体意见 》 第七条 之 规定 ， 判决 如下 ： 

杨某某与张某某离婚纠纷一审民事判决书.txt	据此 ， 为 维护 当事人 的 合法权益 ， 根据 《 中华人民共和国 婚姻法 》 第三十二条 、 《 中华人民共和国 民事 诉讼法 》 第六十四 条 、 《 最高人民法院 关于 民事诉讼 证据 若干 问题 的 规定 》 第二条 之 规定 ， 判决 如下 ： 

杨某某与张某离婚纠纷案一审民事判决书.txt	依照 《 中华人民共和国 婚姻法 》 第三十二条 和 《 中华人民共和国 民事 诉讼法 》 第一百 四十二条 、 第一百 六十条 之 规定 ， 判决 如下 ： 

杨某某与彭某某离婚纠纷案一审民事判决书.txt	据此 ， 依照 《 中华人民共和国 婚姻法 》 第三十二条 第一 、 二 、 三款 的 规定 ， 判决 如下 ： 

杨某某与李某某离婚纠纷民事一审判决书.txt	依照 《 中华人民 共和 民事 诉讼法 》 第六十四 条 第一款 、 第一百 四十二条 ， 《 最高人民法院 关于 民事诉讼 证据 的 若干 规定 》 第二条 的 规定 ， 判决 如下 ： 

杨某某与李某甲离婚一审民事判决书.txt	依照 《 中华人民共和国 婚姻法 》 第三十二条 、 最高人民法院 关于 适用 《 中华人民共和国 民事 诉讼法 》 的 解释 第九 十条 之 规定 ， 判决 如下 ： 

杨某某与李某离婚纠纷一审民事判决书.txt	依照 《 中华人民共和国 婚姻法 》 第三十二条 之 规定 ， 原告 要求 离婚 的 诉讼请求 ， 本院 予以 支持 。 依照 《 中华人民共和国 婚姻法 》 第三十六条 之 规定 ， 结合 本院 调查 证实 ， 婚生子 李某 甲 从小 生活 于 被告 家中 ， 且 上学 亦 由 被告 父母 负责 接送 ， 如 改变 生活 环境 将 明显 不利于 婚生子 李某 甲 的 健康成长 ， 同时 原告 在 诉讼 过程 中 亦 表示 婚生子 李某 甲 可 由 被告 抚养 ， 故 本院认为 婚生子 李某 甲 随 被告 生活 、 由 被告 抚养 监护 更 有利于 其 身心健康 ； 依照 《 中华人民共和国 婚姻法 》 第三十七条 之 规定 ， 结合 婚生子 李某 甲 经常 生活 地 的 生活 水平 及其 年龄 情况 ， 本院 确定 原告 杨 某某 每月 支付 婚生子 李某 甲 生活费 400 元 ， 婚生子 李某 甲 的 教育费 、 医疗 费用 由 原被告 各 承担 50 % 。 关于 原被告 的 共同财产 和 债权债务 问题 ， 因 被告 未 到庭 应诉 ， 本案 无法 查明 相关 情况 ， 故 本案 不宜 处理 。 综上所述 ， 依照 《 中华人民共和国 婚姻法 》 第三十二条 、 第三十六条 、 第三十七条 和 《 中华人民共和国 民事 诉讼法 》 第 一百四十四 条 之 规定 ， 判决 如下 ： 

杨某某与王某某离婚纠纷一审民事判决书.txt	依照 《 中华人民共和国 婚姻法 》 第三十二条 、 《 最高人民法院 关于 民事诉讼 证据 的 若干 规定 》 第二条 之 规定 ， 判决 如下 ： 

杨某某与王某某离婚纠纷案一审民事判决书.txt	依照 《 中华人民共和国 婚姻法 》 第三十二条 和 《 中华人民共和国 民事 诉讼法 》 第一百 四十二条 、 第 一百四十四 条 之 规定 ， 判决 如下 ： 

杨某某与窦某甲离婚纠纷一审民事判决书.txt	据此 ， 依照 《 中华人民共和国 婚姻法 》 第三十二条 、 《 中华人民共和国 民事 诉讼法 》 第六十四 条 第一款 以及 《 最高人民法院 关于 适用 〈 中华人民共和国 民事 诉讼法 〉 的 解释 》 第九 十条 之 规定 ， 判决 如下 ： 

杨某某与翟某甲离婚纠纷一审民事判决书.txt	依照 《 中华人民共和国 婚姻法 》 第三十二条 第三款 （ 五 ） 项 、 第三十六条 、 第三十九条 、 第四十二条 的 规定 ， 判决 如下 ： 

杨某某与谢某某离婚纠纷一审民事判决书.txt	据此 ， 为 维护 正常 的 婚姻家庭 秩序 ， 依照 《 中华人民共和国 婚姻法 》 第三十二条 ， 《 中华人民共和国 民事 诉讼法 》 第六十四 条 第一款 ， 《 最高人民法院 关于 适用 〈 中华人民共和国 民事 诉讼法 〉 的 解释 》 第九 十条 的 规定 ， 判决 如下 ： 

杨某某与陈某某离婚纠纷案一审民事判决书.txt	根据 《 中华人民共和国 婚姻法 》 第三十二条 ， 判决 如下 ： 

杨某某诉梁某离婚纠纷一审判决书.txt	据此 ， 依照 《 中华人民共和国 婚姻法 》 第三十二条 第三款 第 （ 五 ） 项 、 《 中华人民共和国 民事 诉讼法 》 第六十四 条 第一款 、 第 一百四十四 条 、 《 最高人民法院 关于 民事诉讼 证据 的 若干 规定 》 第二条 、 第七十六条 的 规定 ， 判决 如下 ： 

杨某某诉王某离婚纠纷一审民事判决书.txt	据此 ， 依照 《 中华人民共和国 婚姻法 》 第三十二条 、 第三十六条 、 第三十七条 之 规定 ， 判决 如下 ： 

杨某某诉蒲某甲离婚纠纷一案民事判决书.txt	据此 ， 依照 《 中华人民共和国 婚姻法 》 第三十二条 、 第三十七条 之 规定 ， 判决 如下 ： 

杨某甲与向某甲离婚纠纷一审民事判决书.txt	据此 ， 依照 《 中华人民共和国 婚姻法 》 第三十二条 第三款 第 （ 五 ） 项 、 第三十六条 、 第三十七条 、 最高人民法院 《 关于 人民法院 审理 离婚 案件 如何 认定 夫妻感情 确 已 破裂 的 若干 具体意见 》 第 7 条 和 《 中华人民共和国 民事 诉讼法 》 第六十四 条 第一款 之 规定 ， 判决 如下 ： 

杨某甲与李某某离婚纠纷一审民事判决书.txt	依照 《 中华人民共和国 婚姻法 》 第三十二条 ， 《 中华人民共和国 民事 诉讼法 》 第六十四 条 第一款 、 第一百 四十二条 ， 《 最高人民法院 关于 适用 〈 中华人民共和国 民事 诉讼法 〉 的 解释 》 第九 十条 的 规定 ， 判决 如下 ： 

杨某甲与李某某离婚纠纷案一审民事判决书.txt	根据 《 中华人民共和国 婚姻法 》 第三十二条 第二款 、 第三款 之 规定 ， 判决 如下 ： 

杨某甲与贾某甲离婚纠纷一审民事判决书.txt	据此 ， 根据 《 中华人民共和国 婚姻法 》 第三十二条 、 《 中华人民共和国 民事 诉讼法 》 第六十四 条 及 《 最高人民法院 关于 民事诉讼 证据 的 若干 规定 》 第二条 之 规定 ， 判决 如下 ： 

杨某诉朱某某离婚纠纷一审民事判决书.txt	据此 ， 依照 《 中华人民共和国 婚姻法 》 第三十二条 、 第三十七条 、 《 最高人民法院 关于 适用 〈 中华人民共和国 婚姻法 〉 若干 问题 的 解释 （ 一 ） 》 第二十一条 、 《 最高人民法院 关于 人民法院 审理 离婚 案件 处理 子女 抚养 问题 的 若干 具体意见 》 第一条 、 第七条 之 规定 ， 判决 如下 ： 

杨某诉陈某某离婚纠纷一案一审民事判决书.txt	依照 《 中华人民共和国 婚姻法 》 第三十二条 、 《 中华人民共和国 民事 诉讼法 》 第一百 四十八条 之 规定 ， 判决 如下 ： 

杨泽英与程昌荣离婚纠纷案一审民事判决书.txt	据此 ， 依照 《 中华人民共和国 婚姻法 》 第三十二条 第二款 人民法院 审理 离婚 案件 ， 应当 进行 调解 ； 如 感情 确 已 破裂 ， 调解 无效 ， 应 准予 离婚 。 的 规定 ， 判决 如下 ： 

杨甲某某与张某某离婚纠纷一审民事判决书.txt	依照 《 中华人民共和国 婚姻法 》 第三十二条 第二款 、 第三十七条 第一款 、 第四十二条 之 规定 ， 判决 如下 ： 

杨红与吴维离婚纠纷案一审民事判决书.txt	据此 ， 依照 《 中华人民共和国 婚姻法 》 第三十二条 第二款 人民法院 审理 离婚 案件 ， 应当 进行 调解 ； 如 感情 确 已 破裂 ， 调解 无效 ， 应 准予 离婚 。 的 规定 ， 判决 如下 ： 

林某某与侯某某离婚纠纷一审民事判决书.txt	依照 《 中华人民共和国 婚姻法 》 第三十二条 和 《 中华人民共和国 民事 诉讼法 》 第六十四 条 、 第一百 四十二条 的 规定 ， 判决 如下 ： 

林某某与吴某甲离婚纠纷一审民事判决书.txt	据此 ， 依照 《 中华人民共和国 婚姻法 》 第三十二条 第二款 、 第四十二条 之 规定 ， 判决 如下 ： 

林某某与王某甲离婚纠纷一审民事判决书.txt	据此 ， 依据 《 中华人民共和国 婚姻法 》 第三十二条 之 规定 ， 判决 如下 ： 

林某某与陈某甲离婚纠纷一审民事判决书.txt	依照 《 中华人民共和国 婚姻法 》 第三十二条 、 最高人民法院 《 关于 民事诉讼 证据 的 若干 规定 》 第二条 的 规定 ， 判决 如下 ： 

柏某甲与胡某甲离婚纠纷一审民事判决书.txt	依照 《 中华人民共和国 婚姻法 》 第三十二条 、 《 中华人民共和国 民事 诉讼法 》 第一百 四十二条 的 规定 ， 判决 如下 ： 

桑某某诉何某某离婚纠纷一审判决书.txt	据此 ， 依据 《 中华人民共和国 婚姻法 》 第三十二条 的 规定 ， 判决 如下 ： 

梁某与柳某甲离婚纠纷一审民事判决书.txt	依据 《 中华人民共和国 婚姻法 》 第三十二条 之 规定 ， 判决 如下 ： 

梁某与陈某离婚纠纷一审民事判决书.txt	根据 《 中华人民共和国 婚姻法 》 第三十二条 、 《 中华人民共和国 民事 诉讼法 》 第六十四 条 和 《 最高人民法院 关于 民事诉讼 证据 的 若干 规定 》 第二条 之 规定 ， 判决 如下 ： 

梁某某与彭某某离婚纠纷一审民事判决书.txt	依照 《 中华人民共和国 婚姻法 》 第三十二条 的 规定 ， 判决 如下 ： 

梁某某与罗某某离婚纠纷一审民事判决书.txt	据此 ， 依照 《 中华人民共和国 婚姻法 》 第三十二条 ， 《 中华人民共和国 民事 诉讼法 》 第六十四 条 第一款 、 第 一百四十四 条 ， 《 最高人民法院 关于 民事诉讼 证据 的 若干 规定 》 第二条 ， 《 最高人民法院 关于 适用 ﹤ 中华人民共和国 民事 诉讼法 ﹥ 的 解释 》 的 规定 ， 判决 如下 ： 

梁某某与赵某某离婚纠纷一审民事判决书.txt	据此 ， 依照 《 中华人民共和国 婚姻法 》 第三十二条 ， 《 中华人民共和国 民事 诉讼法 》 第一百 四十二条 之 规定 ， 判决 如下 ： 

梁某某诉雷某某离婚纠纷一审民事判决书.txt	据此 ， 依照 《 中华人民共和国 婚姻法 》 第三十二条 ， 最高人民法院 《 关于 适用 ﹤ 中华人民共和国 民事 诉讼法 ﹥ 的 解释 》 第九 十条 之 规定 ， 判决 如下 ： 

梁某甲与万某某离婚纠纷一审民事判决书.txt	据此 ， 依照 《 中华人民共和国 婚姻法 》 第二十条 、 第三十二条 、 《 中华人民共和国 民事 诉讼法 》 第六十四 条 之 规定 ， 判决 如下 ： 

梁某甲与唐某某离婚纠纷一审民事判决书.txt	据此 ， 依照 《 中华人民共和国 婚姻法 》 第三十二条 第二款 、 第三款 （ 四 ） 项 、 第三十九条 第一款 ， 《 中华人民共和国 民事 诉讼法 》 第 一百四十四 条 之 规定 ， 判决 如下 ： 

梅某某与王某离婚纠纷一审民事判决书.txt	据此 ， 依照 《 中华人民共和国 婚姻法 》 第三十二条 第三款 第 （ 四 ） 项 和 《 中华人民共和国 民事 诉讼法 》 第 一百四十四 条 之 规定 ， 判决 如下 ： 

樊某某与江某某离婚纠纷一审民事判决书.txt	依照 《 中华人民共和国 婚姻法 》 第三十二条 、 最高人民法院 《 关于 适用 〈 中华人民共和国 民事 诉讼法 〉 的 解释 》 第九 十条 之 规定 ， 判决 如下 ： 

欧中凯诉祝枝玉离婚纠纷一审民事判决书.txt	依照 《 中华人民共和国 婚姻法 》 第三十二条 、 最高人民法院 《 关于 民事诉讼 证据 的 若干 规定 》 第二条 和 《 民事 诉讼法 》 第 一百四十四 条 的 规定 ， 判决 如下 ： 

欧某某与张某某离婚纠纷一审民事判决书.txt	依照 《 中华人民共和国 婚姻法 》 第三十二条 和 《 中华人民共和国 民事 诉讼法 》 第一百 四十二条 的 规定 ， 判决 如下 ： 

欧某某与李某某离婚纠纷案一审民事判决书.txt	依照 《 中华人民共和国 婚姻法 》 第三十二条 和 《 中华人民共和国 民事 诉讼法 》 第六十四 条 、 第一百 四十二条 、 第一百 六十条 之 规定 ， 判决 如下 ： 

欧某甲与刘某某离婚纠纷一审民事判决书.txt	依照 《 中华人民共和国 婚姻法 》 第三十二条 第二款 " 人民法院 审理 离婚 案件 ， 应当 进行 调解 ； 如 感情 确 已 破裂 ， 调解 无效 ， 应 准予 离婚 " ， 《 中华人民共和国 民事 诉讼法 》 第六十四 条 第一款 " 当事人 对 自己 提出 的 主张 ， 有 责任 提供 证据 " ， 《 最高人民法院 关于 民事诉讼 证据 的 若干 规定 》 第二条 " 当事人 对 自己 提出 的 诉讼请求 所 依据 的 事实 或者 反驳 对方 诉讼请求 所 依据 的 事实 有 责任 提供 证据 加以 证明 。 没有 证据 或者 证据 不足以 证明 当事人 的 事实 主张 的 ， 由 负有 举证责任 的 当事人 承担 不利 后果 " 之 规定 ， 判决 如下 ： 

武某甲与卢某某离婚纠纷一审民事判决书.txt	据此 ， 依照 《 中华人民共和国 婚姻法 》 第三十二条 、 《 中华人民共和国 民事 诉讼法 》 第六十四 条 及 《 最高人民法院 关于 民事诉讼 证据 的 若干 规定 》 第二条 之 规定 ， 判决 如下 ： 

段某某与杨某某离婚纠纷一审民事裁定书.txt	依照 《 中华人民共和国 民事 诉讼法 》 第 一百四十 三条 之 规定 ， 裁定 如下 ： 

段某某与陈某离婚纠纷一审民事判决书.txt	据此 ， 依照 《 中华人民共和国 婚姻法 》 第三十二条 " 男女 一方 要求 离婚 的 ， 可 由 有关 部门 进行 调解 或 直接 向 人民法院 提出 离婚 诉讼 。 人民法院 审理 离婚 案件 ， 应当 进行 调解 ； 如 感情 确 已 破裂 ， 调解 无效 ， 应 准予 离婚 " 、 《 中华人民共和国 民事 诉讼法 》 第 一百四十四 条 " 被告 经 传票 传唤 ， 无 正当理由 拒 不 到庭 的 ， 或者 未经 法庭 许可 中途 退庭 的 ， 可以 缺席判决 " 之 规定 ， 判决 如下 ： 

母某某与赵某某离婚纠纷一审民事裁定书.txt	依照 《 中华人民共和国 民事 诉讼法 》 第 一百四十 三条 、 第一百五十四条 第一款 （ 十一 ） 项之 规定 ， 裁定 如下 ： 

母某甲与姜某甲离婚纠纷一审民事判决书.txt	依照 《 中华人民共和国 婚姻法 》 第三十二条 、 《 中华人民共和国 民事 诉讼法 》 第六十四 条 第一款 以及 《 最高人民法院 关于 适用 ﹤ 中华人民共和国 民事 诉讼法 ﹥ 的 解释 》 第九 十条 之 规定 ， 判决 如下 ： 

母某甲与杨某某离婚纠纷一审民事判决书.txt	据此 ， 依照 《 中华人民共和国 婚姻法 》 第三十二条 、 第三十六条 、 第三十七条 、 第四十条 、 《 中华人民共和国 民事 诉讼法 》 第 一百四十四 条 之 规定 ， 判决 如下 ： 

毛某某与冯某某离婚纠纷一事民事裁定书.txt	本院 在 审理 原告 毛 某某 诉 被告 冯 某某 离婚 纠纷 一案 中 ， 因 原告 毛 某某 未 在 本院 确定 的 期限内 预交 案件 受理费 。 依照 最高人民法院 《 关于 适用 〈 中华人民共和国 民事 诉讼法 〉 的 解释 》 第 213 条 " 原告 应当 预交 而 未 预交 案件 受理费 ， 人民法院 应当 通知 其 预交 ， 通知 后 仍 不 预交 或者 申请 减 、 缓 、 免 未获 批准 而 仍 不 预交 的 ， 裁定 按 撤诉 处理 。 " 之 规定 ， 裁定 如下 ： 

毛某某与李某甲离婚纠纷一审民事判决书.txt	据此 ， 依据 《 中华人民共和国 婚姻法 》 第三十二条 之 规定 ， 判决 如下 ： 

毛某某诉黄某甲离婚纠纷一审民事判决书.txt	依照 《 中华人民共和国 婚姻法 》 第三十二条 的 规定 ， 判决 如下 ： 

江某琼与赵某离婚纠纷一审民事判决书.txt	据此 ， 为 保护 当事人 的 合法权益 ， 维护 社会 、 家庭 的 和谐 稳定 ， 依照 《 中华人民共和国 婚姻法 》 第三十二条 第二款 、 《 中华人民共和国 民事 诉讼法 》 第六十四 条 、 《 最高人民法院 关于 民事诉讼 证据 的 若干 规定 》 第二条 的 规定 ， 判决 如下 ： 

汤某某与何某某离婚后财产纠纷一审民事判决书.txt	据此 ， 根据 《 中华人民共和国 民法通则 》 第八 十五条 、 第 一百一十 一条 ； 《 中华人民共和国 民事 诉讼法 》 第六十四 条 ； 最高人民法院 关于 适用 《 中华人民共和国 婚姻法 》 若干 问题 的 解释 的 相关 规定 ， 判决 如下 ： 

汤某某与高某甲离婚纠纷一审民事判决书.txt	据此 ， 依照 《 中华人民共和国 婚姻法 》 第三十二条 、 第三十六条 、 第三十七条 第一款 、 最高人民法院 《 关于 人民法院 审理 离婚 案件 如何 认定 夫妻感情 确 已 破裂 的 若干 具体意见 》 第 7 条 、 《 关于 人民法院 审理 离婚 案件 处理 子女 抚养 问题 的 若干 具体意见 》 第 7 条 的 规定 ， 判决 如下 ： 

汤某甲与何某某离婚纠纷一审民事判决书.txt	据此 ， 依照 《 中华人民共和国 婚姻法 》 第三十二条 ， 最高人民法院 《 关于 民事诉讼 证据 若干 问题 的 规定 》 第二条 之 规定 ， 判决 如下 ： 

汪某与李某甲离婚纠纷一审民事判决书.txt	依照 《 中华人民共和国 婚姻法 》 第三十二条 、 《 中华人民共和国 民事 诉讼法 》 第六十四 条 第一款 和 《 最高人民法院 关于 民事诉讼 证据 的 若干 规定 》 第二条 之 规定 ， 判决 如下 ： 

汪某某与黄某某离婚纠纷案一审民事判决书.txt	根据 《 中华人民共和国 婚姻法 》 第三十二条 ， 判决 如下 ： 

汪某某诉王某某离婚纠纷一审民事判决书.txt	据此 ， 本院 依照 《 中华人民共和国 婚姻法 》 第四条 、 第三十二条 、 《 最高人民法院 关于 民事诉讼 证据 的 若干 规定 》 第二条 的 规定 ， 判决 如下 ： 

沈某某诉黄某甲离婚纠纷一审民事判决书.txt	据此 ， 原告 请求 与 被告 离婚 ， 不予 支持 。 依照 《 中华人民共和国 民事 诉讼法 》 第六十四 条 第一款 " 当事人 对 自己 提出 的 主张 ， 有 责任 提供 证据 。 " ， 《 中华人民共和国 婚姻法 》 第三十二条 第二款 " 人民法院 审理 离婚 案件 ， 应当 进行 调解 ， 如 感情 确 已 破裂 ， 调解 无效 ， 应 准予 离婚 。 " 的 规定 ， 判决 如下 ： 

滕某某与李某某离婚纠纷案一审民事判决书.txt	依照 《 中华人民共和国 婚姻法 》 第三十二条 、 第三十九条 和 《 中华人民共和国 民事 诉讼法 》 第 一百四十四 条 、 第一百 六十条 之 规定 ， 判决 如下 ： 

潘某与叶某离婚纠纷一审民事判决书.txt	据此 ， 依照 《 中华人民共和国 婚姻法 》 第三十二条 第二款 的 规定 ， 判决 如下 ： 

潘某某与刘某某离婚纠纷案一审民事判决书.txt	据此 ， 依照 《 中华人民共和国 婚姻法 》 第三十二条 、 最高人民法院 《 关于 适用 ﹤ 中华人民共和国 民事 诉讼法 ﹥ 的 解释 》 第九 十条 之 规定 ， 判决 如下 ： 

焦某某与王某某离婚纠纷一审民事判决书.txt	依照 《 中华人民共和国 民事 诉讼法 》 第一百 四十二条 和 《 中华人民共和国 婚姻法 》 第三十二条 的 规定 ， 判决 如下 ： 

熊某与何某甲离婚纠纷一审民事判决书.txt	据此 ， 依照 《 中华人民共和国 民事 诉讼法 》 第六十四 条 、 第 一百四十四 条 和 《 最高人民法院 关于 适用 的 解释 》 第九 十条 的 规定 ， 判决 如下 ： 

熊某某与张某甲离婚纠纷一审民事判决书.txt	依照 《 中华人民共和国 婚姻法 》 第四条 、 第三十二条 第二款 ， 《 最高人民法院 关于 民事诉讼 证据 的 若干 规定 》 第二条 之 规定 ， 判决 如下 ： 

熊某某与杨某某离婚纠纷案一审民事判决书.txt	依照 《 中华人民共和国 婚姻法 》 第三十二条 、 最高人民法院 《 关于 民事诉讼 证据 的 若干 规定 》 第二条 和 《 中华人民共和国 民事 诉讼法 》 第六十四 条 、 第一百 四十二条 、 第一百 六十条 之 规定 ， 判决 如下 ： 

熊某某与熊某明离婚纠纷一审民事判决书.txt	据此 ， 为了 保护 当事人 的 合法权益 ， 维护 家庭 及 社会 的 和谐 稳定 ， 依照 《 中华人民共和国 婚姻法 》 第三十六条 第一 、 二款 、 第三十七条 第一 、 二款 ， 《 中华人民共和国 未成年人 保护法 》 第十条 第一款 之 规定 ， 判决 如下 ： 

熊某某与罗某离婚后财产纠纷一审民事判决书.txt	据此 ， 依照 《 中华人民共和国 物权法 》 第三十三条 、 《 中华人民共和国 婚姻法 》 第 四十八条 之 规定 ， 判决 如下 ： 

熊某某与胡某某离婚纠纷一审民事判决书.txt	根据 《 中华人民共和国 婚姻法 》 第三十二条 之 规定 ， 判决 如下 ： 

熊某某与陈某某离婚纠纷一审民事判决书.txt	本院认为 ： 夫妻感情 是否 确 已 破裂 是 人民法院 判决 准予 离婚 或 不 准予 离婚 的 法定条件 。 原告 向 本院 起诉 离婚 ， 经 本院 判决 不准 离婚 后 ， 双方 仍 未 取得联系 ， 长期 分居 生活 ， 互不 履行 夫妻 义务 。 符合 《 最高人民法院 关于 人民法院 审理 离婚 案件 如何 认定 夫妻感情 确 已 破裂 的 若干 具体意见 》 第 7 条 " 因 感情 不 和 分居 已 满 3 年 ， 确无 和 好 可能 的 ， 或者 经 人民法院 判决 不准 离婚 后 又 分居 满 1 年 ， 互不 履行 夫妻 义务 的 " 之 规定 ， 应 认定 原 、 被告 的 夫妻感情 已经 完全 破裂 。 因此 对 原告 熊 某某 的 离婚 诉请 ， 本院 予以 支持 。 关于 子女 抚养 问题 ， 婚生女 陈某 甲 跟随 被告 生活 ， 婚生子 陈某乙 随 原告 生活 ， 为了 孩子 的 健康成长 ， 以及 原 、 被告 的 实际 情况 ， 本院 支持 原告 的 诉讼请求 ， 婚生女 陈某甲 由 被告 抚养 并 承担 抚养费 ， 婚生子 陈某乙 由 原告 抚养 并 承担 抚养费 。 综上所述 ， 依照 我国 《 婚姻法 》 第三十二条 第三款 第 （ 四 ） 项 " 有 下列 情形 之一 ， 调解 无效 的 ， 应 准予 离婚 ： ...... （ 四 ） 因 感情 不 和 分居 满 二年 的 " 、 第三十六条 第三款 " 离婚 后 ， 哺乳期 内 的 子女 ， 以 随 哺乳 的 母亲 抚养 为 原则 。 哺乳期 后 的 子女 ， 如 双方 因 抚养 问题 发生争执 不能 达成协议 时 ， 由 人民法院 根据 子女 的 权益 和 双方 的 具体情况 判决 " ， 《 民事 诉讼法 》 第 一百四十四 条 " 被告 经 传票 传唤 ， 无 正当理由 拒 不 到庭 的 ， 或者 未经 法庭 许可 中途 退庭 的 ， 可以 缺席判决 。 " 之 规定 ， 判决 如下 ： 

牟某成与胡某碧离婚纠纷一审民事判决书.txt	据此 ， 为了 维护 婚姻家庭 的 完整 ， 根据 《 中华人民共和国 婚姻法 》 第三十二条 二款 和 《 最高人民法院 关于 民事诉讼 证据 的 若干 规定 》 第二条 二款 之 规定 ， 判决 如下 ： 

牟某某与龚甲某某离婚纠纷一审民事判决书.txt	依照 《 中华人民共和国 婚姻法 》 第三十二条 第二款 、 第三十七条 第一款 之 规定 ， 判决 如下 ： 

王伟、王聪章、杨正芬与牟秀娟、牟进兴、潘华蓉离婚后财产纠纷一案二审民事判决书.txt	依照 《 中华人民共和国 民事 诉讼法 》 第一百七十条 第一款 第 （ 一 ） 项 ， 《 最高人民法院 关于 适用 ﹤ 中华人民共和国 民事 诉讼法 ﹥ 的 解释 》 第三 百三 十四条 的 规定 ， 判决 如下 ： 

王小芹与罗举康离婚纠纷一审民事判决书.txt	据此 ， 依照 《 中华人民共和国 婚姻法 》 第三十二条 、 《 最高人民法院 关于 民事诉讼 证据 的 若干 规定 》 第二条 ， 判决 如下 ： 

王某与何某离婚纠纷一审民事判决书.txt	据此 ， 依照 《 中华人民共和国 民事 诉讼法 》 第六十四 条 第一款 、 《 最高人民法院 关于 民事诉讼 证据 的 若干 规定 》 第二条 之 规定 ， 判决 如下 ： 

王某与刘某离婚纠纷一审民事判决书.txt	据此 ， 为 保护 当事人 的 合法权益 ， 维护 正常 的 婚姻家庭 关系 ， 依照 《 中华人民共和国 婚姻法 》 第三十二条 第二款 的 规定 ， 判决 如下 ： 

王某与张某某离婚纠纷一案民事判决书.txt	依照 《 中华人民共和国 婚姻法 》 第三十二条 和 《 最高人民法院 关于 民事诉讼 证据 的 若干 规定 》 第二条 之 规定 ， 判决 如下 ： 

王某与彭某甲离婚纠纷一审民事判决书.txt	根据 《 最高人民法院 关于 民事诉讼 证据 的 若干 规定 》 第二条 " 当事人 对 自己 提出 的 诉讼请求 所 依据 的 事实 或 反驳 对方 诉讼请求 所 依据 的 事实 有 责任 提供 证据 加以 证明 。 没有 证据 或 证据 不足以 证明 当事人 的 事实 主张 的 ， 由 负有 举证责任 的 当事人 承担 不利 后果 " 的 规定 ， 原告 应 就 其 夫妻感情 确 已 破裂 提供 证据 证实 ， 否则 应 承担 举证 不能 的 法律 后果 。 本案 中原 、 被告 双方 虽 家庭 锁 事 产生矛盾 ， 但 原 、 被告 双方 并 无 原则性 的 矛盾 和 分歧 ， 且 原 、 被告 已 结婚 多年 ， 更 应 慎重对待 婚姻大事 ， 成就 一次 完美 的 婚姻 需要 原 、 被告 双方 共同 理解 忍让 。 希望 今后 双方 相互 关爱 包容 ， 加强 沟通 与 交流 ， 双方 是 能够 消除隔阂 并 和睦 生活 的 ， 且 原告 王某 未能 提交 充分 的 证据 证明 其 夫妻感情 确 已 完全 破裂 。 故 原告 王某 主张 与 被告 彭某 甲 离婚 的 诉讼请求 不 成立 ， 本院 不予 支持 。 根据 《 中华人民共和国 婚姻法 》 第三十二条 、 《 中华人民共和国 民事 诉讼法 》 第六十四 条 和 《 最高人民法院 关于 民事诉讼 证据 的 若干 规定 》 第二条 之 规定 ， 判决 如下 ： 

王某与罗某甲离婚纠纷一审民事判决书.txt	据此 ， 为 保护 当事人 的 合法权益 ， 维护 正常 婚姻家庭 秩序 ， 依照 《 中华人民共和国 民事 诉讼法 》 第六十四 条 和 《 最高人民法院 关于 适用 的 解释 》 第九 十条 的 规定 ， 判决 如下 ： 

王某与谢某离婚纠纷一审民事判决书.txt	据此 ， 为 保护 当事人 的 合法权益 ， 依照 《 中华人民共和国 婚姻法 》 第三十二条 第二款 、 第三款 （ 五 ） 项 、 第三十六条 第三款 之 规定 ， 判决 如下 ： 

王某与雷某某离婚纠纷一审民事裁定书.txt	依照 《 中华人民共和国 民事 诉讼法 》 第 一百四十四 条 、 《 中华人民共和国 婚姻法 》 第三十二条 、 第三十六条 、 第三十七条 、 第三十八条 的 规定 ， 判决 如下 ： 

王某全与刘某国离婚纠纷一审民事判决书.txt	依据 《 中华人民共和国 婚姻法 》 第三十二条 第二款 、 《 最高人民法院 关于 人民法院 审理 离婚 案件 如何 认定 夫妻感情 确 已 破裂 的 若干 具体意见 》 第十二条 、 《 中华人民共和国 婚姻法 》 第三十七条 第一款 的 规定 ， 判决 如下 ： 

王某某与吴某某离婚纠纷一审民事判决书.txt	据此 ， 依照 《 中华人民共和国 婚姻法 》 第三十二条 " 男女 一方 要求 离婚 的 ， 可 由 有关 部门 进行 调解 或 直接 向 人民法院 提出 离婚 诉讼 。 人民法院 审理 离婚 案件 ， 应当 进行 调解 ； 如 感情 确 已 破裂 ， 调解 无效 ， 应 准予 离婚 " 之 规定 ， 判决 如下 ： 

王某某与吴某某离婚纠纷案一审民事判决书.txt	据此 ， 依照 《 中华人民共和国 婚姻法 》 第三十二条 、 第三十六条 、 第三十七条 、 第四十二条 之 规定 ， 判决 如下 ： 

王某某与周某某离婚纠纷一审民事判决书.txt	据此 ， 为 维护 当事人 的 合法权益 ， 根据 《 中华人民共和国 民事 诉讼法 》 第六十四 条 、 《 中华人民共和国 婚姻法 》 第三十二条 、 最高人民法院 关于 适用 《 中华人民共和国 民事 诉讼法 》 的 解释 第九 十条 之 规定 ， 判决 如下 ： 

王某某与孙某离婚纠纷一审民事判决书.txt	据此 ， 依照 《 中华人民共和国 婚姻法 》 第三十二条 第三款 第 （ 五 ） 项 、 最高人民法院 《 关于 人民法院 审理 离婚 案件 如何 认定 夫妻感情 确 已 破裂 的 若干 具体意见 》 第十二条 及 《 中华人民共和国 民事 诉讼法 》 第九十二 条 、 第 一百四十四 条 之 规定 ， 判决 如下 ： 

王某某与寇某某离婚纠纷一审民事判决书.txt	依照 《 中华人民共和国 婚姻法 》 第三十二条 、 第三十九条 、 《 中华人民共和国 民事 诉讼法 》 第 一百四十四 条 之 规定 ， 判决 如下 ： 

王某某与张某某离婚纠纷一审民事判决书.txt	据此 ， 为了 保护 当事人 的 合法权益 ， 维护 家庭 及 社会 的 稳定 ， 依照 《 中华人民共和国 民事 诉讼法 》 第六十四 条 第一款 、 最高人民法院 关于 适用 《 中华人民共和国 民事 诉讼法 》 的 解释 第九 十条 第二款 和 《 最高人民法院 关于 民事诉讼 证据 的 若干 规定 》 第二条 之 规定 ， 判决 如下 ： 

王某某与张某甲离婚纠纷一审民事判决书.txt	据此 ， 依照 《 中华人民共和国 婚姻法 》 第二十一条 、 第三十二条 、 第四十一条 、 《 中华人民共和国 民事 诉讼法 》 第六十四 条 之 规定 ， 判决 如下 ： 

王某某与李某某离婚纠纷案一审民事判决书.txt	依照 《 中华人民共和国 婚姻法 》 第三十二条 、 第四十六 条 和 《 中华人民共和国 民事 诉讼法 》 第一百 四十二条 、 第一百 六十条 之 规定 ， 判决 如下 ： 

王某某与李某甲离婚纠纷一审民事判决书.txt	据此 ， 依照 《 中华人民共和国 婚姻法 》 第三十二条 、 《 最高人民法院 关于 适用 中华人民共和国 婚姻法 若干 问题 的 解释 一 》 第五条 第一款 之 规定 ， 判决 如下 ： 

王某某与杨某甲离婚纠纷一审民事判决书.txt	据此 ， 依照 《 中华人民共和国 婚姻法 》 第三十二条 、 《 最高人民法院 关于 民事诉讼 证据 的 若干 规定 》 第二条 之 规定 ， 判决 如下 ： 

王某某与梁某某离婚纠纷一审民事判决书.txt	据此 ， 依照 《 中华人民共和国 婚姻法 》 第三十二条 第二款 、 《 中华人民共和国 民事 诉讼法 》 第六十四 条 第一款 、 《 最高人民法院 关于 适用 〈 中华人民共和国 民事 诉讼法 〉 的 解释 》 第九 十条 第二款 之 规定 ， 判决 如下 ： 

王某某与熊某某离婚纠纷案一审民事判决书.txt	据此 ， 为 维护 当事人 合法权益 ， 依照 《 中华人民共和国 婚姻法 》 第三十二条 和 《 中华人民共和国 民事 诉讼法 》 第一百 四十二条 之 规定 ， 判决 如下 ： 

王某某与罗某某离婚纠纷一审民事判决书.txt	依照 《 中华人民共和国 婚姻法 》 第三十二条 ， 《 中华人民共和国 民事 诉讼法 》 第一百 四十二条 的 规定 ， 判决 如下 ： 

王某某与许某某离婚纠纷一案一审民事判决书.txt	据此 本院认为 原 、 被告 现 确无 和 好 可能 ， 夫妻感情 已 完全 破裂 ， 被告 辩称 等 婚生子 结婚 后 再 考虑 离婚 ， 但 是否 离婚 以 夫妻感情 是否 破裂 为 依据 ， 被告 的 辩称 于法无据 本院 不予 支持 ， 故 原告 请求 离婚 应予 准许 。 综上所述 ， 本院 为 维护 正常 的 社会秩序 ， 保护 当事人 合法权益 ， 依照 《 中华人民共和国 婚姻法 》 第三十二条 二 、 三款 " 人民法院 审理 离婚 案件 ， 应当 进行 调解 ； 如 感情 确 已 破裂 ， 调解 无效 ， 应 准予 离婚 " 之 规定 ， 判决 如下 ： 

王某某与谢某某离婚纠纷案一审民事判决书.txt	依照 《 中华人民共和国 婚姻法 》 第三十二条 和 《 中华人民共和国 民事 诉讼法 》 第六十四 条 、 第一百 四十二条 、 第一百 六十条 之 规定 ， 判决 如下 ： 

王某某与赵某某甲离婚纠纷一审民事判决书.txt	依照 《 中华人民共和国 婚姻法 》 第三十二条 第二款 、 《 中华人民共和国 民事 诉讼法 》 第六十四 条 第一款 、 《 最高人民法院 关于 适用 〈 中华人民共和国 民事 诉讼法 〉 的 解释 》 第九 十条 之 规定 ， 判决 如下 ： 

王某某与赵某某离婚后财产纠纷一审民事判决书.txt	根据 《 中华人民共和国 合同法 》 第八条 、 第一百零七条 、 《 最高人民法院 关于 适用 〈 中华人民共和国 婚姻法 〉 若干 问题 的 解释 （ 二 ） 》 第八条 之 规定 ， 判决 如下 ： 

王某某与陈某某离婚纠纷一审民事判决书.txt	依照 《 中华人民共和国 婚姻法 》 第三十二条 和 《 最高人民法院 关于 民事诉讼 证据 的 若干 规定 》 第二条 的 规定 ， 判决 如下 ： 

王某某与陈某某离婚纠纷案一审民事判决书.txt	依照 《 中华人民共和国 婚姻法 》 第三十二条 和 《 中华人民共和国 民事 诉讼法 》 第 一百四十四 条 、 第一百 六十条 之 规定 ， 判决 如下 ： 

王某某与马某甲离婚纠纷一审民事判决书.txt	依照 《 中华人民共和国 婚姻法 》 第三十二条 ； 《 中华人民共和国 民事 诉讼法 》 第六十四 条 ； 最高人民法院 关于 适用 《 中华人民共和国 民事 诉讼法 》 的 解释 第九 十条 的 规定 ， 判决 如下 ： 

王某某与黄某某离婚纠纷一审民事判决书.txt	依据 《 中华人民共和国 婚姻法 》 第三十二条 ： 人民法院 审理 离婚 案件 ， 应该 进行 调解 ； 如 感情 确 已 破裂 ， 应 准予 离婚 。 、 《 中华人民共和国 民事 诉讼法 》 第一百 四十二条 ： 法庭 辩论 终结 ， 应当 依法 作出 判决 。 判决 前 能够 调解 的 ， 还 可以 进行 调解 ， 调解 不成 的 ， 应当 及时 判决 之 规定 ， 判决 如下 ： 

王某某甲与杨某某离婚纠纷一审民事判决书.txt	依照 《 中华人民共和国 婚姻法 》 第三十二条 、 《 中华人民共和国 民事 诉讼法 》 第六十四 条 第一款 、 《 最高人民法院 关于 适用 〈 中华人民共和国 民事 诉讼法 〉 的 解释 》 第九 十条 之 规定 ， 判决 如下 ： 

王某某诉代某某离婚纠纷一审判决书.txt	据此 ， 依照 《 中华人民共和国 婚姻法 》 第三十二条 、 《 中华人民共和国 民事 诉讼法 》 第六十四 条 第一款 、 《 最高人民法院 关于 民事诉讼 证据 的 若干 规定 》 第二条 、 第七十六条 的 规定 ， 判决 如下 ： 

王某某诉张某离婚纠纷一审民事判决书.txt	依照 《 中华人民共和国 婚姻法 》 第三十二条 ， 最高人民法院 《 关于 适用 ﹤ 中华人民共和国 民事 诉讼法 ﹥ 的 解释 》 第九 十条 之 规定 ， 判决 如下 ： 

王某某诉李某某离婚纠纷一审民事判决书.txt	据此 ， 依照 《 中华人民共和国 婚姻法 》 第三十二条 、 最高人民法院 《 关于 适用 ﹤ 中华人民共和国 民事 诉讼法 ﹥ 的 解释 》 第九 十条 之 规定 ， 判决 如下 ： 

王某某诉李某甲离婚纠纷一审民事判决书.txt	依照 《 中华人民共和国 婚姻法 》 第三十二条 、 最高人民法院 《 关于 民事诉讼 证据 的 若干 规定 》 第二条 之 规定 ， 判决 如下 ： 

王某某诉杜某甲离婚纠纷判决书.txt	根据 《 中华人民共和国 民事 诉讼法 》 第 一百四十四 条 、 《 中华人民共和国 婚姻法 》 第三十二条 、 第三十九条 的 规定 ， 判决 如下 ： 

王某某诉王某甲离婚纠纷一案一审民事判决书.txt	据此 ， 依照 《 中华人民共和国 婚姻法 》 第三十二条 第二款 、 《 中华人民共和国 民事 诉讼法 》 第六十四 条 第一款 、 最高人民法院 《 关于 民事诉讼 证据 的 若干 规定 》 第二条 、 第七十六条 之 规定 ， 判决 如下 ： 

王某某诉袁某某离婚纠纷一审民事判决书.txt	依照 《 中华人民共和国 婚姻法 》 第三十二条 第三款 ： " 有 下列 情形 之一 ， 调解 无效 的 ， 应 准予 离婚 ： （ 四 ） 、 因 感情 不 和 分居 满 2 年 的 " 、 《 最高人民法院 关于 审理 离婚 案件 如何 认定 夫妻感情 确 已 破裂 的 若干 具体意见 》 第 7 条 和 《 中华人民共和国 民事 诉讼法 》 第 一百四十四 条 ： " 被告 经 传票 传唤 ， 无 正当理由 拒 不 到庭 的 ， 或者 未经 法庭 许可 中途 退庭 的 ， 可以 缺席判决 " 之 规定 ， 判决 如下 ： 

王某某诉雷某离婚纠纷一审民事判决书.txt	据此 ， 依照 《 中华人民共和国 婚姻法 》 第三十二条 、 最高人民法院 《 关于 适用 ﹤ 中华人民共和国 民事 诉讼法 ﹥ 的 解释 》 第九 十条 之 规定 ， 判决 如下 ： 

王某某诉魏某甲离婚纠纷一审民事判决书.txt	据此 ， 依照 《 中华人民共和国 民事 诉讼法 》 第六十四 条 " 当事人 对 自己 提出 的 主张 ， 有 责任 提供 证据 " 、 《 最高人民法院 关于 民事诉讼 证据 的 若干 规定 》 第二条 " 当事人 对 自己 提出 的 诉讼请求 所 依据 的 事实 或者 反驳 对方 诉讼请求 所 依据 的 事实 有 责任 提供 证据 加以 证明 。 没有 证据 或者 证据 不足以 证明 当事人 的 事实 主张 的 ， 由 负有 举证责任 的 当事人 承担 不利 后果 " 之 规定 ， 判决 如下 ： 

王某波与李某离婚纠纷一审民事判决书.txt	依照 《 中华人民共和国 婚姻法 》 第三十二条 第一款 男女 一方 要求 离婚 的 ， 可 由 有关 部门 进行 调解 或 直接 向 人民法院 提出 离婚 诉讼 。 之 规定 ， 故 对于 原告 王某波 提出 与 被告 李某 离婚 的 诉讼 ， 本院 应予 受理 。 原告 王某波 请求 与 被告 李某 离婚 ， 但 未 提供 证明 夫妻感情 确 已 破裂 的 证据 ， 依照 《 最高人民法院 关于 适用 ﹤ 中华人民共和国 民事 诉讼法 ﹥ 的 解释 》 第九 十条 ： 当事人 对 自己 提出 的 诉讼请求 所 依据 的 事实 或者 反驳 对方 诉讼请求 所 依据 的 事实 ， 应当 提供 证据 加以 证明 ， 但 法律 另 有 规定 的 除外 。 在 作出 判决 前 ， 当事人 未能 提供 证据 或者 证据 不足以 证明 其 事实 主张 的 ， 由 负有 举证 证明 责任 的 当事人 承担 不利 的 后果 。 之 规定 ， 故 本院 不予 支持 。 被告 李某 经 本院 传票 传唤 未 到庭 参加 诉讼 ， 依照 《 中华人民共和国 民事 诉讼法 》 第 一百四十四 条 被告 经 传票 传唤 ， 无下 当 理由 拒 不 到庭 的 ， 或 未经 法庭 许何 中途 退庭 的 ， 可以 缺席判决 ， 被告 经 人民法院 传唤 ， 无 正当理由 拒 不 到庭 ， 不 影响 对 本案 公正 审理 ， 由此 可能 产生 的 不利 后果 由其 自行 承担 。 为 保护 当事人 的 合法权益 ， 维护 正常 的 婚姻家庭 关系 ， 依照 《 中华人民共和国 婚姻法 》 第三十二条 第二款 之 规定 ， 判决 如下 ： 

王某甲与易某甲离婚纠纷民事判决书.txt	据此 ， 依照 《 中华人民共和国 婚姻法 》 第三十二条 第二款 的 规定 ， 判决 如下 ： 

王某甲与王某乙离婚后财产纠纷一审民事判决书.txt	据此 ， 为 保护 当事人 的 合法权益 ， 依照 《 中华人民 合同法 》 第六十条 、 第一百零七条 和 《 最高人民法院 关于 适用 若干 问题 的 解释 （ 二 ） 》 第八条 的 规定 ， 判决 如下 ： 

王某甲与王某乙离婚纠纷一审民事判决书.txt	据此 ， 依照 《 中华人民共和国 婚姻法 》 第三十二条 、 第三十六条 、 第三十七条 、 第三十九条 、 第四十一条 、 第四十二条 ， 最高人民法院 《 关于 人民法院 审理 离婚 案件 处理 财产 分割 问题 的 若干意见 》 第四条 、 第七条 、 第八条 、 第十七条 一款 ， 最高人民法院 《 关于 审理 离婚 案件 处理 子女 抚养 问题 的 若干 具体意见 》 第四条 、 第七条 ， 最高人民法院 《 关于 民事诉讼 证据 的 若干 规定 》 第二条 之 规定 ， 判决 如下 ： 

王某甲与王甲离婚纠纷一案一审民事判决书.txt	据此 ， 依照 《 中华人民共和国 婚姻法 》 第三十二条 、 《 最高人民法院 关于 适用 〈 中华人民共和国 民事 诉讼法 〉 的 解释 》 第九 十条 、 《 中华人民共和国 民事 诉讼法 》 第 一百四十四 条 之 规定 ， 判决 如下 ： 

王某甲与石某离婚纠纷一审民事判决书.txt	据此 ， 依照 《 中华人民共和国 婚姻法 》 第三十二条 、 《 最高人民法院 关于 适用 〈 中华人民共和国 民事 诉讼法 〉 的 解释 》 第九 十条 的 规定 ， 判决 如下 ： 

王某甲与童某某离婚纠纷一审民事判决书.txt	据此 ， 依照 《 中华人民共和国 婚姻法 》 第三十二条 第二款 、 《 中华人民共和国 民事 诉讼法 》 第六十四 条 第一款 、 《 最高人民法院 关于 适用 〈 中华人民共和国 民事 诉讼法 〉 的 解释 》 第九 十条 第二款 之 规定 ， 判决 如下 ： 

王某甲与罗某某离婚纠纷一审民事判决书.txt	根据 《 中华人民共和国 婚姻法 》 第三十二条 二款 ： 人民法院 审理 离婚 案件 ， 应当 进行 调解 ； 如 感情 确 已 破裂 ， 调解 无效 ， 应 准予 离婚 。 的 规定 ， 判决 如下 ： 

王某甲与被告王某乙离婚纠纷一审民事判决书.txt	依照 《 中华人民共和国 民事 诉讼法 》 第六十四 条 第一款 、 《 最高人民法院 关于 民事诉讼 证据 的 若干 规定 》 第二条 、 《 最高人民法院 关于 适用 ﹤ 中华人民共和国 民事 诉讼法 ﹥ 的 解释 》 第九 十条 的 规定 ， 判决 如下 ： 

王某甲诉刘某甲离婚纠纷一审民事判决书.txt	依照 《 中华人民共和国 婚姻法 》 第三十二条 、 《 最高人民法院 关于 民事诉讼 证据 的 若干 规定 》 第二条 、 《 中华人民共和国 民事 诉讼法 》 第一百 四十二条 之 规定 ， 判决 如下 ： 

王某诉罗某某离婚纠纷一案一审民事判决书.txt	依照 《 中华人民共和国 婚姻法 》 第四条 、 第三十二条 之 规定 ， 判决 如下 ： 

王某诉罗某离婚纠纷一审民事裁定书.txt	依照 《 中华人民共和国 民事 诉讼法 》 第 一百四十 三条 之 规定 ， 裁定 如下 ： 

甘某某诉邹某某离婚纠纷一审民事判决书.txt	据此 ， 依照 《 中华人民共和国 婚姻法 》 第三十二条 第二款 、 《 中华人民共和国 民事 诉讼法 》 第六十四 第一款 、 第 一百四十四 条 、 最高人民法院 《 关于 民事诉讼 证据 的 若干 规定 》 第二条 、 第七十六条 之 规定 ， 判决 如下 ： 

田某某与张某甲离婚纠纷案一审民事判决书.txt	据此 ， 依照 《 中华人民共和国 婚姻法 》 第三十二条 、 第三十六条 、 第四十二条 ， 最高人民法院 《 关于 适用 〈 中华人民共和国 婚姻法 〉 若干 问题 的 解释 （ 一 ） 》 第二十七条 、 最高人民法院 《 关于 人民法院 审理 离婚 案件 如何 认定 夫妻感情 确 已 破裂 的 若干 具体意见 》 第 3 条 之 规定 ， 判决 如下 ： 

田某某与肖某某离婚纠纷一审民事判决书.txt	据此 ， 为了 保护 当事人 的 合法权益 ， 维护 家庭 及 社会 的 稳定 ， 依照 《 中华人民共和国 民事 诉讼法 》 第六十四 条 第一款 ， 《 中华人民共和国 婚姻法 》 第三十二条 第二款 ， 《 最高人民法院 关于 民事诉讼 证据 的 若干 规定 》 第二条 的 规定 ， 判决 如下 ： 

田某某与黄某甲离婚纠纷一审民事判决书.txt	据此 ， 依照 《 中华人民共和国 婚姻法 》 第三十二条 第三款 第 （ 五 ） 项 、 第三十六条 第二款 、 第三款 之 规定 ， 判决 如下 ： 

田某某诉王某某离婚纠纷一审民事判决书.txt	据此 ， 依照 《 中华人民共和国 婚姻法 》 第三十二条 、 最高人民法院 《 关于 适用 ﹤ 中华人民共和国 民事 诉讼法 ﹥ 的 解释 》 第九 十条 之 规定 ， 判决 如下 ： 

田某某诉陈某某离婚纠纷一审民事判决书.txt	据此 ， 依照 《 中华人民共和国 婚姻法 》 第三十二条 ， 《 中华人民共和国 民事 诉讼法 》 第 一百四十四 条 ， 《 最高人民法院 关于 适用 ＜ 中华人民共和国 民事 诉讼法 ＞ 的 解释 》 第九 十条 之 规定 ， 判决 如下 ： 

白某某与周某某离婚纠纷一审民事判决书.txt	依照 《 中华人民共和国 婚姻法 》 第三十二条 、 《 最高人民法院 关于 民事诉讼 证据 的 若干 规定 》 第二条 、 《 中华人民共和国 民事 诉讼法 》 第一百 四十二条 、 第 一百四十四 条 之 规定 ， 判决 如下 ： 

白某某与杜某某离婚纠纷一审民事判决书.txt	依照 《 中华人民共和国 婚姻法 》 第三十二条 、 第三十六条 、 第三十八条 、 《 中华人民共和国 民事 诉讼法 》 第 一百四十四 条 之 规定 ， 判决 如下 ： 

白某某与杨某甲离婚纠纷一审民事判决书.txt	据此 ， 依照 《 中华人民共和国 婚姻法 》 第三十二条 、 第三十九条 、 第四十一条 之 规定 ， 判决 如下 ： 

石某与刘某甲离婚纠纷一审民事判决书.txt	据此 ， 根据 《 中华人民共和国 婚姻法 》 第三十二条 、 《 中华人民共和国 民事 诉讼法 》 第六十四 条 和 《 最高人民法院 关于 民事诉讼 证据 的 若干 规定 》 第二条 之 规定 ， 判决 如下 ： 

石某某与蒋某甲离婚纠纷一审民事判决书.txt	依照 《 中华人民共和国 婚姻法 》 第三十二条 、 《 中华人民共和国 民事 诉讼法 》 第六十四 条 第一款 以及 《 最高人民法院 关于 适用 ﹤ 中华人民共和国 民事 诉讼法 ﹥ 的 解释 》 第九 十条 之 规定 ， 判决 如下 ： 

石某某诉被告付某某离婚纠纷一审民事判决书.txt	根据 《 中华人民共和国 婚姻法 》 第三十二条 之 规定 ， 判决 如下 ： 

石某某诉黎某某离婚纠纷一审民事判决书.txt	据此 ， 依照 《 中华人民共和国 婚姻法 》 第三十二条 第二款 、 《 中华人民共和国 民事 诉讼法 》 第六十四 条 第一款 、 第六十五条 第一款 、 第 一百四十四 条 、 《 最高人民法院 关于 民事诉讼 证据 的 若干 规定 》 第二条 、 第七十六条 的 规定 ， 判决 如下 ： 

秦某某与谢某某离婚后财产纠纷案二审民事判决书.txt	据此 ， 依照 《 中华人民共和国 民法通则 》 第六十二 条 、 《 中华人民共和国 婚姻法 》 第三十九条 、 《 中华人民共和国 民事 诉讼法 》 第一百七十条 第一款 第 （ 二 ） 项之 规定 ， 判决 如下 ： 

程丽萍与黄科贵离婚纠纷二审民事判决书.txt	依照 《 中华人民共和国 民事 诉讼法 》 第一百七十条 第一款 第 （ 一 ） 项 、 第一百七 十五条 的 规定 ， 判决 如下 ： 

程某与谢某离婚纠纷一审民事判决书.txt	依照 《 中华人民共和国 婚姻法 》 第三十二条 和 《 最高人民法院 关于 民事诉讼 证据 的 若干 规定 》 第二条 之 规定 ， 判决 如下 ： 

程某某与杨某甲离婚纠纷一审民事判决书.txt	据此 ， 依照 《 中华人民共和国 婚姻法 》 第三十二条 第二款 ， 本院 判决 如下 ： 

童某甲与杨某某离婚纠纷一审民事判决书.txt	据此 ， 依照 《 中华人民共和国 婚姻法 》 第三十二条 ， 《 中华人民共和国 民事 诉讼法 》 第六十四 条 ， 最高人民法院 关于 适用 《 中华人民共和国 民事 诉讼法 》 的 解释 第九 十条 之 规定 ， 判决 如下 ： 

简某某与彭某某离婚纠纷一审民事判决书.txt	依照 《 最高人民法院 关于 民事诉讼 证据 的 若干 规定 》 第二条 、 《 中华人民共和国 婚姻法 》 第三十一条 、 三十六条 之 规定 ， 判决 如下 ： 

罗某与刘某甲离婚纠纷一审民事判决书.txt	依照 《 中华人民共和国 婚姻法 》 第三十二条 和 最高人民法院 《 关于 民事诉讼 证据 的 若干 规定 》 第二条 之 规定 ， 判决 如下 ： 

罗某与康某甲离婚纠纷一审民事判决书.txt	据此 ， 依照 《 中华人民共和国 婚姻法 》 第三十二条 、 第三十六条 、 第三十七条 ， 《 中华人民共和国 民事 诉讼法 》 第 一百四十四 条 之 规定 ， 缺席判决 如下 ： 

罗某与杨某某离婚纠纷一案一审民事判决书.txt	依照 《 中华人民共和国 婚姻法 》 第三十二条 第二款 " 人民法院 审理 离婚 案件 ， 应当 进行 调解 ； 如 感情 确 已 破裂 ， 调解 无效 ， 应 准予 离婚 " 和 最高人民法院 《 关于 民事诉讼 证据 的 若干 规定 》 第二条 " 当事人 对 自己 提出 的 诉讼请求 所 依据 的 事实 或者 反驳 对方 诉讼请求 所 依据 的 事实 有 责任 提供 证据 加以 证明 。 没有 证据 或者 证据 不足以 证明 当事人 的 事实 主张 的 ， 由 负有 举证责任 的 当事人 承担 不利 后果 " 之 规定 ， 判决 如下 ： 

罗某与赵某离婚纠纷一审民事判决书.txt	依照 《 中华人民共和国 婚姻法 》 第三十二条 、 《 最高人民法院 关于 民事诉讼 证据 的 若干 规定 》 第二条 之 规定 ， 判决 如下 ： 

罗某与黄某某婚姻无效一审民事判决书.txt	依照 《 中华人民共和国 婚姻法 》 第十条 第一款 第四项 之 规定 ， 判决 如下 ： 

罗某某与何某甲离婚纠纷一审民事判决书.txt	据此 ， 根据 《 中华人民共和国 婚姻法 》 第三十二条 第二款 和 《 最高人民法院 关于 民事诉讼 证据 的 若干 规定 》 第二条 的 规定 ， 判决 如下 ： 

罗某某与吴某甲离婚纠纷一案一审民事判决书.txt	依照 《 中华人民共和国 婚姻法 》 第三十二条 、 《 中华人民共和国 民事 诉讼法 》 六十四 条 、 第一百 四十二条 之 规定 ， 判决 如下 ： 

罗某某与周某某离婚纠纷一审民事判决书.txt	据此 ， 依照 《 中华人民共和国 婚姻法 》 第三十二条 、 《 最高人民法院 关于 适用 〈 中华人民共和国 民事 诉讼法 〉 的 解释 》 第九 十条 之 规定 ， 判决 如下 ： 

罗某某与周某某离婚纠纷民事一审判决书.txt	据此 ， 依据 《 中华人民共和国 民事 诉讼法 》 第 一百四十四 条 、 《 中华人民共和国 婚姻法 》 第三十二条 、 第三十七 的 规定 ， 判决 如下 ： 

罗某某与林某甲离婚纠纷一审民事判决书.txt	据此 ， 依据 《 中华人民共和国 婚姻法 》 第三十二条 、 第三十六条 、 第三十七条 之 规定 ， 判决 如下 ： 

罗某某与贾某某离婚纠纷一审民事判决书.txt	依据 《 中华人民共和国 婚姻法 》 第三十二条 之 规定 ， 判决 如下 ： 

罗某某与陈某甲离婚纠纷一审民事判决书.txt	依据 《 中华人民共和国 婚姻法 》 第三十二条 ： 人民法院 审理 离婚 案件 ， 应该 进行 调解 ； 如 感情 确 已 破裂 ， 应 准予 离婚 。 、 《 中华人民共和国 民事 诉讼法 》 第一百 四十二条 ： 法庭 辩论 终结 ， 应当 依法 作出 判决 。 判决 前 能够 调解 的 ， 还 可以 进行 调解 ， 调解 不成 的 ， 应当 及时 判决 之 规定 ， 判决 如下 ： 

罗某某与陈某甲离婚纠纷一审民事裁定书.txt	依据 《 中华人民共和国 婚姻法 》 第三十二条 ： 人民法院 审理 离婚 案件 ， 应该 进行 调解 ； 如 感情 确 已 破裂 ， 应 准予 离婚 。 、 《 中华人民共和国 民事 诉讼法 》 第一百 四十二条 ： 法庭 辩论 终结 ， 应当 依法 作出 判决 。 判决 前 能够 调解 的 ， 还 可以 进行 调解 ， 调解 不成 的 ， 应当 及时 判决 之 规定 ， 判决 如下 ： 

罗某某诉吴某某离婚纠纷一案一审民事判决书.txt	据此 ， 依照 《 中华人民共和国 婚姻法 》 第三十二条 第二款 、 《 中华人民共和国 民事 诉讼法 》 第六十四 第一款 、 第 一百四十四 条 、 最高人民法院 《 关于 民事诉讼 证据 的 若干 规定 》 第二条 、 第七十六条 之 规定 ， 判决 如下 ： 

罗某某诉孙某某离婚纠纷一案一审民事判决书.txt	依照 《 中华人民共和国 婚姻法 》 第四条 、 第三十二条 、 《 中华人民共和国 民事 诉讼法 》 第 一百四十四 条 之 规定 ， 判决 如下 ： 

罗某甲与张某甲离婚纠纷一审民事判决书.txt	依照 《 中华人民共和国 婚姻法 》 第三十二条 、 第三十九条 之 规定 ， 判决 如下 ： 

羊某某诉覃某某离婚纠纷一审判决书.txt	据此 ， 依照 《 中华人民共和国 婚姻法 》 第三十二条 、 《 中华人民共和国 民事 诉讼法 》 第六十四 条 第一款 、 《 最高人民法院 关于 民事诉讼 证据 的 若干 规定 》 第二条 、 第七十六条 的 规定 ， 判决 如下 ： 

翟某某与刘某某离婚纠纷一审民事判决书.txt	依照 《 中华人民共和国 婚姻法 》 第三十二条 、 《 最高人民法院 关于 民事诉讼 证据 的 若干 规定 》 第二条 、 《 中华人民共和国 民事 诉讼法 》 第一百 四十二条 之 规定 ， 判决 如下 ： 

翟某诉隆某离婚纠纷一审判决书.txt	据此 ， 依照 《 中华人民共和国 婚姻法 》 第三十二条 第二款 第五项 、 第三十六条 第一款 、 第二款 、 《 中华人民共和国 民事 诉讼法 》 第 一百四十四 条 的 规定 ， 判决 如下 ： 

聂某某诉余某某离婚纠纷一审民事判决书.txt	据此 ， 依照 《 中华人民共和国 婚姻法 》 第三十二条 《 最高人民法院 关于 适用 ＜ 中华人民共和国 民事 诉讼法 ＞ 的 解释 》 第九 十条 之 规定 ， 判决 如下 ： 

肖某与尹某甲离婚纠纷一审民事判决书.txt	据此 ， 根据 《 中华人民共和国 婚姻法 》 第三十二条 、 《 中华人民共和国 民事 诉讼法 》 第六十四 条 和 《 最高人民法院 关于 民事诉讼 证据 的 若干 规定 》 第二条 之 规定 ， 判决 如下 ： 

肖某与蒲某离婚纠纷一审民事裁定书.txt	据此 ， 依照 最高人民法院 《 关于 适用 〈 中华人民共和国 民事 诉讼法 〉 的 解释 》 第一百 九十九条 之 规定 ， 裁定 如下 ： 

肖某某与张某某离婚纠纷一审民事判决书.txt	据此 ， 为了 保护 当事人 的 合法权益 ， 维护 家庭 及 社会 的 和谐 稳定 ， 依照 《 中华人民共和国 民事 诉讼法 》 第六十四 条 第一款 ， 《 中华人民共和国 婚姻法 》 第三十二条 第二款 ， 《 最高人民法院 关于 民事诉讼 证据 的 若干 规定 》 第二条 的 规定 ， 判决 如下 ： 

肖某某与敬某某离婚纠纷一案一审民事判决书.txt	依照 《 中华人民共和国 婚姻法 》 第三十二条 第二款 " 人民法院 审理 离婚 案件 ， 应当 进行 调解 ； 如 感情 确 已 破裂 ， 调解 无效 ， 应 准予 离婚 " ， 最高人民法院 《 关于 民事诉讼 证据 的 若干 规定 》 第二条 " 当事人 对 自己 提出 的 诉讼请求 所 依据 的 事实 或者 反驳 对方 诉讼请求 所 依据 的 事实 有 责任 提供 证据 加以 证明 。 没有 证据 或者 证据 不足以 证明 当事人 的 事实 主张 的 ， 由 负有 举证责任 的 当事人 承担 不利 后果 " 的 规定 ， 判决 如下 ： 

肖某某与方某甲离婚纠纷案一审民事判决书.txt	依据 《 中华人民共和国 婚姻法 》 第三十二条 第二款 " 人民法院 审理 离婚 案件 ， 应当 进行 调解 ； 如 感情 确 已 破裂 ， 调解 无效 ， 应 准予 离婚 。 " 的 规定 ， 判决 如下 ： 

肖某某与杨某某离婚纠纷一审民事判决书.txt	依照 《 中华人民共和国 婚姻法 》 第三十二条 第二款 的 规定 ， 判决 如下 ： 

肖某甲与肖某乙离婚纠纷一审民事判决书.txt	据此 ， 依照 《 中华人民共和国 婚姻法 》 第三十二条 、 《 中华人民共和国 民事 诉讼法 》 第六十四 条 第一款 、 第 一百四十四 条 以及 《 最高人民法院 关于 适用 〈 中华人民共和国 民事 诉讼法 〉 的 解释 》 第九 十条 之 规定 ， 判决 如下 ： 

胡某与周某离婚纠纷案二审民事裁定书.txt	依照 《 中华人民共和国 民事 诉讼法 》 第一百七十条 第一款 第 （ 三 ） 项之 规定 ， 裁定 如下 ： 

胡某与辛某甲离婚纠纷一审民事判决书.txt	依照 《 中华人民共和国 婚姻法 》 第三十二条 、 《 中华人民共和国 民事 诉讼法 》 第六十四 条 和 《 最高人民法院 关于 民事诉讼 证据 的 若干 规定 》 的 规定 ， 判决 如下 ： 

胡某某与严某某离婚纠纷一审民事判决书.txt	据此 ， 依照 《 中华人民共和国 婚姻法 》 第三十二条 、 《 最高人民法院 关于 人民法院 审理 离婚 案件 如何 认定 夫妻感情 确 已 破裂 的 若干 具体意见 》 第 7 条 之 规定 ， 判决 如下 ： 

胡某某与刘某某离婚纠纷一审民事判决书.txt	依照 《 中华人民共和国 婚姻法 》 第三十二条 、 《 最高人民法院 关于 民事诉讼 证据 的 若干 规定 》 第二条 、 《 中华人民共和国 民事 诉讼法 》 第一百 四十二条 之 规定 ， 判决 如下 ： 

胡某某与唐某某离婚纠纷一审民事判决书.txt	依照 《 中华人民共和国 婚姻法 》 第三十二条 、 《 中华人民共和国 民事 诉讼法 》 第六十四 条 、 第一百 四十二条 和 《 最高人民法院 关于 民事诉讼 证据 的 若干 规定 》 第二条 的 规定 ， 判决 如下 ： 

胡某某与王某甲离婚纠纷一审民事判决书.txt	依照 《 中华人民共和国 婚姻法 》 第三十二条 和 最高人民法院 《 关于 民事诉讼 证据 的 若干 规定 》 第二条 之 规定 ， 判决 如下 ： 

胡某某与袁某某离婚纠纷一审民事判决书.txt	依照 《 中华人民共和国 婚姻法 》 第三十二条 、 《 中华人民共和国 民事 诉讼法 》 第六十四 条 、 第一百 四十二条 和 《 最高人民法院 关于 民事诉讼 证据 的 若干 规定 》 第二条 的 规定 ， 判决 如下 ： 

胡某某与陈某某离婚纠纷一审民事判决书.txt	依照 《 中华人民共和国 婚姻法 》 第三十二条 、 最高人民法院 《 关于 民事诉讼 证据 的 若干 规定 》 第二条 的 规定 ， 判决 如下 ： 

胡某某与陈某某离婚纠纷案一审民事判决书.txt	依照 《 中华人民共和国 婚姻法 》 第三十二条 、 最高人民法院 《 关于 民事诉讼 证据 的 若干 规定 》 第二条 和 《 中华人民共和国 民事 诉讼法 》 第一百 四十二条 、 第六十四 条 、 第一百 六十条 之 规定 ， 判决 如下 ： 

胡某某诉张某某离婚纠纷一审民事裁定书.txt	依照 《 中华人民共和国 民事 诉讼法 》 第 一百四十 五条 第一款 、 第一百五十四条 第一款 第 （ 五 ） 项 的 规定 ， 裁定 如下 ： 

胡某某诉李某某离婚纠纷民事一审判决书.txt	据此 ， 根据 《 中华人民共和国 婚姻法 》 第三十二条 、 第三十六条 、 《 最高人民法院 关于 人民法院 审理 离婚 案件 处理 子女 抚养 问题 的 若干 具体意见 》 第 16 条 第一款 第 （ 3 ） 项 、 《 中华人民共和国 民事 诉讼法 》 第六十四 条 、 第 一百四十四 条 之 规定 ， 判决 如下 ： 

胡某梅与杨某学离婚纠纷民事裁定书.txt	根据 《 中华人民共和国 民事 诉讼法 》 第 一百四十 三条 之 规定 ， 裁定 如下 ： 

胡英与唐丽珍离婚纠纷一审民事裁定书.txt	据此 ， 依照 上述 法律 、 司法解释 以及 《 中华人民共和国 民事 诉讼法 》 第二 百条 之 规定 ， 裁定 如下 ： 

胥某兰与何某军离婚纠纷一审民事判决书.txt	据此 ， 为了 维护 婚姻家庭 的 稳定 ， 构建 和谐社会 ， 依照 《 中华人民共和国 婚姻法 》 第三十二条 第二款 、 《 中华人民共和国 民事 诉讼法 》 第六十四 条 、 《 最高人民法院 关于 民事诉讼 证据 的 若干 规定 》 第二条 之 规定 ， 判决 如下 ： 

胥某某与段某某离婚纠纷一审民事判决书.txt	根据 《 中华人民共和国 婚姻法 》 第三十二条 二款 之 规定 ， 判决 如下 ： 

胥某某与胡某某离婚纠纷一审民事判决书.txt	依照 《 中华人民共和国 婚姻法 》 第三十二条 、 最高人民法院 《 关于 适用 〈 中华人民共和国 民事 诉讼法 〉 的 解释 》 第九 十条 之 规定 ， 判决 如下 ： 

胥某甲与曹某某离婚纠纷一审民事判决书.txt	依照 《 中华人民共和国 婚姻法 》 第三十二条 ； 《 最高人民法院 关于 适用 ﹤ 中华人民共和国 民事 诉讼法 ﹥ 的 解释 》 第九 十条 的 规定 ， 判决 如下 ： 

舒某与尹某离婚纠纷一审民事判决书.txt	依照 《 中华人民共和国 婚姻法 》 第三十二条 、 《 中华人民共和国 民事 诉讼法 》 第六十四 条 和 《 最高人民法院 关于 民事诉讼 证据 的 若干 规定 》 第二条 之 规定 ， 判决 如下 ： 

舒某某诉余某某离婚纠纷一审民事判决书.txt	据此 ， 依照 《 中华人民共和国 婚姻法 》 第三十二条 ， 最高人民法院 《 关于 适用 ﹤ 中华人民共和国 民事 诉讼法 ﹥ 的 解释 》 第九 十条 之 规定 ， 判决 如下 ： 

芶某某与黄某甲离婚纠纷一审民事判决书.txt	据此 ， 依照 《 中华人民共和国 婚姻法 》 第三十二条 、 《 最高人民法院 关于 适用 〈 中华人民共和国 民事 诉讼法 〉 的 解释 》 第九 十条 之 规定 ， 判决 如下 ： 

苏呷某甲与纳子某甲婚姻无效纠纷一审民事判决书.txt	依照 《 中华人民共和国 婚姻法 》 第七条 有 下列 情形 之一 的 ， 禁止 结婚 ： （ 一 ） 直系 血亲 和 三代 以内 的 旁系血亲 ； （ 二 ） 患有 医学 上 认为 不 应当 结婚 的 疾病 、 第十条 有 下列 情形 之一 的 ， 婚姻 无效 ： （ 一 ） 重婚 的 ； （ 二 ） 有 禁止 结婚 的 亲属关系 的 ； （ 三 ） 婚前 患有 医学 上 认为 不 应当 结婚 的 疾病 ， 婚后 尚未 治愈 的 ； （ 四 ） 未 到 法定 婚龄 的的 规定 ， 判决 如下 ： 

苏某与唐某某离婚纠纷一审民事判决书.txt	根据 《 中华人民共和国 民事 诉讼法 》 第六十四 条 ， 最高人民法院 《 关于 民事诉讼 证据 的 若干 规定 》 第二条 ， 《 中华人民共和国 婚姻法 》 第三十二条 第二款 的 规定 ， 判决 如下 ： 

苏某某与宋某某离婚纠纷一审民事判决书.txt	据此 ， 依照 《 中华人民共和国 婚姻法 》 第三十二条 第二款 、 《 中华人民共和国 民事 诉讼法 》 第六十四 条 第一款 、 《 最高人民法院 关于 适用 〈 中华人民共和国 民事 诉讼法 〉 的 解释 》 第九 十条 第二款 之 规定 ， 判决 如下 ： 

苏某某与彭某某甲离婚纠纷一审民事判决书.txt	依照 《 中华人民共和国 婚姻法 》 第三十二条 、 《 中华人民共和国 民事 诉讼法 》 第六十四 条 第一款 、 第 一百四十四 条 、 最高人民法院 《 关于 适用 〈 中华人民共和国 民事 诉讼法 〉 的 解释 》 第九 十条 之 规定 ， 判决 如下 ： 

苏某某与舒某某离婚纠纷一事民事判决书.txt	据此 ， 依照 《 中华人民共和国 婚姻法 》 第三十二条 ， 《 中华人民共和国 民事 诉讼法 》 第一百 四十二条 之 规定 ， 判决 如下 ： 

苏某某与赵某甲离婚纠纷一审民事判决书.txt	据此 ， 为 维护 正常 的 婚姻家庭 秩序 ， 保障 社会 稳定 ， 依照 《 中华人民共和国 婚姻法 》 三十二条 之 规定 ， 判决 如下 ： 

苟某甲与张某甲离婚纠纷一审民事判决书.txt	据此 ， 依照 《 中华人民共和国 婚姻法 》 第三十二条 第三款 （ 四 ） 项 、 第三十九条 ， 《 中华人民共和国 民事 诉讼法 》 第 一百四十四 条 之 规定 ， 判决 如下 ： 

范某丹与陈某离婚纠纷一审民事判决书.txt	据此 ， 为了 保护 当事人 的 合法权益 ， 促进 社会 的 稳定 ， 依照 《 中华人民共和国 婚姻法 》 第三十二条 第二款 、 《 中华人民共和国 民事 诉讼法 》 第六十四 条 第一款 、 《 最高人民法院 关于 民事诉讼 证据 的 若干 规定 》 第二条 之 规定 ， 判决 如下 ： 

范某某与罗某离婚纠纷一审民事判决书.txt	依照 《 中华人民共和国 婚姻法 》 第三十二条 、 《 中华人民共和国 民事 诉讼法 》 第六十四 条 第一款 、 最高人民法院 《 关于 适用 〈 中华人民共和国 民事 诉讼法 〉 的 解释 》 第九 十条 之 规定 ， 判决 如下 ： 

荣某珍与雷某明离婚纠纷一审民事判决书.txt	据此 ， 为 维护 当事人 的 合法权益 ， 根据 《 中华人民共和国 婚姻法 》 第三十二条 第二款 、 《 中华人民共和国 民事 诉讼法 》 第六十四 条 、 最高人民法院 《 关于 民事诉讼 证据 若干 问题 的 规定 》 第二条 之 规定 ， 判决 如下 ： 

莫某某与苏某某离婚纠纷一审民事判决书.txt	据此 ， 依照 《 中华人民共和国 婚姻法 》 第三十二条 、 第三十九条 的 规定 ， 判决 如下 ： 

董某与鲁某离婚纠纷二审民事判决书.txt	依照 《 中华人民共和国 民事 诉讼法 》 第一百七十条 第一款 第 （ 一 ） 项 、 《 最高人民法院 关于 适用 ＜ 中华人民共和国 民事 诉讼法 ＞ 的 解释 》 第三 百三 十四条 之 规定 ， 判决 如下 ： 

董某某与彭某甲离婚纠纷一审民事判决书.txt	依照 《 中华人民共和国 婚姻法 》 第三十二条 、 最高人民法院 《 关于 民事诉讼 证据 的 若干 规定 》 第二条 的 规定 ， 判决 如下 ： 

蒋凤英与罗强离婚后财产纠纷一审民事判决书.txt	根据 《 最高人民法院 关于 适用 ＜ 中华人民共和国 婚姻法 ＞ 若干 问题 的 解释 （ 二 ） 》 第八条 之 规定 ， 判决 如下 ： 

蒋某与杜某某离婚纠纷一审民事判决书.txt	依照 《 中华人民共和国 民事 诉讼法 》 第一百 四十二条 和 《 中华人民共和国 婚姻法 》 第三十二条 的 规定 ， 判决 如下 ： 

蒋某与王某离婚纠纷一审民事判决书.txt	依照 《 中华人民共和国 婚姻法 》 第三十二条 和 最高人民法院 《 关于 民事诉讼 证据 的 若干 规定 》 第二条 之 规定 ， 判决 如下 ： 

蒋某某与党某某离婚纠纷一审民事判决书.txt	依照 《 中华人民共和国 婚姻法 》 第三十二条 第一款 的 规定 ， 判决 如下 ： 

蒋某某与吕某某离婚纠纷一审民事判决书.txt	依照 《 中华人民共和国 婚姻法 》 第十条 之 （ 三 ） 项 、 最高人民法院 《 关于 适用 〈 中华人民共和国 婚姻法 〉 若干 问题 的 解释 （ 二 ） 》 第三条 、 第四条 、 《 中华人民共和国 民事 诉讼法 》 第 一百四十四 条 之 规定 ， 判决 如下 ： 

蒋某某与呙某某离婚后财产纠纷一审民事判决书.txt	据此 ， 依照 《 最高人民法院 关于 适用 ﹤ 中华人民共和国 婚姻法 ﹥ 若干 问题 的 解释 （ 二 ） 》 第八条 第一款 、 《 中华人民共和国 民事 诉讼法 》 第 一百四十四 条 、 《 最高人民法院 关于 适用 ﹤ 中华人民共和国 民事 诉讼法 ﹥ 的 解释 》 第九 十条 之 规定 ， 判决 如下 ： 

蒋某某与李某甲离婚纠纷一审民事判决书.txt	据此 ， 依照 《 中华人民共和国 婚姻法 》 第三十二条 、 《 最高人民法院 关于 适用 〈 中华人民共和国 民事 诉讼法 〉 的 解释 》 第九 十条 之 规定 ， 判决 如下 ： 

蒋某某与汪某某离婚纠纷案一审民事判决书.txt	依照 《 中华人民共和国 婚姻法 》 第三十二条 和 《 中华人民共和国 民事 诉讼法 》 第一百 四十二条 、 第一百 六十条 之 规定 ， 判决 如下 ： 

蒋某某与王某某离婚纠纷一审民事判决书.txt	依照 《 中华人民共和国 婚姻法 》 第三十二条 、 及 最高人民法院 《 关于 民事诉讼 证据 的 若干 规定 》 第二条 第二款 的 规定 ， 判决 如下 ： 

蒋某某与黄某甲离婚纠纷一审民事判决书.txt	依照 《 中华人民共和国 婚姻法 》 第三十二条 及 《 中华人民共和国 民事 诉讼法 》 第六十四 条 第一款 的 规定 ， 判决 如下 ： 

蒋某某甲与许某某离婚纠纷一审民事判决书.txt	据此 ， 依照 《 中华人民共和国 婚姻法 》 第三十二条 、 第三十六条 、 第三十七条 之 规定 ， 判决 如下 ： 

蒋某甲与吴某甲离婚纠纷一审民事判决书.txt	依照 《 中华人民共和国 婚姻法 》 第三十二条 、 《 中华人民共和国 民事 诉讼法 》 第六十四 条 第一款 以及 《 最高人民法院 关于 适用 ﹤ 中华人民共和国 民事 诉讼法 ﹥ 的 解释 》 第九 十条 之 规定 ， 判决 如下 ： 

蒋某甲与李某某离婚纠纷案一审民事判决书.txt	根据 《 中华人民共和国 婚姻法 》 第三十二条 第二款 ： " 人民法院 审理 离婚 案件 ， 应当 进行 调解 ； 如 感情 确 已 破裂 ， 调解 无效 ， 应 准予 离婚 " 、 第三款 " 有 下列 情形 之一 ， 调解 无效 的 ， 应 准予 离婚 ： ...... （ 五 ） 其他 导致 夫妻 感情破裂 的 情形 ； " 的 规定 ， 判决 如下 ： 

蒲某某与葛某甲离婚纠纷一审民事判决书.txt	依照 《 中华人民共和国 婚姻法 》 第三十二条 的 规定 ， 判决 如下 ： 

蒲某某与補某某离婚纠纷一审民事判决书.txt	依照 《 中华人民共和国 婚姻法 》 第三十二条 、 第三十六条 、 第三十七条 的 规定 ， 判决 如下 ： 

蒲某某诉苏某某离婚纠纷一审民事判决书.txt	依照 《 中华人民共和国 婚姻法 》 第三十二条 、 第三十六条 、 第三十九条 之 规定 ， 判决 如下 ： 

蓝某某与张某甲离婚纠纷一审民事判决书.txt	依照 《 中华人民共和国 婚姻法 》 第三十二条 、 最高人民法院 《 关于 民事诉讼 证据 的 若干 规定 》 第二条 的 规定 ， 判决 如下 ： 

蔡某甲与查某离婚纠纷一审民事判决书.txt	据此 ， 依照 《 中华人民共和国 民事 诉讼法 》 第六十四 条 和 《 最高人民法院 关于 适用 ﹤ 中华人民共和国 民事 诉讼法 ﹥ 的 解释 》 第九 十条 的 规定 ， 判决 如下 ： 

蔡某诉李某某离婚纠纷一案一审民事裁定书.txt	据此 ， 依照 《 中华人民共和国 民事 诉讼法 》 第 一百四十 三条 之 规定 ， 裁定 如下 ： 

薛某诉易某离婚纠纷一案一审民事判决书.txt	据此 ， 为 调整 社会 婚姻家庭 关系 ， 维护 婚姻 当事人 的 合法权益 ， 依照 《 中华人民共和国 婚姻法 》 第三十二条 和 《 中华人民共和国 民事 诉讼法 》 第 一百四十四 条 之 规定 ， 判决 如下 ： 

袁某与肖某离婚纠纷一审民事判决书.txt	据此 ， 为 保护 当事人 的 合法权益 ， 维护 正常 婚姻家庭 秩序 ， 依照 《 中华人民共和国 民事 诉讼法 》 第六十四 条 和 《 最高人民法院 关于 适用 ﹤ 中华人民共和国 民事 诉讼法 ﹥ 的 解释 》 第九 十条 的 规定 ， 判决 如下 ： 

袁某某与王某甲离婚纠纷一审民事判决书.txt	依照 《 中华人民共和国 婚姻法 》 第三十二条 和 最高人民法院 《 关于 民事诉讼 证据 的 若干 规定 》 第二条 之 规定 ， 判决 如下 ： 

袁某某与邓某甲离婚纠纷一审民事裁定书.txt	据此 ， 依据 《 最高人民法院 关于 使用 < 中华人民共和国 婚姻法 > 若干 问题 的 解释 （ 一 ） 》 、 《 中华人民共和国 民事 诉讼法 》 第 一百四十四 条 、 《 中华人民共和国 民事 诉讼法 》 的 解释 第九 十条 之 规定 ， 裁定 如下 ： 

袁某某与陈某某离婚纠纷一案一审民事判决书.txt	依据 《 中华人民共和国 婚姻法 》 第三十二条 、 第四十二条 、 之 规定 ， 判决 如下 ： 

袁某某诉叶某某离婚纠纷一审判决书.txt	据此 ， 依照 《 中华人民共和国 婚姻法 》 第三十二条 第二款 、 《 中华人民共和国 民事 诉讼法 》 第六十四 条 第一款 、 《 最高人民法院 关于 民事诉讼 证据 的 若干 规定 》 第二条 、 第七十六条 的 规定 ， 判决 如下 ： 

袁某某诉黄某某离婚纠纷一审民事判决书.txt	依照 《 中华人民共和国 婚姻法 》 第三十二条 、 第三十七条 的 规定 ， 判决 如下 ： 

裴某某与周某某离婚纠纷案一审民事判决书.txt	依照 《 中华人民共和国 婚姻法 》 第三十二条 和 《 中华人民共和国 民事 诉讼法 》 第一百 四十二条 之 规定 ， 判决 如下 ： 

詹某甲与吴某某离婚纠纷一审民事判决书.txt	据此 ， 根据 《 中华人民共和国 婚姻法 》 第三十二条 第三款 （ 四 ） 项 、 《 中华人民共和国 民事 诉讼法 》 第 一百四十四 条 被告 经 传票 传唤 ， 无 正当理由 拒 不 到庭 的 ， 或者 未经 法庭 许可 中途 退庭 的 ， 可以 缺席判决 。 之 规定 ， 判决 如下 ： 

譙某某与徐某某甲离婚纠纷一审民事判决书.txt	依照 《 中华人民共和国 婚姻法 》 第四条 、 第三十二条 的 规定 判决 如下 ： 

许某某与姚某某离婚纠纷案一审民事判决书.txt	依照 《 中华人民共和国 婚姻法 》 第三十二条 、 第三十九条 、 《 最高人民法院 关于 人民法院 审理 离婚 案件 处理 子女 抚养 问题 若干 具体意见 》 第 3 条 第 （ 2 ） 款 ， 第 4 条 和 《 中华人民共和国 民事 诉讼法 》 第一百 四十二条 、 第一百 六十条 之 规定 ， 判决 如下 ： 

许某某与廖某某离婚纠纷一案一审民事判决书.txt	据此 ， 为 维护 婚姻家庭 的 稳定 ， 依照 《 中华人民共和国 婚姻法 》 第三十二条 、 《 最高人民法院 关于 适用 〈 中华人民共和国 民事 诉讼法 〉 的 解释 》 第九 十条 之 规定 ， 判决 如下 ： 

许某某与杨某某确认婚姻无效纠纷案一审民事判决书.txt	依照 《 中华人民共和国 婚姻法 》 第七条 第 （ 一 ） 项 、 第十条 第 （ 二 ） 项 ， 最高人民法院 关于 适用 《 中华人民共和国 婚姻法 》 若干 问题 的 解释 （ 一 ） 第九条 第一项 和 《 中华人民共和国 民事 诉讼法 》 第一百 四十二条 、 第 一百四十四 条 之 规定 ， 判决 如下 ： 

许某某诉被告李某某离婚纠纷一审民事判决书.txt	依照 《 中华人民共和国 婚姻法 》 第三十二条 第二款 、 《 中华人民共和国 民事 诉讼法 》 第六十四 条 第一款 、 第六十五条 第一款 、 《 最高人民法院 关于 民事诉讼 证据 的 若干 规定 》 第二条 、 第七十六条 之 规定 ， 判决 如下 ： 

许某诉梁某甲离婚纠纷一审民事判决书.txt	依照 《 中华人民共和国 婚姻法 》 第三十二条 的 规定 ， 判决 如下 ： 

谌某甲诉郭某某离婚纠纷一审民事裁定书.txt	依照 《 中华人民共和国 民事 诉讼法 》 第 一百四十 五条 第一款 、 第一百五十四条 第一款 第 （ 五 ） 项 的 规定 ， 裁定 如下 ： 

谢明兰与程德正离婚纠纷一审民事判决书.txt	依照 《 中华人民共和国 婚姻法 》 第三十二条 、 《 中华人民共和国 民事 诉讼法 》 第一百 四十二条 之 规定 ， 判决 如下 ： 

谢某与何某某离婚纠纷一审民事判决书.txt	依照 《 中华人民共和国 婚姻法 》 第三十二条 、 《 最高人民法院 关于 适用 〈 中华人民共和国 民事 诉讼法 〉 的 解释 》 第九 十条 之 规定 ， 判决 如下 ： 

谢某某与刘某某离婚纠纷案一审民事判决书.txt	依照 《 中华人民共和国 婚姻法 》 第三十二条 和 《 中华人民共和国 民事 诉讼法 》 第一百 四十二条 、 第一百 六十条 之 规定 ， 判决 如下 ： 

谢某某与姜某某离婚纠纷一审民事判决书.txt	据此 ， 依照 《 中华人民共和国 婚姻法 》 第三十二条 、 《 最高人民法院 关于 民事诉讼 证据 的 若干 规定 》 第二条 之 规定 ， 判决 如下 ： 

谢某某与张某甲离婚纠纷一审民事判决书.txt	据此 ， 依照 《 中华人民共和国 婚姻法 》 第三十二条 、 《 最高人民法院 关于 民事诉讼 证据 的 若干 规定 》 第二条 、 《 中华人民共和国 民事 诉讼法 》 第 一百四十四 之 规定 ， 判决 如下 ： 

谢某某与高某某离婚纠纷一审民事判决书.txt	据此 ， 本院 为 维护 婚姻自由 的 原则 ， 依照 《 中华人民共和国 婚姻法 》 第三十二条 第二款 、 第三款 第 （ 五 ） 项 、 第三十六条 、 第三十七条 之 规定 ， 判决 如下 ： 

谢某某诉谭某甲离婚纠纷一审民事判决书.txt	据此 ， 依照 《 中华人民共和国 婚姻法 》 三十二条 之 规定 ， 判决 如下 ： 

谢某某诉陈某离婚纠纷一审民事判决书.txt	据此 ， 本院 依照 《 中华人民共和国 婚姻法 》 第三十二条 、 《 中华人民共和国 民事 诉讼法 》 第六十四 条 、 第 一百四十四 条 ， 《 最高人民法院 关于 民事诉讼 证据 的 若干 规定 》 第二条 之 规定 ， 判决 如下 ： 

谭某某与王甲、王某乙、王某丙、王丁婚姻家庭、继承纠纷一审民事判决书.txt	据此 ， 依照 《 中华人民共和国 婚姻法 》 第十七条 ， 《 中华人民共和国 物权法 》 第九 十三条 、 第九十五条 、 第一 百条 ， 《 中华人民共和国 继承法 》 第十条 、 第十三条 、 第二十六条 ， 《 中华人民共和国 民事 诉讼法 》 第 一百四十四 条 的 规定 ， 判决 如下 ： 

谭某某与赵某某离婚纠纷案一审民事判决书.txt	依照 《 中华人民共和国 婚姻法 》 第三十二条 ， 第三十六条 、 第三十七条 和 《 中华人民共和国 民事 诉讼法 》 第 一百四十四 条 、 第一百 六十条 之 规定 ， 判决 如下 ： 

贵金存与曹晋元离婚纠纷一审民事判决书.txt	根据 《 中华人民共和国 婚姻法 》 第三十二条 、 《 中华人民共和国 民事 诉讼法 》 第六十四 条 第一款 、 《 最高人民法院 关于 民事诉讼 证据 的 若干 规定 》 第二条 之 规定 ， 判决 如下 ： 

贾某华与贾某渠离婚纠纷一审民事判决书.txt	依照 《 中华人民共和国 婚姻法 》 第三十二条 第二款 、 《 中华人民共和国 民事 诉讼法 》 第六十四 条 、 《 最高人民法院 关于 适用 〈 中华人民共和国 民事 诉讼法 〉 的 解释 》 第九 十条 之 规定 ， 判决 如下 ： 

贾某某与徐某甲离婚纠纷一审民事判决书.txt	依照 《 中华人民共和国 婚姻法 》 第三十二条 、 《 中华人民共和国 民事 诉讼法 》 第六十四 条 第一款 以及 《 最高人民法院 关于 适用 ﹤ 中华人民共和国 民事 诉讼法 ﹥ 的 解释 》 第九 十条 之 规定 ， 判决 如下 ： 

贾某某与王某甲离婚纠纷一案二审民事判决书.txt	据此 ， 依照 《 中华人民共和国 民事 诉讼法 》 第一百七十条 第一款 第二项 之 规定 ， 判决 如下 ： 

贾某诉李某离婚纠纷一审民事判决书.txt	根据 《 中华人民共和国 婚姻法 》 第三十二条 ， 《 最高人民法院 关于 民事诉讼 证据 的 若干 规定 》 第二条 ， 《 中华人民共和国 民事 诉讼法 》 第一百 四十二 之 规定 ， 判决 如下 ： 

贾某诉被告董某离婚纠纷一审民事判决书.txt	依照 《 中华人民共和国 婚姻法 》 第二十一条 、 第二十三条 、 第三十二条 、 第三十七条 之 规定 ， 判决 如下 ： 

赖某某与李某甲离婚纠纷一审民事判决书.txt	依照 《 中华人民共和国 民事 诉讼法 》 第 一百四十四 条 、 《 中华人民共和国 婚姻法 》 第三十二条 第二款 、 最高人民法院 《 关于 民事 证据 的 若干 规定 》 第二条 的 规定 ， 判决 如下 ： 

赖某某与龙某某离婚纠纷案一审民事判决书.txt	依照 《 中华人民共和国 婚姻法 》 第三十二条 、 第三十九条 及 《 中华人民共和国 民事 诉讼法 》 第一百 四十二条 、 第一百 六十条 之 规定 ， 判决 如下 ： 

赵某某与刘某离婚纠纷一审民事判决书.txt	据此 ， 依照 《 中华人民共和国 婚姻法 》 第三十二条 、 《 中华人民共和国 民事 诉讼法 》 第六十四 条 第一款 、 《 最高人民法院 关于 适用 〈 中华人民共和国 民事 诉讼法 〉 的 解释 》 第九 十条 、 《 中华人民共和国 民事 诉讼法 》 第 一百四十四 条 的 规定 ， 判决 如下 ： 

赵某某与朱某离婚纠纷一民事裁定书.txt	依照 《 中华人民共和国 民事 诉讼法 》 第 一百四十 三条 的 规定 ， 裁定 如下 ： 

赵某某与李某离婚纠纷一审民事判决书.txt	依照 《 中华人民共和国 婚姻法 》 第三十二条 、 《 中华人民共和国 民事 诉讼法 》 第 一百四十四 条 、 最高人民法院 《 关于 适用 〈 中华人民共和国 民事 诉讼法 〉 的 解释 》 第九 十条 之 规定 ， 判决 如下 ： 

赵某某与汤某某甲离婚纠纷一审民事判决书.txt	依照 《 中华人民共和国 婚姻法 》 第三十二条 、 《 中华人民共和国 民事 诉讼法 》 第六十四 条 第一款 、 第 一百四十四 条 、 最高人民法院 《 关于 适用 〈 中华人民共和国 民事 诉讼法 〉 的 解释 》 第九 十条 之 规定 ， 判决 如下 ： 

赵某某与汤某某离婚纠纷一审民事判决书.txt	依照 《 中华人民共和国 婚姻法 》 第三十二条 、 第三十七条 、 第三十九条 、 第四十一条 之 规定 判决 如下 ： 

赵某某与王某某离婚纠纷一审民事判决书.txt	根据 《 中华人民共和国 婚姻法 》 第三十二条 、 《 中华人民共和国 民事 诉讼法 》 第六十五条 、 第 一百四十四 条 之 规定 ， 判决 如下 ： 

赵某某诉吉某某离婚纠纷一审民事判决书.txt	依照 《 中华人民共和国 婚姻法 》 第三十二条 和 《 中华人民共和国 民事 诉讼法 》 第 一百四十 三条 之 规定 ， 判决 如下 ： 

赵某某诉钟某离婚纠纷一案一审民事判决书.txt	据此 ， 依照 《 中华人民共和国 婚姻法 》 第三十二条 、 《 中华人民共和国 民事 诉讼法 》 第一百 四十八条 之 规定 ， 判决 如下 ： 

赵某琴因与被上诉人罗某扬离婚纠纷一案二审民事判决.txt	依照 《 中华人民共和国 民事 诉讼法 》 第一百七十条 第一款 第 （ 一 ） 项 的 规定 ， 判决 如下 ： 

赵某甲与周某某离婚纠纷一审民事判决书.txt	据此 ， 依照 《 中华人民共和国 民事 诉讼法 》 一百四十四 条 、 《 中华人民共和国 婚姻法 》 第三十二条 ， 《 最高人民法院 关于 人民法院 审理 离婚 案件 如何 认定 夫妻 确 已 破裂 的 若干 具体意见 》 第七条 之 规定 ， 判决 如下 ： 

赵某甲与李某甲离婚纠纷一审民事判决书.txt	依照 《 中华人民共和国 婚姻法 》 第三十二条 第二款 及 《 最高人民法院 关于 民事诉讼 证据 的 若干 规定 》 第二条 、 第七十六条 之 规定 ， 判决 如下 ： 

赵某甲诉王某甲离婚纠纷一审民事判决书.txt	依照 《 中华人民共和国 婚姻法 》 第三十二条 、 第三十九条 ， 《 中华人民共和国 民事 诉讼法 》 第 一百四十四 条的 的 规定 ， 判决 如下 ： 

蹇某与陈某甲离婚纠纷一审民事判决书.txt	据此 ， 依照 《 中华人民共和国 婚姻法 》 第三十二条 二款 （ 四 ） 、 （ 五 ） 项 、 第三十九条 、 第四十一条 ， 《 中华人民共和国 民事 诉讼法 》 第六十四 条 ， 最高人民法院 《 关于 民事诉讼 证据 的 若干 规定 》 第二条 之 规定 ， 经 本院 审判 委员会 研究 决定 ， 判决 如下 ： 

车某与卢某某离婚纠纷一审民事判决书.txt	据此 ， 依照 《 中华人民共和国 民事 诉讼法 》 第 一百四十四 条 及 《 中华人民共和国 婚姻法 》 第三十二条 三款 四项 、 第三十七条 之 规定 ， 判决 如下 ： 

车某甲与张某甲离婚纠纷一审民事判决书.txt	据此 ， 依照 《 中华人民共和国 婚姻法 》 第三十二条 、 第三十六条 、 第三十七条 、 第三十八条 及 《 最高人民法院 关于 人民法院 审理 离婚 案件 处理 子女 抚养 问题 的 若干 具体意见 》 第 4 条 及 《 中华人民共和国 民事 诉讼法 》 第 一百四十四 条 之 规定 ， 判决 如下 ： 

邓某与李某离婚纠纷一审民事判决书.txt	据此 ， 为 保护 当事人 的 合法权益 ， 维护 正常 婚姻家庭 秩序 ， 依照 《 中华人民共和国 民事 诉讼法 》 第六十四 条 、 第 一百四十四 条 和 《 最高人民法院 关于 适用 的 解释 》 第九 十条 的 规定 ， 判决 如下 ： 

邓某与舒某某离婚纠纷一审民事判决书.txt	据此 ， 依照 《 中华人民共和国 婚姻法 》 第三十二条 第二款 、 第三十六 、 第三十七条 之 规定 ， 判决 如下 ： 

邓某某与刘某离婚纠纷一审民事判决书.txt	依照 《 中华人民共和国 民事 诉讼法 》 第一百 四十二条 和 《 中华人民共和国 婚姻法 》 第三十二条 之 规定 ， 判决 如下 ： 

邓某某与张某离婚纠纷一审民事判决书.txt	依照 《 中华人民共和国 婚姻法 》 第三十二条 第二款 之 规定 ， 判决 如下 ： 

邓某某与杨某某离婚纠纷一审民事判决书.txt	依照 《 中华人民共和国 婚姻法 》 第三十二条 及 最高人民法院 《 关于 民事诉讼 证据 的 若干 规定 》 第二条 第二款 的 规定 ， 判决 如下 ： 

邓某某与陈某某离婚纠纷一审民事判决书.txt	依照 《 中华人民共和国 婚姻法 》 第三十二条 、 第三十七条 、 第三十八条 、 第四十一条 、 《 中华人民共和国 民事 诉讼法 》 第 一百四十四 条 之 规定 ， 判决 如下 ： 

邓某某与黄某甲离婚纠纷一审民事判决书.txt	据此 ， 依照 《 中华人民共和国 婚姻法 》 第三十二条 、 《 中华人民共和国 民事 诉讼法 》 第六十四 条 及 《 最高人民法院 关于 民事诉讼 证据 的 若干 规定 》 第二条 之 规定 ， 判决 如下 ： 

邓某甲与邓某乙离婚纠纷一审民事裁定书.txt	依照 《 中华人民共和国 民事 诉讼法 》 第 一百四十 五条 、 第一百五十四条 第一款 （ 五 ） 项之 规定 ， 裁定 如下 ： 

邓某甲与陈某甲离婚纠纷一审民事判决书.txt	依照 《 中华人民共和国 婚姻法 》 第三十二条 、 第三十七条 、 第四十一条 之 规定 ， 判决 如下 ： 

邓超英与彭江离婚纠纷案一审民事判决书.txt	据此 ， 依照 《 中华人民共和国 婚姻法 》 第三十二条 、 第三十六条 第三款 的 规定 ， 判决 如下 ： 

邱某某与杨某离婚纠纷案一审民事判决书.txt	据此 ， 依照 《 中华人民共和国 婚姻法 》 第二十一条 、 第三十二条 第二款 、 第三十七条 ， 《 最高人民法院 关于 人民法院 审理 离婚 案件 处理 子女 抚养 问题 的 若干 具体意见 》 第 7 条 ， 《 中华人民共和国 民事 诉讼法 》 第 一百四十四 条 之 规定 ， 判决 如下 ： 

邱某某与熊甲离婚纠纷一审民事判决书.txt	依照 《 中华人民共和国 婚姻法 》 第三十二条 、 《 最高人民法院 关于 人民法院 审理 离婚 案件 如何 认定 夫妻感情 确 已 破裂 的 若干 具体意见 》 七条 ， 《 中华人民共和国 民事 诉讼法 》 第 一百四十四 条 的 规定 ， 判决 如下 ： 

邱某某诉杨某某离婚纠纷一案一审民事判决书.txt	依照 《 中华人民共和国 婚姻法 》 第四条 、 第三十二条 、 《 中华人民共和国 民事 诉讼法 》 第 一百四十四 条 之 规定 ， 判决 如下 ： 

邵某某与江某离婚后财产分割管辖纠纷一案二审民事裁定书.txt	依照 《 中华人民共和国 民事 诉讼法 》 第一百七十条 第一款 （ 一 ） 项 " 原 判决 、 裁定 认定 事实清楚 ， 适用法律 正确 的 ， 以 判决 、 裁定 方式 驳回上诉 ， 维持原判 、 裁定 " 和 第 一百七十 一条 " 第二审 人民法院 对 不服 第一审 人民法院 裁定 的 上诉 案件 的 处理 ， 一律 使用 裁定 " 的 规定 ， 裁定 如下 ： 

邹某某与任某某离婚纠纷一审民事判决书.txt	依照 《 中华人民共和国 婚姻法 》 第三十二条 的 规定 ， 判决 如下 ： 

邹某甲与陈某某离婚纠纷一审民事判决书.txt	据此 ， 依据 《 中华人民共和国 婚姻法 》 第三十二条 、 第三十六条 之 规定 ， 判决 如下 ： 

郑某某与叶某甲离婚纠纷一案民事判决书.txt	据此 ， 依照 《 中华人民共和国 婚姻法 》 第三十二条 、 最高人民法院 关于 适用 《 中华人民共和国 民事 诉讼法 》 的 解释 第九 十条 之 规定 ， 判决 如下 ： 

郑某某与宋某某离婚纠纷二审民事判决书.txt	据此 ， 依照 《 中华人民共和国 民事 诉讼法 》 第一百七十条 第一款 第一项 之 规定 ， 判决 如下 ： 

郑某某诉曾某某离婚纠纷一审民事裁定书.txt	依照 《 中华人民共和国 民事 诉讼法 》 第 一百四十 三条 、 第一百五十四条 第一款 第 （ 十一 ） 项之 规定 ， 裁定 如下 ： 

郑某某诉肖某某离婚纠纷一案民事判决书.txt	据此 ， 依照 《 中华人民共和国 婚姻法 》 第三十二条 、 最高人民法院 关于 适用 《 中华人民共和国 民事 诉讼法 》 的 解释 第九 十条 之 规定 ， 判决 如下 ： 

郦某某诉周某某离婚纠纷一审民事判决书.txt	据此 ， 依照 《 中华人民共和国 婚姻法 》 第三十二条 ， 《 最高人民法院 关于 适用 ＜ 中华人民共和国 民事 诉讼法 ＞ 的 解释 》 第九 十条 之 规定 ， 判决 如下 ： 

郭某与张某甲离婚纠纷一审民事判决书.txt	据此 ， 依照 《 中华人民共和国 婚姻法 》 第三十二条 、 《 最高人民法院 关于 适用 ﹤ 中华人民共和国 民事 诉讼法 ﹥ 的 解释 》 第九 十条 的 规定 ， 判决 如下 ： 

郭某某与任某甲离婚纠纷一审民事判决书.txt	依照 《 中华人民共和国 婚姻法 》 第三十二条 以及 《 中华人民共和国 民事 诉讼法 》 第六十四 条 第一款 、 第 一百四十四 条 以及 《 最高人民法院 关于 适用 ﹤ 中华人民共和国 民事 诉讼法 ﹥ 的 解释 》 第九 十条 之 规定 ， 判决 如下 ： 

郭某某与吴某甲离婚纠纷一审民事判决书.txt	据此 ， 依照 《 中华人民共和国 婚姻法 》 第三十二条 第三款 第 （ 三 ） 项 、 第三十六条 第三款 、 第三十七条 、 第四十一条 及 《 中华人民共和国 民事 诉讼法 》 第六十四 条 、 第 一百四十四 条 及 之 规定 ， 判决 如下 ： 

郭某某与景某某离婚纠纷案一审民事判决书.txt	依照 《 中华人民共和国 婚姻法 》 第三十二条 、 第三十六条 、 第三十七条 和 《 中华人民共和国 民事 诉讼法 》 第 一百四十四 条 、 第一百 六十条 之 规定 ， 判决 如下 ： 

郭某某与罗某某离婚纠纷一案民事判决书.txt	依照 《 中华人民共和国 婚姻法 》 第三十二条 、 《 中华人民共和国 民事 诉讼法 》 第六十四 条 第一款 、 最高人民法院 《 关于 民事诉讼 证据 的 若干 规定 》 第二条 之 规定 ， 判决 如下 ： 

郭某某与赵某某离婚纠纷一审民事判决书.txt	依照 《 中华人民共和国 婚姻法 》 第三十二条 的 规定 ， 判决 如下 ： 

郭某某与黄某某离婚纠纷一审民事判决书.txt	依照 《 中华人民共和国 婚姻法 》 第三十二条 、 最高人民法院 《 关于 民事诉讼 证据 的 若干 规定 》 第二条 的 规定 ， 判决 如下 ： 

郭某甲与刘某某离婚纠纷一案一审民事判决书.txt	据此 ， 特 依照 《 中华人民共和国 婚姻法 》 第三十二条 及 最高人民法院 《 关于 民事诉讼 证据 的 若干 规定 》 第二条 ， 判决 如下 ： 

郭某甲与林某某离婚纠纷一审民事判决书.txt	依照 《 中华人民共和国 婚姻法 》 第三十二条 、 最高人民法院 《 关于 民事诉讼 证据 的 若干 规定 》 第二条 的 规定 ， 判决 如下 ： 

郭某甲诉李某甲离婚纠纷一审民事判决书.txt	依照 《 中华人民共和国 婚姻法 》 第三十二条 第二款 、 第三款 第五项 、 第三十七条 第一款 、 第四十二条 和 最高人民法院 关于 适用 《 中华人民共和国 婚姻法 》 若干 问题 的 解释 （ 一 ） 第二十七条 及 【 最高人民法院 《 关于 人民法院 审理 离婚 案件 如何 认定 夫妻感情 确 已 破裂 的 若干 具体意见 》 】 第三条 的 规定 ， 判决 如下 ： 

郭某诉周某离婚纠纷一审民事判决书.txt	依照 《 中华人民共和国 婚姻法 》 第三十一条 、 第三十六条 、 第三十七条 、 《 中华人民共和国 民事 诉讼法 》 第六十四 条 、 《 最高人民法院 关于 民事诉讼 证据 的 若干 规定 》 第二条 第二款 之 规定 ， 判决 如下 ： 

金某某与于某某离婚纠纷一审民事判决书.txt	依照 《 中华人民共和国 婚姻法 》 第三十二条 的 规定 ， 判决 如下 ： 

金某某与代某甲离婚纠纷一审民事判决书.txt	依照 《 中华人民共和国 婚姻法 》 第三十二条 、 最高人民法院 《 关于 民事诉讼 证据 的 若干 规定 》 第二条 的 规定 ， 判决 如下 ： 

钟某与罗某甲离婚纠纷一审民事判决书.txt	据此 ， 为 保护 当事人 的 合法权益 ， 维护 正常 婚姻家庭 秩序 ， 依照 《 中华人民共和国 婚姻法 》 第三十二条 和 《 中华人民共和国 民事 诉讼法 》 第 一百四十四 条 的 规定 ， 判决 如下 ： 

钟某某与夏某甲离婚纠纷一案一审民事判决书.txt	依照 《 中华人民共和国 婚姻法 》 第三十二条 第二款 第三款 " 人民法院 审理 离婚 案件 ， 应当 进行 调解 ； 如 感情 确 已 破裂 ， 调解 无效 ， 应 准予 离婚 。 有 下列 情形 之一 ， 调解 无效 的 ， 应 准予 离婚 ： （ 一 ） 重婚 或 有 配偶 者 与 他人 同居 的 ； （ 二 ） 实施 家庭暴力 或 虐待 、 遗弃 家庭成员 的 ； （ 三 ） 有 赌博 、 吸毒 等 恶习 屡教不改 的 ； （ 四 ） 因 感情 不 和 分居 满 二年 的 ； （ 五 ） 其他 导致 夫妻 感情破裂 的 情形 " 之 规定 ， 判决 如下 ： 

钱某某与李某某离婚后子女抚养、财产分割纠纷一审民事判决书.txt	依照 《 中华人民共和国 婚姻法 》 第三十六条 、 第三十八条 、 最高人民法院 关于 适用 《 中华人民共和国 婚姻法 》 若干 问题 的 解释 （ 二 ） 第八条 之 规定 ， 判决 如下 ： 

阿衣某某与吴某甲离婚纠纷一审民事判决书.txt	依照 《 中华人民共和国 婚姻法 》 第三十二条 第二款 之 规定 ， 判决 如下 ： 

陈某与刘某某离婚纠纷案一审民事判决书.txt	依照 《 中华人民共和国 婚姻法 》 第三十二条 和 《 中华人民共和国 民事 诉讼法 》 第 一百四十四 条 、 第一百 六十条 之 规定 ， 判决 如下 ： 

陈某与周某、蒋某素、周某林婚约财产纠纷一审民事判决书.txt	据此 ， 根据 《 中华人民共和国 婚姻法 》 第十八条 第一款 （ 一 ） 项 、 《 最高人民法院 关于 适用 〈 中华人民共和国 婚姻法 〉 若干 问题 的 解释 （ 二 ） 》 第十条 （ 一 ） 项 规定 ， 判决 如下 ： 

陈某与周甲离婚纠纷一审民事判决书.txt	依照 《 中华人民共和国 婚姻法 》 第三十二条 的 规定 ， 判决 如下 ： 

陈某与尹某离婚纠纷一审民事判决书.txt	依照 《 中华人民共和国 婚姻法 》 第三十二条 、 《 中华人民共和国 民事 诉讼法 》 第六十四 条 第一款 、 《 最高人民法院 关于 民事诉讼 证据 的 若干 规定 》 第二条 及 《 中华 人民法院 于 民事 诉讼法 》 第 一百四十四 条 之 规定 ， 判决 如下 ： 

陈某与曾某某离婚纠纷案一审民事判决书.txt	依照 《 中华人民共和国 婚姻法 》 第三十二条 和 《 中华人民共和国 民事 诉讼法 》 第一百 四十二条 、 第一百 六十条 之 规定 ， 判决 如下 ： 

陈某与李某某离婚纠纷一审民事判决书.txt	依照 《 中华人民共和国 民事 诉讼法 》 第一百 四十二条 和 《 中华人民共和国 婚姻法 》 第三十二条 之 规定 ， 判决 如下 ： 

陈某与李某某离婚纠纷民事一审民事判决书.txt	依照 《 中华人民共和国 民事 诉讼法 》 第一百 四十二条 和 《 中华人民共和国 婚姻法 》 第三十二条 之 规定 ， 判决 如下 ： 

陈某与王某某离婚纠纷一审民事裁定书.txt	据此 ， 依据 《 中华人民共和国 民事 诉讼法 》 第 一百一十 九条 、 第一百五十四条 第一款 第 （ 三 ） 项之 规定 ， 裁定 如下 ： 

陈某与王某离婚纠纷一审民事判决书.txt	依据 《 中华人民共和国 民事 诉讼法 》 第六十四 条 第一款 " 当事人 对 自己 提出 的 主张 ， 有 责任 提供 证据 。 " 和 《 最高人民法院 关于 民事诉讼 证据 的 若干 规定 》 第二条 " 当事人 对 自己 提出 的 诉讼请求 所 依据 的 事实 或者 反驳 对方 诉讼请求 所 依据 的 事实 有 责任 提供 证据 加以 证明 。 没有 证据 或者 证据 不足以 证明 当事人 的 事实 主张 的 ， 由 负有 举证责任 的 当事人 承担 不利 后果 " 之 规定 ， 判决 如下 ： 

陈某华与孙某朋离婚纠纷一审民事判决书.txt	依照 《 中华人民共和国 婚姻法 》 第三十二条 第一款 男女 一方 要求 离婚 的 ， 可 由 有关 部门 进行 调解 或 直接 向 人民法院 提出 离婚 诉讼 。 之 规定 ， 故对 原告 陈某华 起诉 与 被告 孙某 朋 离婚 纠纷 一案 ， 应予 受理 。 原告 陈某华 请求 与 被告 孙某 朋 离婚 ， 但 未 提供 证明 夫妻感情 确 已 破裂 的 证据 ， 依照 《 最高人民法院 关于 适用 ﹤ 中华人民共和国 民事 诉讼法 ﹥ 的 解释 》 第九 十条 ： 当事人 对 自己 提出 的 诉讼请求 所 依据 的 事实 或者 反驳 对方 诉讼请求 所 依据 的 事实 ， 应当 提供 证据 加以 证明 ， 但 法律 另 有 规定 的 除外 。 在 作出 判决 前 ， 当事人 未能 提供 证据 或者 证据 不足以 证明 其 事实 主张 的 ， 由 负有 举证 证明 责任 的 当事人 承担 不利 的 后果 。 之 规定 ， 故 本院 不予 支持 。 被告 孙某 朋经 本院 传票 传唤 未 到庭 参加 诉讼 ， 依照 《 中华人民共和国 民事 诉讼法 》 第 一百四十四 条 被告 经 传票 传唤 ， 无下 当 理由 拒 不 到庭 的 ， 或 未经 法庭 许何 中途 退庭 的 ， 可以 缺席判决 ， 被告 经 人民法院 传唤 ， 无 正当理由 拒 不 到庭 ， 不 影响 对 本案 公正 审理 ， 由此 可能 产生 的 不利 后果 由其 自行 承担 。 为 保护 当事人 的 合法权益 ， 维护 正常 的 婚姻家庭 关系 ， 根据 《 中华人民共和国 婚姻法 》 第三十二条 第二款 之 规定 ， 判决 如下 ： 

陈某某与何某离婚纠纷一审民事判决书.txt	依照 《 中华人民共和国 婚姻法 》 第三十二条 的 规定 ， 判决 如下 ： 

陈某某与余某某离婚纠纷一审民事判决书.txt	依照 《 中华人民共和国 婚姻法 》 第三十二条 、 《 最高人民法院 关于 民事诉讼 证据 的 若干 规定 》 第二条 之 规定 ， 判决 如下 ： 

陈某某与冯某离婚纠纷一审民事判决书.txt	据此 ， 为 维护 婚姻家庭 关系 的 稳定 ， 依照 《 中华人民共和国 婚姻法 》 第三十二条 、 《 中华人民共和国 民事 诉讼法 》 第六十四 条 第一款 、 《 最高人民法院 关于 适用 〈 中华人民共和国 民事 诉讼法 〉 的 解释 》 第九 十条 的 规定 ， 判决 如下 ： 

陈某某与刘某某离婚纠纷一审民事判决书.txt	据此 ， 为了 保护 当事人 的 合法权益 ， 维护 家庭 及 社会 的 和谐 稳定 ， 依照 《 中华人民共和国 民事 诉讼法 》 第六十四 条 第一款 ， 最高人民法院 关于 适用 《 民事 诉讼法 》 的 解释 第九 十条 ， 《 最高人民法院 关于 民事诉讼 证据 的 若干 规定 》 第二条 的 规定 ， 判决 如下 ： 

陈某某与唐某某离婚纠纷一审民事判决书.txt	依照 《 中华人民共和国 婚姻法 》 第三十二条 第三款 第 （ 四 ） 项 、 第三十六条 、 第三十七条 第一款 、 《 最高人民法院 对 审理 离婚 案件 处理 子女 抚养 问题 的 若干 具体意见 》 第四条 、 第七条 、 第八条 、 第十一条 、 《 中华人民共和国 民事 诉讼法 》 第九十二 条 、 第 一百四十四 条 的 规定 ， 判决 如下 ： 

陈某某与岳某某离婚纠纷案一审民事判决书.txt	依照 《 中华人民共和国 婚姻法 》 第三十二条 ， 《 中华人民共和国 民事 诉讼法 》 第一百 四十二条 、 第一百 六十条 之 规定 ， 判决 如下 ： 

陈某某与明某甲离婚纠纷一审民事判决书.txt	根据 《 中华人民共和国 婚姻法 》 第三十二条 之 规定 ， 判决 如下 ： 

陈某某与毛某某离婚纠纷一审民事判决书.txt	依照 《 中华人民共和国 婚姻法 》 第三十二条 第二款 之 规定 ， 判决 如下 ： 

陈某某与江某某离婚纠纷案一审民事判决书.txt	依照 《 中华人民共和国 婚姻法 》 第三十二条 、 第三十九条 、 第四十二条 ， 《 中华人民共和国 民事 诉讼法 》 第一百 四十二条 、 第一百 六十条 之 规定 ， 判决 如下 ： 

陈某某与王某某离婚纠纷一审民事判决书.txt	据此 ， 为了 保护 当事人 的 合法权益 ， 维护 家庭 及 社会 的 和谐 稳定 ， 依照 《 中华人民共和国 民事 诉讼法 》 第六十四 条 第一款 ， 《 中华人民共和国 婚姻法 》 第三十二条 第二款 ， 《 最高人民法院 关于 民事诉讼 证据 的 若干 规定 》 第二条 的 规定 ， 判决 如下 ： 

陈某某与秦某某离婚纠纷案一审民事判决书.txt	依照 《 中华人民共和国 婚姻法 》 第三十二条 和 《 中华人民共和国 民事 诉讼法 》 第 一百四十四 条 、 第一百 六十条 之 规定 ， 判决 如下 ： 

陈某某与蒲某某离婚纠纷案一审民事判决书.txt	依照 《 中华人民共和国 婚姻法 》 第三十二条 、 最高人民法院 《 关于 民事诉讼 证据 的 若干 规定 》 第二条 和 《 中华人民共和国 民事 诉讼法 》 第六十四 条 、 第 一百四十四 条 、 第一百 六十条 之 规定 ， 判决 如下 ： 

陈某某与谢某甲离婚纠纷一审民事判决书.txt	依照 《 中华人民共和国 婚姻法 》 第三十二条 、 《 中华人民共和国 民事 诉讼法 》 第 一百四十四 条 、 最高人民法院 关于 适用 《 中华人民共和国 民事 诉讼法 》 的 解释 第九 十条 之 规定 ， 判决 如下 ： 

陈某某与邓某某离婚纠纷一审民事判决书.txt	依照 《 中华人民共和国 民事 诉讼法 》 第一百 四十二条 、 《 中华人民共和国 婚姻法 》 第三十二条 的 规定 ， 判决 如下 ： 

陈某某诉刘某某离婚纠纷一审民事判决书.txt	据此 ， 依照 《 中华人民共和国 婚姻法 》 第三十二条 ， 《 中华人民共和国 民事 诉讼法 》 第 一百四十四 条 ， 《 最高人民法院 关于 适用 ＜ 中华人民共和国 民事 诉讼法 ＞ 的 解释 》 第九 十条 之 规定 ， 判决 如下 ： 

陈某某诉被告张某某离婚纠纷一审民事判决书.txt	根据 《 中华人民共和国 婚姻法 》 第三十二条 " 人民法院 审理 离婚 案件 ， 应当 进行 调解 ； 如 感情 确 已 破裂 ， 调解 无效 ， 应 准予 离婚 " 及 《 中华人民共和国 民事 诉讼法 》 第 一百四十四 条 " 被告 经 传票 传唤 ， 无 正当理由 拒 不 到庭 的 ， 或者 未经 法庭 许可 中途 退庭 的 ， 可以 缺席判决 " 之 规定 ， 判决 如下 ： 

陈某某诉被告郭某某离婚纠纷一审民事判决书.txt	根据 《 中华人民共和国 婚姻法 》 第三十二条 " 人民法院 审理 离婚 案件 ， 应当 进行 调解 ； 如 感情 确 已 破裂 ， 调解 无效 ， 应 准予 离婚 " 之 规定 ， 判决 如下 ： 

陈某某诉邱某甲离婚纠纷一审民事判决书.txt	据此 ， 依照 《 中华人民共和国 婚姻法 》 第三十二条 第五款 和 最高人民法院 关于 适用 《 中华人民共和国 民事 诉讼法 》 的 解释 第九 十条 第二款 之 规定 ， 判决 如下 ： 

陈某梅与孙某离婚纠纷一审民事判决书.txt	据此 ， 为了 保护 当事人 的 合法权益 ， 促进 社会 的 稳定 ， 依照 《 中华人民共和国 婚姻法 》 第三十二条 第二款 、 《 中华人民共和国 民事 诉讼法 》 第六十四 条 第一款 、 《 最高人民法院 关于 民事诉讼 证据 的 若干 规定 》 第二条 的 规定 ， 判决 如下 ： 

陈某甲与刘某甲离婚纠纷一审民事判决书.txt	依照 《 中华人民共和国 婚姻法 》 第三十二条 和 最高人民法院 《 关于 民事诉讼 证据 的 若干 规定 》 第二条 之 规定 ， 判决 如下 ： 

陈某甲与周某某离婚纠纷一审民事判决书.txt	据此 ， 依照 《 中华人民 共和 民事 诉讼法 》 第六十四 条 第一款 之 规定 ， 判决 如下 ： 

陈某甲与王某甲离婚纠纷一审民事裁定书.txt	根据 《 中华人民共和国 民事 诉讼法 》 第 一百四十 三条 " 原告 经 传票 传唤 ， 无 正当理由 拒 不 到庭 的 ， 或者 未经 法庭 许可 中途 退庭 的 ， 可能 按 撤诉 处理 ； 被告 反诉 的 ， 可以 缺席判决 。 " 的 规定 ， 裁定 如下 ： 

陈某甲与董某某离婚纠纷一审民事判决书.txt	依据 《 中华人民共和国 婚姻法 》 第三十二条 、 第三十六条 、 第三十七条 之 规定 ， 判决 如下 ： 

陈某诉刘某离婚纠纷一审民事判决书.txt	据此 ， 依照 《 中华人民共和国 婚姻法 》 第三十二条 、 第三十六条 、 第三十七条 之 规定 ， 判决 如下 ： 

陈某诉梁某某离婚纠纷一审民事判决书.txt	依照 《 中华人民共和国 婚姻法 》 第三十二条 ， 最高人民法院 《 关于 民事诉讼 证据 的 若干 规定 》 第三十四条 、 第七十六条 之 规定 ， 判决 如下 ： 

陈甲某某与刘某某离婚纠纷一审民事判决书.txt	根据 《 中华人民共和国 婚姻法 》 第三十二条 之 规定 ， 判决 如下 ： 

陈英与刘凡刚离婚纠纷二审民事裁定书.txt	依照 《 中华人民共和国 民事 诉讼法 》 第一百七十条 第一款 第 （ 四 ） 项 的 规定 ， 裁定 如下 ： 

陶传琼与王良光离婚纠纷一审民事判决书.txt	据此 ， 依照 《 中华人民共和国 婚姻法 》 第三十二条 、 《 最高人民法院 关于 民事诉讼 证据 的 若干 规定 》 第二条 、 《 中华人民共和国 民事 诉讼法 》 第六十四 条 第一款 之 规定 ， 判决 如下 ： 

陶某与任某离婚纠纷一审民事判决书.txt	依照 《 中华人民共和国 婚姻法 》 第三十二条 和 《 最高人民法院 关于 民事诉讼 证据 的 若干 规定 》 第二条 之 规定 ， 判决 如下 ： 

陶某某诉杨某某离婚纠纷一案一审民事判决书.txt	依照 《 中华人民共和国 婚姻法 》 第三十二条 的 规定 ， 判决 如下 ： 

雍与黄某某离婚纠纷一审民事判决书.txt	据此 ， 依照 《 中华人民共和国 婚姻法 》 第三十二条 第二款 " 人民法院 审理 离婚 案件 ， 应当 进行 调解 ； 如 感情 确 已 破裂 ， 调解 无效 ， 应 准予 离婚 。 " 之 规定 ， 判决 如下 ： 

雍某与何某离婚纠纷一审民事判决书.txt	据此 ， 依照 《 中华人民共和国 婚姻法 》 第三十二条 、 《 中华人民共和国 民事 诉讼法 》 第六十四 条 、 《 最高人民法院 关于 适用 ﹤ 中华人民共和国 民事 诉讼法 ﹥ 的 解释 》 第九 十条 之 规定 ， 判决 如下 ： 

雍某某与黄某某离婚纠纷一审民事判决书.txt	据此 ， 依照 《 中华人民共和国 婚姻法 》 第三十二条 第二款 " 人民法院 审理 离婚 案件 ， 应当 进行 调解 ； 如 感情 确 已 破裂 ， 调解 无效 ， 应 准予 离婚 。 " 之 规定 ， 判决 如下 ： 

雍某某诉被告王某某、姜某甲、姜某乙离婚后财产纠纷一审民事判决书.txt	据此 ， 依照 《 中华人民共和国 民法通则 》 第五十七条 、 第六十六 条 、 第四条 、 《 中华人民共和国 合同法 》 第六条 、 第八条 、 第四十九条 、 第六十条 的 规定 ， 判决 如下 ： 

雷某与陈某离婚纠纷一审民事判决书.txt	据此 ， 依照 《 中华人民共和国 婚姻法 》 第三十二条 ， 《 中华人民共和国 民事 诉讼法 》 第六十四 条 、 第 一百四十四 条 之 规定 ， 《 最高人民法院 关于 审理 民事诉讼 证据 的 若干 规定 》 第二条 之 规定 ， 缺席判决 如下 ： 

靳某某与闫某某离婚纠纷一审民事判决书.txt	依照 《 中华人民共和国 民事 诉讼法 》 第六十四 条 第一款 、 第 一百四十四 条 、 《 最高人民法院 关于 适用 ﹤ 中华人民共和国 民事 诉讼法 ﹥ 的 解释 》 第九 十条 的 规定 ， 判决 如下 ： 

韩某与伏某离婚纠纷一审民事判决书.txt	依照 《 中华人民共和国 婚姻法 》 第三十二条 和 《 最高人民法院 关于 民事诉讼 证据 的 若干 规定 》 第二条 之 规定 ， 判决 如下 ： 

韩某某诉李某某离婚纠纷一审民事判决书.txt	依照 《 中华人民共和国 婚姻法 》 第三十二条 第二款 、 《 中华人民共和国 民事 诉讼法 》 第 一百四十四 条 和 《 最高人民法院 关于 民事诉讼 证据 的 若干 规定 》 第二条 第二款 之 规定 ， 判决 如下 ： 

顾某与程某某甲离婚纠纷一审民事判决书.txt	依照 《 中华人民共和国 民事 诉讼法 》 第六十四 条 、 《 最高人民法院 关于 适用 〈 中华人民共和国 民事 诉讼法 〉 的 解释 》 第九 十条 之 规定 ， 判决 如下 ： 

顾某某与张某某离婚纠纷一审民事判决书.txt	依照 《 中华人民共和国 婚姻法 》 第三十二条 、 《 中华人民共和国 民事 诉讼法 》 第六十四 条 第一款 、 第 一百四十四 条 、 最高人民法院 《 关于 适用 〈 中华人民共和国 民事 诉讼法 〉 的 解释 》 第九 十条 之 规定 ， 判决 如下 ： 

顾某某诉尹某某离婚纠纷一审民事判决书.txt	据此 ， 依照 《 中华人民共和国 婚姻法 》 第三十二条 ， 《 中华人民共和国 民事 诉讼法 》 第 一百四十四 条 ， 《 最高人民法院 关于 适用 ＜ 中华人民共和国 民事 诉讼法 ＞ 的 解释 》 第九 十条 之 规定 ， 判决 如下 ： 

顾某某诉谭某某离婚纠纷一审判决书.txt	据此 ， 依照 《 中华人民共和国 婚姻法 》 第三十二条 、 《 中华人民共和国 民事 诉讼法 》 第六十四 条 第一款 、 《 最高人民法院 关于 民事诉讼 证据 的 若干 规定 》 第二条 、 第七十六条 的 规定 ， 判决 如下 ： 

颜某某与李某某离婚纠纷案一审民事判决书.txt	依照 《 中华人民共和国 婚姻法 》 第三十二条 、 第三十六条 、 第三十七条 之 规定 ， 缺席判决 如下 ： 

马某某与何某甲离婚纠纷一审民事判决书.txt	依照 《 中华人民共和国 民事 诉讼法 》 第 一百四十四 条 、 《 中华人民共和国 婚姻法 》 第三十二条 第二款 、 最高人民法院 《 关于 民事 证据 的 若干 规定 》 第二条 的 规定 ， 判决 如下 ： 

马某某与刘某某离婚纠纷一审民事判决书.txt	据此 ， 原 告诉 请 离婚 的 证据不足 ， 理由 不 充分 ， 本院 不予 支持 。 依照 《 中华人民共和国 民事 诉讼法 》 第六十四 条 第一款 和 《 最高人民法院 关于 适用 〈 中华人民共和国 民事 诉讼法 〉 的 解释 》 第九 十条 的 规定 ， 判决 如下 ： 

马某某与张某甲离婚纠纷一审民事判决书.txt	依照 《 中华人民共和国 婚姻法 》 第三十二条 第三款 （ 五 ） 项 、 《 中华人民共和国 民事 诉讼法 》 第 一百四十四 条 之 规定 ， 判决 如下 ： 

骆某某与陈某甲离婚纠纷一审民事判决书.txt	据此 ， 依照 《 中华人民共和国 婚姻法 》 第三十二条 及 《 最高人民法院 关于 民事诉讼 证据 的 若干 规定 》 第二条 之的 规定 ， 判决 如下 ： 

高某与杨某某离婚纠纷一审民事裁定书.txt	依照 《 中华人民共和国 民事 诉讼法 》 第 一百四十 三条 的 规定 ， 裁定 如下 ： 

高某某与夏某甲离婚纠纷一审民事判决书.txt	依照 《 中华人民共和国 婚姻法 》 第三十二条 、 三十六条 、 三十七 条 的 规定 ， 判决 如下 ： 

高某某与杨某甲离婚纠纷案一审民事判决书.txt	据此 ， 依照 《 中华人民共和国 婚姻法 》 第三十二条 第二款 人民法院 审理 离婚 案件 ， 应当 进行 调解 ； 如 感情 确 已 破裂 ， 调解 无效 ， 应 准予 离婚 之 规定 ， 判决 如下 ： 

高某甲与聂某某离婚纠纷一审民事判决书.txt	据此 ， 依照 《 中华人民共和国 婚姻法 》 第三十二条 、 最高人民法院 《 关于 人民法院 审理 离婚 案件 如何 认定 夫妻感情 确 已 破裂 的 若干 具体意见 》 第 7 条 、 《 中华人民共和国 民事 诉讼法 》 第 一百四十四 条 之 规定 ， 缺席判决 如下 ： 

魏某某与邱某某离婚纠纷一审民事裁定书.txt	依照 《 中华人民共和国 民事 诉讼法 》 第一百 二十四条 、 《 最高人民法院 关于 适用 〈 中华人民共和国 民事 诉讼法 〉 的 解释 》 第二百 一 十四条 之 规定 ， 裁定 如下 ： 

魏某甲诉李某某离婚纠纷民事判决书.txt	据此 ， 依照 《 中华人民共和国 婚姻法 》 第三十二条 、 《 最高人民法院 关于 人民法院 审理 离婚 案件 如何 认定 夫妻感情 确 已 破裂 的 若干 具体意见 》 第 7 条 及 《 最高人民法院 关于 人民法院 审理 离婚 案件 处理 子女 抚养 问题 的 若干 具体意见 》 第 5 条 ， 判决 如下 ： 

魏某诉王某甲离婚纠纷一审民事判决书.txt	依照 《 中华人民共和国 婚姻法 》 第三十二条 的 规定 ， 判决 如下 ： 

鲁某某与赵某某离婚纠纷一审民事判决书.txt	据此 ， 依照 《 中华人民共和国 婚姻法 》 第三十二条 、 第三十六条 、 第三十七条 之 规定 ， 判决 如下 ： 

鲁某某诉邱某某离婚一审民事判决书.txt	依照 《 中华人民共和国 婚姻法 》 第三十二条 、 《 中华人民共和国 民事 诉讼法 》 第六十四 条 和 《 最高人民法院 关于 适用 〈 中华人民共和国 民事 诉讼法 〉 的 解释 》 第九 十条 之 规定 ， 判决 如下 ： 

鲜群碧与兰建元离婚纠纷一审民事判决书.txt	据此 ， 依照 《 中华人民共和国 婚姻法 》 第三十二条 、 《 最高人民法院 关于 民事诉讼 证据 的 若干 规定 》 第二条 ， 判决 如下 ： 

黄云凤与张开翔、黄云九离婚后财产分割纠纷二审民事判决书.txt	依照 《 中华人民共和国 民事 诉讼法 》 第一百七十条 第一款 第 （ 一 ） 项之 规定 ， 判决 如下 ： 

黄某与陈某离婚纠纷一审民事判决书.txt	依照 《 中华人民共和国 婚姻法 》 第三十二条 和 最高人民法院 《 关于 民事诉讼 证据 的 若干 规定 》 第二条 之 规定 ， 判决 如下 ： 

黄某某与余某甲离婚纠纷一审民事判决书.txt	据此 ， 依照 《 中华人民共和国 婚姻法 》 第三十二条 第四款 ， 《 中华人民共和国 民事 诉讼法 》 第 一百四十四 条 之 规定 ， 判决 如下 ： 

黄某某与兰某某离婚纠纷二审民事判决书.txt	依照 《 中华人民共和国 民事 诉讼法 》 第一百七十条 第一款 （ 一 ） 项之 规定 ， 判决 如下 ： 

黄某某与冯某某离婚纠纷案一审民事判决书.txt	依照 《 中华人民共和国 婚姻法 》 第三十二条 、 第三十六条 和 《 中华人民共和国 民事 诉讼法 》 第一百 六十条 、 第 一百四十四 条 、 第一百 四十二条 之 规定 ， 判决 如下 ： 

黄某某与叶某甲离婚纠纷一审民事判决书.txt	据此 ， 依照 《 中华人民共和国 婚姻法 》 第三十二条 、 第三十六条 、 第三十七条 ， 《 中华人民共和国 民事 诉讼法 》 第 一百四十四 条 ， 《 最高人民法院 关于 适用 ﹤ 中华人民共和国 婚姻法 ﹥ 若干 问题 的 解释 （ 一 ） 》 第二十一条 ， 《 最高人民法院 关于 适用 ﹤ 中华人民共和国 民事 诉讼法 ﹥ 的 解释 》 第九 十条 之 规定 ， 判决 如下 ： 

黄某某与曾某某离婚纠纷案一审民事判决书.txt	依照 《 中华人民共和国 婚姻法 》 第三十二条 和 《 中华人民共和国 民事 诉讼法 》 第一百 四十二条 、 第一百 六十条 之 规定 ， 判决 如下 ： 

黄某某与李某某离婚纠纷案一审民事判决书.txt	依照 《 中华人民共和国 婚姻法 》 第三十二条 、 最高人民法院 《 关于 民事诉讼 证据 的 若干 规定 》 第二条 和 《 中华人民共和国 民事 诉讼法 》 第 一百四十四 条 、 第六十四 条 、 第一百 六十条 之 规定 ， 判决 如下 ： 

黄某某与杨某某离婚纠纷案一审民事判决书.txt	依照 《 中华人民共和国 婚姻法 》 第三十二条 和 《 中华人民共和国 民事 诉讼法 》 第一百 六十条 、 第 一百四十四 条 、 第一百 四十二条 之 规定 ， 判决 如下 ： 

黄某某与艾某某离婚纠纷一审民事判决书.txt	据此 ， 依照 《 中华人民共和国 婚姻法 》 第三十二条 第二款 ： 人民法院 审理 离婚 案件 ， 应当 进行 调解 ； 如 感情 确 已 破裂 ， 调解 无效 ， 应 准予 离婚 。 的 规定 ， 判决 如下 ： 

黄某某与陈某某离婚后财产纠纷一审民事判决书.txt	本院认为 ， 被告 承认 原告 在 本案 中 主张 的 事实 ， 对 原告 主张 的 事实 本院 予以 确认 。 经 本院 审查 ， 被告 承认 原告 的 全部 诉讼请求 ， 没有 违反 法律 规定 。 本院 判决 如下 ： 

黄某某诉王某某离婚纠纷一审民事判决书.txt	据此 ， 依照 《 中华人民共和国 婚姻法 》 第三十二条 、 第三十六条 第三款 、 第三十七条 第一款 ， 最高人民法院 《 关于 适用 〈 中华人民共和国 婚姻法 〉 若干 问题 的 解释 （ 三 ） 》 第十八条 ， 最高人民法院 《 关于 适用 〈 中华人民共和国 民事 诉讼法 〉 的 解释 》 第九 十条 之 规定 ， 判决 如下 ： 

黄某甲与刘某甲离婚纠纷二审民事判决书.txt	依照 《 中华人民共和国 民事 诉讼法 》 第一百七十条 第一款 第 （ 一 ） 项 " 原 判决 、 裁定 认定 事实清楚 ， 适用法律 正确 的 ， 以 判决 、 裁定 方式 驳回上诉 ， 维持原判 决 、 裁定 " 的 规定 ， 判决 如下 ： 

黄某甲与曾某离婚纠纷一审民事判决书.txt	根据 《 中华人民共和国 民事 诉讼法 》 第六十四 条 、 《 最高人民法院 关于 适用 ﹤ 中华人民共和国 民事 诉讼法 ﹥ 的 解释 》 第九 十条 和 《 中华人民共和国 民事 诉讼法 》 第 一百四十四 条 之 规定 ， 判决 如下 ： 

黄某甲诉赵某某离婚纠纷一审民事判决书.txt	据此 ， 原告 请求 与 被告 离婚 ， 不予 支持 。 依照 《 中华人民共和国 民事 诉讼法 》 第六十四 条 第一款 " 当事人 对 自己 提出 的 主张 ， 有 责任 提供 证据 。 " 、 第 一百四十四 条 " 被告 经 传票 传唤 ， 无 正当理由 拒 不 到庭 ， 或者 未经 法庭 许可 中途 退庭 的 ， 可以 缺席判决 。 " ， 《 中华人民共和国 婚姻法 》 第三十二条 第二款 " 人民法院 审理 离婚 案件 ， 应当 进行 调解 ， 如 感情 确 已 破裂 ， 调解 无效 ， 应 准予 离婚 。 " 的 规定 ， 缺席判决 如下 ： 

黎某某与杨某某离婚纠纷一审民事判决书.txt	据此 ， 依照 《 中华人民共和国 婚姻法 》 第三十二条 第二款 " 人民法院 审理 离婚 案件 ， 应当 进行 调解 ； 如 感情 确 已 破裂 ， 调解 无效 ， 应 准予 离婚 。 " 及 《 中华人民共和国 民事 诉讼法 》 第 一百四十四 条 " 被告 经 传票 传唤 ， 无 正当理由 拒 不 到庭 的 ， 或者 未经 法庭 许可 中途 退庭 的 ， 可以 缺席判决 。 " 之 规定 ， 判决 如下 ： 

龙某诉曹某离婚纠纷一审民事判决书.txt	根据 《 中华人民共和国 婚姻法 》 第三十二条 " 人民法院 审理 离婚 案件 ， 应当 进行 调解 ； 如 感情 确 已 破裂 ， 调解 无效 ， 应 准予 离婚 " 及 《 中华人民共和国 民事 诉讼法 》 第 一百四十四 条 " 被告 经 传票 传唤 ， 无 正当理由 拒 不 到庭 的 ， 或者 未经 法庭 许可 中途 退庭 的 ， 可以 缺席判决 " 之 规定 ， 判决 如下 ： 

龚某某与孙某某离婚纠纷一审民事判决书.txt	根据 《 中华人民共和国 民事 诉讼法 法 》 第六十四 条 之 规定 ， 判决 如下 ： 

龚某某与岳某某离婚纠纷案一审民事判决书.txt	依照 《 中华人民共和国 婚姻法 》 第三十二条 和 《 中华人民共和国 民事 诉讼法 》 第 一百四十四 条 、 第一百 六十条 之 规定 ， 判决 如下 ： 

龚某某与李某某离婚纠纷一审民事判决书.txt	据此 ， 依照 《 中华人民共和国 婚姻法 》 第三十二条 、 最高人民法院 《 关于 适用 ﹤ 中华人民共和国 婚姻法 ﹥ 若干 问题 的 解释 （ 一 ） 》 第五条 第一款 、 最高人民法院 《 关于 人民法院 审理 未办 结婚登记 而 以 夫妻 名义 同居 生活 案件 的 若干意见 》 第 6 条 之 规定 ， 判决 如下 ： 

龚某某诉毕某某离婚纠纷一审民事判决书.txt	据此 ， 依照 《 中华人民共和国 婚姻法 》 第三十二 第三款 第 （ 五 ） 项 、 第三十六条 、 第三十七条 的 规定 ， 判决 如下 ： 

龚某甲与张某某离婚纠纷案一审民事判决书.txt	根据 《 中华人民共和国 婚姻法 》 第三十二条 第二款 、 《 最高人民法院 关于 适用 〈 中华人民共和国 民事 诉讼法 〉 的 解释 》 第九 十条 第一款 、 第二款 的 规定 ， 判决 如下 ： 

龚靖与刘华离婚纠纷一审民事判决书.txt	据此 ， 依照 《 中华人民共和国 婚姻法 》 第三十二条 、 《 最高人民法院 关于 民事诉讼 证据 的 若干 规定 》 第二条 ， 判决 如下 ： 
