168原告叶某甲诉被告王某某离婚纠纷案一审民事判决书.txt	不准 原告 叶某甲 与 被告 王 某某 离婚 。 

丁某某诉赵某甲离婚纠纷一审民事判决书.txt	准予 原告 丁 某某 与 被告 赵某 甲 离婚 。 

丁某甲与王某离婚纠纷一案 二审民事裁定书.txt	准许 上诉 人丁 某 甲 撤回 上诉 。 

万某兵与郑某琼离婚纠纷一审民事判决书.txt	不予 准许 原告 万某兵 与 被告 郑某琼 离婚 。 

万某某与王某某离婚纠纷一审民事判决书.txt	不 准予 原告 万 某某 与 被告 汪 某某 离婚 。 

万某某与袁某某离婚纠纷一审民事判决书.txt	不准 原告 万 某某 与 被告 袁 某某 离婚 。 

万某诉余某离婚纠纷民事一审判决书.txt	不准 原告 万 某某 与 被告 余 某某 离婚 。 

于某与苏某某离婚纠纷案一审民事判决书.txt	不准 原告 于 某 与 被告 苏 某某 离婚 。 

于某某诉彭某某离婚纠纷一案一审民事判决书.txt	不准 原告 于 某某 与 被告 彭 某某 离婚 。 

于某某诉邓某某离婚纠纷一审民事裁定书.txt	本案 按 撤诉 处理 。 

付某某与张某某离婚纠纷一审民事判决书.txt	准予 原告 付 某某 与 被告 张 某某 离婚 。 在 本 判决 发生 法律效力 前 ， 原 、 被告 不得 另行 结婚 。 

付某某与鄢某某离婚纠纷二审民事判决书.txt	驳回上诉 ， 维持原判 。 

代某某与周某离婚纠纷案一审民事判决书.txt	一 、 代 某某 与 周某 离婚 。 二 、 婚生子 代某甲 由 原告 抚养 ， 被告 应 承担 的 抚养费 由 原告 应 偿还 周某 在 石亭 信用社 的 贷款 10000 元 予以 折抵 。 被告 不再 支付 原告 代 某某 子女 抚养费 。 三 、 共同财产 位于 三台县 观桥镇 石亭 办事处 的 房屋 由 原 、 被告 双方 各自 平均 分割 。 四 、 周某 在 观桥 镇 石亭 信用 分社 的 20000 元 未 还 贷款 由 周某 负责 偿还 。 五 、 驳回 周某 的 其它 诉讼请求 。 

代某某与王某某离婚纠纷一案一审民事判决书.txt	一 、 准予 原告 代 某某 与 被告 王 某某 离婚 ； 二 、 婚生子 王某甲 由 被告 王 某某 抚养 ， 原告 代 某某 每月 承担 婚生子 生活费 400 元 ， 教育费 、 住院 医疗费 凭 票据 原 、 被告 各 承担 50 % 。 上述 费用 从 2016 年 3 月 起付 至 子女 年满 18 周岁 止 ； 生活费 于 每月 15 日前 支付 ， 教育费 、 住院 医疗费 于 每年 12 月 31 日前 付清 。 

代某某与王某甲离婚纠纷一审民事判决书.txt	不准 原告 代 某某 与 被告 王某 甲 离婚 。 

代某浩与郑某娟离婚纠纷一审判决书.txt	不 准予 原告 代某浩 与 被告 郑某 娟 离婚 。 

任安杰与孔小叶离婚纠纷二审民事裁定书.txt	本案 按 撤回 上诉 处理 。 

任某某与勾某某离婚纠纷一审民事判决书.txt	不准 原告 任 某某 与 被告 勾 某某 离婚 。 

任某某与杜某离婚纠纷一审民事判决书.txt	不准 原告 任 某某 与 被告 杜某 离婚 。 

任某某与牟某甲离婚纠纷一审民事判决书.txt	一 、 准予 原告 任 某某 与 被告 牟某 甲 离婚 ； 二 、 原 、 被告 之 子 牟某乙 随 被告 牟某 甲 生活 ， 从 2016 年 2 月 起 至 牟某 乙 年满 18 周岁 止 ， 由 原告 任 某某 每月 给付 牟某 乙 生活费 300 元 并 承担 牟某 乙 教育费 、 医疗费 （ 扣除 新农 合 报销 后 ） 的 二分之一 。 

任某甲与王某离婚纠纷一审民事判决书.txt	一 、 准予 原告 任某甲 与 被告 王某 离婚 ； 二 、 被告 王某 一次性 给付 原告 医药费 及 经济 补偿费 20000 元 （ 已 当庭 履行 ） 。 

任某甲诉李某某离婚纠纷判决书.txt	一 、 准予 原告 任某甲 与 被告 李 某某 离婚 。 二 、 原告 任某 甲 、 被告 李 某某 离婚 后 ， 婚生 女任 某 乙 由 被告 李 某某 具体 抚育 ， 原告 任某 甲 每月 给付 子女 生活费 1000 元 至 任某 乙 学业 完成 时 止 （ 此款 限 每年 6 月底 、 12 月底 各 支付 一次 ） ， 任某 乙 在校 期间 的 学费 由 任某 甲 、 李 某某 各 给付 一半 （ 此款 定于 每年 开学 时 支付 ） 。 原告 有 探望 子女 的 权利 ， 被告 有 协助 的 义务 。 三 、 位于 平昌县 江口 镇 新平 街 西段 4 号 附 2 幢 1 单元 6 号 的 房屋 一套 （ 原 平昌县 糖酒 公司 的 集资房 ） 归任 某 乙 所有 ， 被告 李 某某 享有 居住权 。 四 、 原告 任某 甲 一次性 给 被告 李 某某 精神 损害 赔偿金 20000 元 ， 生活 困难 帮助 金 25000 元 。 此款 在 本 判决 生效 后 十日 内 一次性 付清 。 如 未 按 本 判决 指定 的 期间 履行 金钱 给付 义务 的 ， 根据 《 中华人民共和国 民事 诉讼法 》 第 二百五十 三条 之 规定 ， 应当 加倍 支付 迟延 履行 期间 的 债务 利息 。 

伍某某与周某某离婚纠纷案一审民事判决书.txt	一 、 准予 原告 伍 某某 与 被告 周 某某 离婚 ； 二 、 婚生 女伍 某 甲 随 被告 周 某某 共同 生活 ， 原告 伍 某某 从 本 判决 生效 之日起 至 伍某 甲 年满 十八周岁 期间 ， 每月 支付 被告 周 某某 子女 生活费 500 元 ， 伍某甲 在 此 此间 的 医疗费 和 教育费 ， 由 原告 伍 某某 和 被告 周 某某 凭票 各自 负担 一半 ； 三 、 夫妻 共同财产 5433.96 元 ， 由 原告 伍 某某 与 被告 周 某某 各 分得 2716.98 元 ， 被告 周 某某 应分得 的 部分 ， 由 原告 伍 某某 在 本 判决 生效 后 十日 内 支付 给 被告 周 某某 。 如果 未 按 本 判决 指定 的 期间 履行 给付 金钱 义务 ， 应当 依照 《 中华人民共和国 民事 诉讼法 》 第 二百五十 三条 之 规定 ， 加倍 支付 迟延 履行 期间 的 债务 利息 。 

伍某某与张某某离婚纠纷一审民事判决书.txt	准予 原告 伍 某某 与 被告 张 某某 离婚 ； 原告 伍 某某 在 本 判决 生效 后 五日 内 给付 被告 张 某某 经济 帮助 费 3000 元 。 

伍某某与李某某离婚纠纷一审民事判决书.txt	不 准予 原告 伍 某某 与 被告 李 某某 离婚 。 

伍某某与辜某某离婚纠纷一审民事判决书.txt	准予 原告 伍 某某 与 被告 辜 某某 离婚 。 

何文艳与冯全离婚纠纷一审民事判决书.txt	不 准许 原告 何 某某 与 被告 冯某 离婚 。 

何某与张某甲离婚纠纷一审民事判决书.txt	不准 原告 何某 与 被告 张某 甲 离婚 。 

何某与杨甲离婚纠纷一审民事判决书.txt	一 、 准许 原告 何某 与 被告 杨甲 离婚 ； 二 、 婚生 次子 杨丙 由 被告 杨甲 抚养 ， 原告 何某 自本 判决 生效 之日起 按 500 元 ／ 月 的 标准 向 被告 杨甲 支付 杨丙 的 子女 抚养费 ， 直至 杨丙 年满 十八周岁 之日 止 ； 三 、 原 、 被告 婚姻关系 存续 期间 购买 的 位于 四川省 仪陇县 金 城镇 文化路 48 号 3 楼 的 住房 一套 （ 房屋 所有权证 号 ： 00013534 ， 登记 所有权 人 ： 杨甲 ， 建筑面积 ： 69.48 ㎡ ） 归 被告 杨甲 所有 ； 四 、 婚生子 杨乙 、 杨丙 自本 判决 生效 之日起 ， 至 大学毕业 期间 （ 含 读研 期间 在内 ） 的 学杂费 用 （ 凭 正式 发票 结算 ） 由 原告 何某 负担 。 如果 未 按 本 判决 指定 的 期间 履行 给付 金钱 义务 ， 应当 依照 《 中华人民共和国 民事 诉讼法 》 第 二百五十 三条 的 规定 ， 支付 迟延 履行 期间 的 加倍 债务 利息 。 

何某某与任某某离婚纠纷一审民事判决书.txt	不 准许 原告 何 某某 与 被告 任 某某 离婚 。 

何某某与何某甲离婚纠纷一审民事判决书.txt	一 、 准予 原告 何 某某 与 被告 何某 甲 离婚 ； 二 、 本 判决 生效 之日起 十日 内 ， 由 原告 何 某某 支付 被告 何某 甲 经济 帮助 人民币 20000.00 元 。 

何某某与何某甲离婚纠纷案一审民事判决书.txt	一 、 何 某某 与 何某 甲 离婚 。 二 、 现有 夫妻 共同财产 归何某 甲 所有 。 

何某某与刘某某离婚纠纷一审民事判决书.txt	不准 原告 何 某某 与 被告 刘 某某 离婚 。 

何某某与向某甲离婚纠纷案一审民事判决书.txt	不准 原告 何 某某 与 被告 向 某 甲 离婚 。 

何某某与唐某甲离婚纠纷一审民事判决书.txt	不准 原告 何 某某 与 被告 唐某 甲 离婚 。 

何某某与张某某离婚纠纷案一审民事判决书.txt	一 、 何 某某 与 张 某某 离婚 。 二 、 婚生 男孩 张某 甲 （ 生于 2015 年 7 月 30 日 ） 由 何 某某 抚养 ， 由 张 某某 从 2016 年 4 月 起 每月 20 日前 给付 子女 （ 张某 甲 ） 抚养费 400 元 至 子女 （ 张某 甲 ） 18 周岁 止 。 

何某某与曾某甲离婚纠纷一审民事判决书.txt	不 准予 原告 何 某某 与 被告 曾某 甲 离婚 。 

何某某与李某甲离婚纠纷一审民事判决书.txt	准予 原告 何 某某 与 被告 李某 甲 离婚 。 

何某某与李某离婚纠纷一审民事判决书.txt	不予 准许 原告 何 某某 与 被告 李某 离婚 。 

何某某与李甲离婚纠纷一审民事判决书.txt	不准 原告 何 某某 与 被告 李甲 离婚 。 

何某某与王某某离婚纠纷一审民事判决书.txt	准予 原告 何 某某 与 被告 王 某某 离婚 ； 婚 生长 子王某 波 由 原告 何 某某 直接 抚养 ， 婚生 次子 王某耀 由 被告 王 某某 直接 抚养 ， 原告 何 某某 在 本 判决 生效 之日起 十五日 内 一次性 支付 婚生子 之间 年龄 差 抚养费 人民币 5700 元 （ 大写 人民币 伍仟柒佰 圆整 ） ， 以后 双方 互不 给付 子女 抚养费 。 

何某某与董某甲离婚纠纷一审民事判决书.txt	不准 原告 何 某某 与 被告 董某 甲 离婚 。 

何某某与被告魏某某离婚纠纷民事一审判决书.txt	不准 原告 何 某某 与 被告 魏 某某 离婚 。 

何某某与谢某甲离婚纠纷一审民事判决书.txt	一 、 准予 原告 何 某某 与 被告 谢某 甲 离婚 ； 二 、 婚生子 谢某丙 由 被告 谢某 甲 抚养 教育 ， 原告 何 某某 每月 支付 谢某 丙 生活费 500 元 至 谢某丙 的 银行账号 ， 谢某丙 的 教育费 、 医疗费 凭 票据 由 原 、 被告 各 承担 一半 ， 上述 费用 支付 至 谢某 丙 独立 生活 时 止 ， 并 于 每年 12 月 31 日前 结清 当年 费用 。 

何某某与赵某某离婚纠纷一案一审民事判决书.txt	一 、 准予 原告 何 某某 与 被告 赵 某某 离婚 ； 二 、 婚生子 赵某 由 被告 赵 某某 抚养 ， 原告 何 某某 从 2016 年 5 月 起 ， 每月 向 被告 赵 某某 支付 婚生子 的 生活费 300 元 ， 教育费 、 医疗费 凭 实际 发生 的 票据 各自 承担 一半 ， 直至 婚生子 独立 生活 为止 ， 支付 办法 为 每年 12 月 30 日前 结付 当年 费用 。 

何某某与钟某某离婚纠纷一审民事判决书.txt	不 准予 原告 何 某某 与 被告 钟 某某 离婚 。 

何某某与马某某离婚纠纷一审民事判决书.txt	不 准许 原告 何 某某 与 被告 马 某某 离婚 。 

何某某与骆某某离婚纠纷一审民事判决书.txt	准予 原告 何 某某 与 被告 骆 某某 离婚 ； 二 、 儿子 骆某 甲 随 被告 骆 某某 生活 ， 原告 何 某某 由 被告 在 判决 生效 之日起 每月 支付 儿子 生活费 300 元 ， 并 承担 儿子 的 教育费 、 医疗费 （ 凭 正式 票据 ） 的 50 % 至 其子 独立 生活 止 。 

何某某诉丁某某离婚纠纷一审民事判决书.txt	不 准予 原告 何 某某 与 被告 丁 某某 离婚 。 

何某甲与丁某某离婚纠纷一审民事判决书.txt	原告 何某 甲 诉 与 被告 丁 某某 离婚 ， 不予 准许 。 

何某甲与王某甲离婚纠纷一审民事判决书.txt	不准 原告 何某甲 与 被告 王某 甲 离婚 。 

何某甲与罗某甲离婚纠纷一审民事判决书.txt	准予 原告 何某甲 与 被告 罗某 甲 离婚 。 

佘某卫与袁某离婚纠纷一审民事判决书.txt	不 准许 原告 佘某卫 与 被告 袁某 离婚 。 

余某与雍某某离婚纠纷一审民事判决书.txt	不 准许 原告 余某 与 被告 雍 某某 离婚 。 

余某兰与张某斌离婚纠纷一审民事判决书.txt	不 准许 原告 余某兰 与 被告 张某斌 离婚 。 

余某某与夏某甲离婚纠纷一审民事判决书.txt	不 准予 原告 余 某某 与 被告 夏某 甲 离婚 。 

余某某诉向某某离婚纠纷一审民事判决书.txt	不准 原告 余 某某 与 被告 向 某某 离婚 。 

余某某诉晏某甲离婚纠纷一审民事判决书.txt	不 准予 原告 余 某某 与 被告 晏某 甲 离婚 。 

侯某某与刘某某离婚纠纷一审民事判决书.txt	一 、 准予 原告 侯 某某 与 被告 刘 某某 离婚 ； 二 、 婚生子 侯某 丙 （ 生于 2007 年 2 月 13 日 ） 由 原告 侯 某某 抚养 ， 婚生女 侯某 乙 （ 生于 2004 年 8 月 25 日 ） 由 被告 刘 某某 抚养 。 

侯某某与张某某离婚纠纷一审民事判决书.txt	原告 侯 某某 与 被告 张 某某 离婚 。 

侯某某与张某某离婚纠纷案一审民事判决书.txt	侯 某某 与 张 某某 离婚 。 

兰某某与曹某某离婚纠纷民事一审民事判决书.txt	不 准予 原告 兰 某某 与 被告 曹 某某 离婚 。 

兰某某与李某某离婚纠纷一审民事判决书.txt	不 准予 原告 兰 某某 与 被告 李 某某 离婚 。 

兰某某与黄某甲离婚纠纷一审民事判决书.txt	原告 兰某 要求 与 被告 黄某 甲 离婚 ， 本院 不予 准许 。 

兰某某诉何某甲离婚纠纷一审民事判决书.txt	一 、 准予 原告 兰 某某 与 被告 何某 甲 离婚 ； 二 、 婚生女 何某乙 由 原告 兰 某某 抚养 ， 被告 何某 甲 自本 判决 生效 之 月 起 每月 支付 子女 抚养费 700 元 ， 至 何某 乙 独立 生活 时 止 。 

冉某与韩某离婚纠纷一审民事判决书.txt	不准 原告 冉 某某 与 被告 韩 某某 离婚 。 

冯某某与侯某某离婚纠纷一案一审民事判决书.txt	准予 原告 侯 某某 与 被告 冯 某某 离婚 。 

冯某某与张某某离婚纠纷案一审民事判决书.txt	一 、 冯 某某 与 张 某某 离婚 。 二 、 现有 家庭财产 各 持归 各自 所有 

冯某某与曾某某离婚纠纷一审民事判决书.txt	不 准予 原告 冯 某某 与 被告 曾 某某 离婚 。 

冯某某诉陈某某离婚纠纷一案一审民事判决书.txt	不准 原告 冯 某某 与 被告 陈 某某 离婚 。 

冯某甲与曹某某离婚纠纷一审民事判决书.txt	不准 原告 冯某甲 与 被告 曹 某某 离婚 。 

冯某甲诉张某甲离婚纠纷民事判决书.txt	不 准予 原告 冯某甲 与 被告 张某 甲 离婚 。 

凌某某与邱某某离婚纠纷一审民事判决书.txt	准予 原告 凌 某某 与 被告 邱 某某 离婚 。 

刘某与唐某某离婚纠纷一审民事判决书.txt	不 准予 原告 刘某 与 被告 唐 某某 离婚 。 

刘某与尹某离婚纠纷案一审民事判决书.txt	不准 原告 刘某 与 被告 尹某 离婚 。 

刘某与朱某离婚纠纷一审民事判决书.txt	准予 原告 刘某 与 朱某 离婚 。 婚生女 朱某 乙 （  年  月  日 生 ） 由 原告 刘某 抚养 。 

刘某与牟某某离婚纠纷一审民事判决书.txt	不 准予 原告 刘某 与 被告 牟 某某 离婚 。 

刘某与陈某离婚纠纷一审民事判决书.txt	准予 原告 刘某 与 被告 陈某 离婚 。 婚前 财产 ： 原告 刘某 于 本 判决 生效 之日起 十日 内 退还 被告 陈某 的 婚前 存款 12299 元 共同财产 ： 原告 刘某 于 本 判决 生效 之日起 十日 内 支付 被告 陈某 7500 元 。 

刘某某与先某某离婚纠纷一审民事判决书.txt	不 准予 原告 刘 某某 与 被告 先 某某 离婚 。 

刘某某与吴某甲离婚纠纷一审民事判决书.txt	一 、 准予 原告 刘 某某 与 被告 吴某 甲 离婚 ； 二 、 原 、 被告 婚生子 吴某乙 由 被告 吴某 甲 抚养 ， 原告 刘 某某 自 2016 年 4 月 每月 给付 被告 子女 抚养费 400 元 至 婚生子 吴某 乙 年满 18 周岁 止 。 如果 未 按 本 判决 指定 的 期间 给付 金钱 义务 ， 应当 依照 《 中华人民共和国 民事 诉讼法 》 第 二百五十 三条 之 规定 ， 加倍 支付 迟延 履行 期间 的 债务 利息 。 

刘某某与唐某某离婚纠纷一审民事判决书.txt	不 准许 原告 刘 某某 与 被告 唐 某某 离婚 。 

刘某某与夏某甲离婚纠纷一审民事判决书.txt	一 、 准予 原告 刘 某某 与 被告 夏某 甲 离婚 ； 二 、 原 、 被告 婚生子 夏某乙 随 原告 刘 某某 生活 ， 被告 夏某 甲 自 2016 年 5 月 起 每月 支付 夏某 乙 抚养费 300 元 至 夏某 乙 独立 生活 时 止 。 

刘某某与康某离婚纠纷一审民事判决书.txt	不准 原告 刘 某某 与 被告 康某 离婚 。 

刘某某与李某某离婚纠纷一审民事判决书.txt	准予 原告 刘 某某 与 被告 李 某某 离婚 。 

刘某某与李某甲离婚纠纷一审民事判决书.txt	不 准予 原告 刘 某某 与 被告 李某 甲 离婚 。 

刘某某与李某离婚后财产纠纷一审民事判决书.txt	被告 李某 于 本 判决 生效 之日起 十日 内 给付 原告 刘 某某 现金 14000 元 。 如 未 按 判决 指定 的 期间 履行 给付 义务 ， 应当 依照 《 中华人民共和国 民事 诉讼法 》 第 二百五十 三条 之 规定 ， 加倍 支付 迟延 履行 期间 的 债务 利息 。 

刘某某与杜春某某离婚纠纷一审民事裁定书.txt	本案 按 撤诉 处理 。 

刘某某与汤某某离婚纠纷案一审民事判决书.txt	一 、 刘 某某 与 汤 某某 离婚 。 二 、 婚生 女孩 汤某 甲 （ 生于 2015 年 10 月 31 日 ） 由 刘 某某 抚养 ， 由 汤 某某 每月 给付 子女 （ 汤某 甲 ） 抚养费 500 元 ， 此款 2021 年 2 月 起至 子女 （ 汤某 甲 ） 18 周岁 止 。 三 、 夫妻关系 存续 期间 购买 北京牌 轿车 一辆 归 刘 某某 所有 。 四 、 夫妻关系 存续 期间 在 原告 刘 某某 父母 处 借款 48000 元 ， 由 刘 某某 偿还 ， 在 周 某某 处 借款 9100 元 由 汤 某某 偿还 。 汤 某某 偿还 后 折抵 相应 的 子女 抚养 。 五 、 由 刘 某某 返还 给 汤 某某 彩礼 人民币 20000 元 ， 此款 应 折抵 子女 相应 抚养费 。 六 、 以上 四 、 五项 汤 某某 可 折抵 子女 抚养费 从 2016 年 4 月 至 2021 年 1 月 。 

刘某某与沈某某离婚纠纷一审民事判决书.txt	不准 原告 刘 某某 与 被告 沈 某某 离婚 。 

刘某某与熊某某离婚纠纷一案一审民事判决书.txt	不 准予 原告 刘 某某 与 被告 熊 某某 离婚 。 

刘某某与赵某某离婚纠纷一审民事判决书.txt	准予 原告 刘 某某 与 被告 赵 某某 离婚 。 二 、 婚生子 赵 某月 由 原告 刘 某某 抚养 ， 被告 赵 某某 从 2016 年 4 月 起 每月 承担 小孩 抚养费 300 元 ， 并 凭据 承担 其 医疗费 、 教育费 的 50 % ， 至 其 十八周岁 止 。 三 、 原告 陪嫁 的 床 一张 、 高 组合 六门 柜 、 梳妆台 各 一个 、 沙发 、 餐桌 各 一套 及 部分 床上用品 归 原告 所有 。 四 、 驳回 原告 的 其他 诉讼请求 。 本 判决 发生 法律效力 前 双方 不得 另行 结婚 。 

刘某某与阳某离婚纠纷一审民事判决书.txt	一 、 准予 原告 刘 某某 与 被告 阳某 离婚 ； 二 、 婚生子 刘某甲 由 原告 刘 某某 抚养 ， 原告 刘 某某 承担 刘某 甲 的 全部 抚养费 。 

刘某某与阿仲某某离婚纠纷一审民事判决书.txt	一 、 准予 原告 刘某甲 与 被告 阿仲 某某 离婚 ； 二 、 原 、 被告 婚 生长 女 刘某乙 由 原告 抚养 ， 婚生 次女 阿景 某某 由 被告 抚养 ， 抚养费 由 原 、 被告 各自 承担 。 

刘某某与陈某甲离婚纠纷一审民事判决书.txt	不 准予 原告 刘 某某 与 被告 陈某 甲 离婚 。 

刘某某与陈某甲离婚纠纷案一审民事判决书.txt	不 准许 原告 刘 某某 与 被告 陈某 甲 离婚 。 

刘某某与马甲离婚纠纷一案一审民事判决书.txt	不准 原告 刘 某某 与 被告 马甲 离婚 。 

刘某某诉吕某甲离婚纠纷一审民事判决书.txt	不 准予 原告 刘 某某 与 被告 吕某 甲 离婚 。 

刘某某诉干某离婚纠纷案一审民事判决书.txt	不 准予 原告 刘 某某 与 被告 干某 离婚 。 

刘某某诉曾某甲离婚纠纷一审民事判决书.txt	准予 原告 刘 某某 与 被告 曾某 甲 离婚 ； 二 、 孩子 曾某乙 随 原告 刘 某某 生活 ， 被告 曾某 甲 自 2016 年 3 月 起至 孩子 曾某 乙 年满 18 周岁 时 止 每月 月底 前 向 孩子 曾某 乙 支付 生活费 500 元 ； 孩子 曾某乙 的 教育费 和 医疗费 （ 凭据 ） 由 原 、 被告 各 负担 50 % 。 

刘某某诉李某某离婚纠纷一审民事裁定书.txt	准许 原告 刘 某某 撤回 起诉 。 

刘某某诉李某某离婚纠纷一案一审民事判决书.txt	准予 原告 刘 某某 和 被告 李 某某 离婚 。 

刘某某诉查某某离婚纠纷民事一审判决书.txt	不准 原告 刘 某某 与 被告 查 某某 离婚 。 

刘某某诉邓某甲离婚纠纷一审民事判决书.txt	不准 原告 刘 某某 与 被告 邓某 甲 离婚 。 

刘某桃与韦某亭离婚纠纷一审民事判决书.txt	一 、 准许 原告 刘某桃 与 被告 韦某亭 离婚 ； 二 、 婚生子 刘某 由 原告 刘某 桃 直接 抚养 ， 被告 韦某亭 不 承担 小孩 抚养费 。 

刘某甲与刘某乙离婚纠纷一审民事判决书.txt	不 准许 原告 刘某甲 与 被告 刘某 乙 离婚 。 

刘某甲与曹某某离婚纠纷案一审民事判决书.txt	不准 原告 刘某甲 与 被告 曹 某某 离婚 。 

刘某甲与林某某离婚纠纷一审民事判决书.txt	准予 原告 刘某甲 与 被告 林 某某 离婚 ； 婚生女 刘某乙 由 被告 林 某某 抚养 ， 原告 刘某 甲 自本 判决 生效 之日起 每月 向 原告 林 某某 支付 刘某 乙 抚养费 400 元 ； 驳回 原告 刘某 甲 的 其他 诉讼请求 。 

刘某甲与樊某甲离婚纠纷一审民事判决书.txt	准予 原告 刘某甲 与 被告 樊某 甲 离婚 。 

刘某甲与陶某甲离婚纠纷二审民事判决书.txt	一 、 维持原判 第一项 即 " 准予 上诉人 刘某甲 与 被上诉人 陶某 甲 离婚 " ； 二 、 变更 原判 第二项 即 " 原 、 被告 婚生 女儿 刘某 乙 、 刘某丙 随 被告 陶某 甲 生活 ， 陶某 甲 自行 承担 子女 抚养费 " 为 " 上诉人 刘某甲 与 被上诉人 陶某 甲 的 婚 生长 女 刘某甲 由 上诉人 刘某 甲 抚养 ， 由 被上诉人 陶某甲 从 2016 年 4 月 起 每月 给付 其 长女 抚养费 300 元 至 其 长女 独立 生活 为止 ； 婚生 次女 刘某甲 由 被上诉人 陶某 甲 抚养 ， 由 上诉人 刘某甲 从 2016 年 4 月 起 每月 给付 其次 女 抚养费 300 元 至 其次 女 独立 生活 为止 " 。 

刘某甲与魏某某离婚纠纷一审民事判决书.txt	不 准许 原告 刘某甲 与 被告 魏 某某 离婚 。 

刘某甲诉唐某某离婚纠纷一案一审民事判决书.txt	一 、 准予 原告 刘某甲 与 被告 唐 某某 离婚 ； 二 、 夫妻 共同财产 鸣钟 乡 xxx 村 xx 组 的 瓦房 六间 归 被告 唐 某某 所有 ； 三 、 原告 刘某 甲 给付 被告 唐 某某 人民币 2 万元 。 

刘某诉杨某离婚纠纷一案一审民事判决书.txt	不准 原告 刘某 与 被告 杨某 离婚 。 

刘某诉王某某离婚纠纷一审民事判决书.txt	准予 原告 刘某 与 被告 王 某某 离婚 ； 婚生子 刘某 甲 随 原告 刘某 生活 。 

刘正涵与董起赞离婚纠纷一审民事判决书.txt	不准 原告 刘 某某 与 被告 董 某某 离婚 。 

勾某某与曾某某离婚纠纷民事二审判决书.txt	驳回上诉 ， 维持原判 。 

包某甲与张某甲离婚纠纷一案一审民事判决书.txt	一 、 准予 原告 包某甲 与 被告 张某 甲 离婚 。 二 、 婚 生长 子张某 乙 随 原告 包某 甲 共同 生活 ， 由其 自行 抚养 成人 ； 婚 生长 女包 某 乙 随 被告 张某 甲 共同 生活 ， 由其 自行 抚养 成人 。 三 、 夫妻 共同财产 2 间房 由 被告 张某 甲 享有 ； 共同 债权 16000 元 （ 毛 某某 欠款 ） 、 五金 门市 现存 物资 由 原告 包某 甲 享有 。 由 原告 包某甲 在 本 判决 生效 之日起 15 日 内 补偿 被告 张某 甲 人民币 23000 元 （ 款 交 本院 民庭 转付 ） 。 四 、 驳回 原告 包某 甲 的 其他 诉讼请求 。 

匡光荣与张书珍离婚纠纷一审民事判决书.txt	本院 不予 准许 原告 匡 光荣 与 被告 张书珍 离婚 。 

卓某甲与许某甲离婚纠纷一审民事判决书.txt	不予 准许 原告 卓某甲 与 被告 许某 甲 离婚 。 

卢某某与赵某某离婚纠纷一审民事判决书.txt	准予 原告 卢 某某 与 被告 赵 某某 离婚 。 

卢某某与马某甲离婚纠纷一审民事判决书.txt	原告 卢 某某 诉 与 被告 马某 甲 离婚 ， 不予 准许 。 

卢某甲与付某某离婚纠纷一审民事判决书.txt	不准 原告 卢某甲 与 被告 付 某某 离婚 。 

原告任某与被告杨某离婚纠纷一案一审民事裁定书.txt	一 、 准予 原告 任某 与 被告 杨某 离婚 ； 二 、 原 、 被告 之 婚生 女 某某 由 原告 抚养 ， 抚养费 由 原告 承担 至 其 独立 生活 时 止 ； 三 、 夫妻 共同 债务 欠 绵竹市 农村 信用联社 贷款 10000 元 本金 及 利息 由 原告 负责 偿还 ； 四 、 驳回 原告 其他 诉讼请求 。 

原告任某某诉被告张某某离婚纠纷一案一审民事判决书.txt	不准 原告 任 某某 与 被告 张 某某 离婚 。 

原告伍文容诉被告张兵离婚纠纷一案一审民事判决书.txt	一 、 准许 原告 伍 某某 与 被告 张某 离婚 ； 二 、 原 、 被告 夫妻 共同财产 （ 即 ： 位于 青神县 西 龙镇 某村 的 2.6 亩 鱼塘 22 年 的 承包 经营权 及 小青瓦 房 5 间 ） ， 由 被告 张某 分得 ； 三 、 原 、 被告 夫妻 共同 债务 ： 欠 鲁 某某 饲料 款 1070 元 ， 由 原告 伍 某某 承担 清偿 责任 ； 欠易 某某 鱼药 及 鱼饲料 款 1600 元 ， 由 被告 张某 承担 清偿 责任 。 

原告何某某与被告杨某某离婚纠纷一案民事判决书.txt	一 、 准予 原告 何 某某 与 被告 杨 某某 离婚 ； 二 、 被告 杨 某某 的 婚前 个人财产 床 一张 、 立柜 一个 、 抽屉 一张 、 电视柜 一个 、 桌子 一张 归 被告 杨 某某 所有 ； 三 、 原告 何 某某 于 本 判决 生效 后 十五日 内 给付 被告 杨 某某 经济 帮助 费 5000 元 。 

原告何某某与被告赵某某离婚纠纷一案一审民事判决书.txt	一 、 准予 原告 何 某某 与 被告 赵 某某 离婚 ； 二 、 婚生女 赵某 甲 随 原告 何 某某 生活 ， 被告 赵 某某 从 2016 年 3 月 1 日 起 每月 向 原告 何 某某 支付 小孩 生活费 500 元 ， 赵某 甲 的 教育费 和 医疗费 据实 凭据 由 原 、 被告 各 承担 一半 ， 直至 赵某 甲 年满 十八周岁 止 。 如果 未 按 本 判决 指定 的 期间 履行 金钱 给付 义务 ， 应当 依照 《 中华人民共和国 民事 诉讼法 》 第 二百五十 三条 的 规定 ， 加倍 支付 迟延 履行 期间 的 债务 利息 。 

原告何某某诉被告吴某离婚纠纷案民事判决书.txt	不 准予 原告 何 某某 与 被告 吴某 离婚 。 

原告何某某诉被告王某某离婚纠纷一案一审民事判决书.txt	不准 原告 何 某某 与 被告 王 某某 离婚 。 

原告何某某诉被告郑某某离婚纠纷一审民事判决书.txt	一 、 准予 原告 何 某某 与 被告 郑 某某 离婚 ； 二 、 婚生女 郑某乙 由 原告 何 某某 抚养 ， 由 被告 郑 某某 每月 15 日前 支付 当月 抚养费 300 元 至 郑某 乙 18 周岁 止 ； 三 、 婚生子 郑某丙 由 被告 郑 某某 抚养 ， 由 原告 何 某某 每月 15 日前 支付 当月 抚养费 300 元 至 郑某 丙 18 周岁 止 。 

原告何某某诉被告黄某某为离婚纠纷一案一审民事判决书.txt	不准 原告 何 某某 与 被告 黄 某某 离婚 。 

原告何某诉被告邬某某离婚纠纷一审民事判决书.txt	一 、 准予 原告 何某 与 被告 邬 某某 离婚 ； 二 、 婚生女 邬某甲 由 被告 邬 某某 抚养 ， 并 由其 自行 承担 子女 抚养费 ； 三 、 由 被告 邬 某某 在 本 判决 生效 后 五日 内 一次性 支付 原告 何某 经济 帮助 费 2000 元 。 

原告余某某诉被告李某某离婚纠纷一审民事判决书.txt	一 、 准许 原告 余 某某 与 被告 李 某某 离婚 ； 二 、 婚生女 李某 由 原告 余 某某 抚养 并 承担 孩子 的 抚养费 。 三 、 驳回 原告 余 某某 的 其他 诉讼请求 。 

原告冯某某诉被告付某某离婚纠纷一案一审民事判决书.txt	一 、 准予 原告 冯 某某 与 被告 付 某某 离婚 。 二 、 婚 生长 女付 某 由 被告 付 某某 抚养 ， 婚生 次女 付某甲 由 原告 冯 某某 抚养 。 在 本 判决 生效 前 ， 原 、 被告 不得 另行 结婚 。 

原告冯某某诉被告杨某某离婚纠纷一案一审民事判决书.txt	不 准予 原告 冯 某某 与 被告 杨 某某 离婚 。 

原告刘俊芬诉被告张斗亮离婚纠纷一审民事判决书.txt	不准 刘 某某 与 张 某某 离婚 。 

原告刘某与被告巫某某离婚纠纷一审民事裁定书.txt	原告 刘 某某 与 被告 巫 某某 离婚 纠纷 一案 ， 按 撤诉 处理 。 

原告刘某某与被告张某某婚姻无效纠纷一案的民事判决书.txt	原告 刘 某某 与 被告 张 某某 的 婚姻 无效 。 

原告刘某某与被告王某某离婚纠纷一案民事裁定书.txt	本案 按 撤诉 处理 。 

原告刘某某诉被告张某离婚纠纷一案的民事判决书.txt	不准 原告 刘 某某 与 被告 张某 离婚 。 

原告刘某某诉被告袁某某离婚纠纷一案民事判决书.txt	准予 原告 刘 某某 与 被告 袁 某某 离婚 。 

原告刘某某诉被告谭某某离婚纠纷案一审民事判决书.txt	一 、 准予 原告 刘 某某 与 被告 谭 某某 离婚 。 二 、 婚生女 随 原告 刘 某某 生活 ， 婚生子 随 被告 谭 某某 生活 ， 双方 互不 给付 子女 抚养费 。 

原告刘某某诉被告赵某某离婚纠纷一案一审民事判决书.txt	准予 原告 刘 某某 与 被告 赵 某某 离婚 。 

原告刘某诉被告张某某离婚纠纷一案一审民事判决书.txt	准许 原告 刘某 与 被告 张 某某 离婚 ； 二 、 登记 在 原告 刘某 与 被告 张 某某 名下 的 位于 成都市 武侯区 洗面 桥 街 18 号 1 栋 2 单元 23 楼 13 号 房屋 （ 建筑面积 ： 44.51 平方米 ， 权 1407644 ） 归 原告 刘某 所有 ， 被告 张 某某 于 本 判决 生效 之日起 三十日 内 配合 原告 刘某 过理 上述 房屋 的 过户 手续 ； 三 、 登记 在 原告 刘某 与 被告 张 某某 名下 的 位于 成都市 武侯区 洗面 桥 街 18 号 1 栋 2 单元 23 楼 14 号 房屋 （ 建筑面积 ： 63.43 平方米 ， 权 1407641 ） 归 原告 刘某 所有 ， 被告 张 某某 于 本 判决 生效 之日起 三十日 内 配合 原告 刘某 过理 上述 房屋 的 过户 手续 ； 四 、 登记 在 原告 刘某 与 被告 张 某某 名下 的 位于 成都市 武侯区 洗面 桥 街 18 号 1 栋 2 单元 23 楼 15 号 房屋 （ 建筑面积 ： 31.06 平方米 ， 权 1407643 ） 归 原告 刘某 所有 ， 被告 张 某某 于 本 判决 生效 之日起 三十日 内 配合 原告 刘某 过理 上述 房屋 的 过户 手续 ； 五 、 登记 在 原告 刘某 与 被告 张 某某 名下 的 位于 成都市 武侯区 洗面 桥 街 18 号 1 栋 2 单元 23 楼 16 号 房屋 （ 建筑面积 ： 44.18 平方米 ， 权 1407642 ） 归 原告 刘某 所有 ， 被告 张 某某 于 本 判决 生效 之日起 三十日 内 配合 原告 刘某 过理 上述 房屋 的 过户 手续 ； 六 、 登记 在 原告 刘某 与 被告 张 某某 名下 的 位于 成都市 武侯区 黉 门 后 街 2 号 1 单元 14 层 5 号 房屋 （ 建筑面积 ： 122.71 平方米 ， 权 2225593 ） 归 原告 刘某 所有 ， 被告 张 某某 于 本 判决 生效 之日起 三十日 内 配合 原告 刘某 过理 上述 房屋 的 过户 手续 ； 七 、 登记 在 原告 刘某 与 被告 张 某某 名下 的 位于 高新区 天府 大道 中段 177 号 13 栋 1 单元 20 层 3 号 房屋 （ 建筑面积 ： 304.74 平方米 ， 权 2225603 ） 归 被告 张 某某 所有 ， 原告 刘某 于 本 判决 生效 之日起 三十日 内 配合 被告 张 某某 过理 上述 房屋 的 过户 手续 ； 八 、 登记 在 原告 刘某 与 被告 张 某某 名下 的 成都市 高新区 天府 大道 中段 177 号 1 栋 - 1 层 13060 号 车位 （ 建筑面积 ： 28.22 平方米 ， 权 2225611 ） 归 被告 张 某某 所有 ， 原告 刘某 于 本 判决 生效 之日起 三十日 内 配合 被告 张 某某 过理 上述 房屋 的 过户 手续 ； 九 、 登记 在 原告 刘某 与 被告 张 某某 名下 的 成都市 高新区 天府 大道 中段 177 号 1 栋 - 1 层 13061 号 车位 （ 建筑面积 ： 28.22 平方米 ， 权 2225618 ） 归 被告 张 某某 所有 ， 原告 刘某 于 本 判决 生效 之日起 三十日 内 配合 被告 张 某某 过理 上述 房屋 的 过户 手续 ； 十 、 原告 刘某 于 判决 生效 之日起 十五日 内 支付 被告 张 某某 房产 与 车位 分割 折 价款 151000 元 。 

原告刘桂华诉被告曾义财离婚纠纷一案民事判决书.txt	不准 原告 刘桂华 与 被告 曾义 财 离婚 。 

原告华某诉被告彭某某离婚纠纷案一审判决书.txt	不 准予 原告 华某 与 被告 彭 某某 离婚 。 

原告卢某某与被告江某某离婚纠纷一案民事判决书.txt	一 、 准予 原告 卢 某某 与 被告 江 某某 离婚 ； 二 、 驳回 原卢 某某 本案 其他 诉讼请求 。 

原告卢某某诉被告何某某“离婚纠纷”一案民事判决书.txt	不准 原告 卢 某某 和 被告 何 某某 离婚 。 

原告向某某诉被告税某甲离婚纠纷一审民事判决书.txt	不准 原告 向 某某 与 被告 税 某 甲 离婚 。 

原告吴某某与被告向某甲离婚纠纷一审民事判决书.txt	原告 吴 某某 与 被告 向 某 甲 离婚 。 

原告吴某某与被告魏某某离婚纠纷一案的民事判决书.txt	不准 原告 吴 某某 与 被告 魏 某某 离婚 。 

原告吴腾英与被告岳瑞亭离婚纠纷一案民事判决书.txt	一 、 准予 原告 吴某 与 被告 岳某 离婚 。 二 、 驳回 原告 吴某 要求 被告 岳某 支付 困难 帮助 费 的 诉讼请求 。 

原告周某某与被告于某某离婚纠纷一案民事判决书.txt	一 、 准予 原告 周 某某 与 被告 于 某某 离婚 ； 二 、 婚生女 于 某 乙 随 被告 于 某某 生活 ， 原告 周 某某 从 2016 年 起 至于 某 乙 独立 生活 时 止 每年 支付 子女 抚养费 4000 元 （ 支付 方式 ： 每年 12 月 31 日前 支付 当年 子女 抚养费 ） ； 三 、 驳回 原告 周 某某 本案 其他 诉讼请求 。 

原告周某某与被告刘某某离婚纠纷一审民事判决书.txt	准予 原告 周 某某 和 被告 刘 某某 离婚 。 

原告周某某与被告张某某离婚纠纷案一审民事判决书.txt	不 准予 原告 周 某某 与 被告 张 某某 离婚 。 

原告周某某与被告魏某某离婚纠纷一案的民事判决书.txt	不准 原告 周 某某 与 被告 魏 某某 离婚 。 

原告周某某与黄某甲离婚纠纷一审民事判决书.txt	不准 原告 周 某某 与 被告 黄某 甲 离婚 ； 驳回 原告 周 某某 的 其他 诉讼请求 。 

原告唐某某与被告张某甲离婚纠纷案一审民事判决书.txt	不 准予 原告 唐 某某 与 被告 张某 甲 离婚 。 

原告唐某某诉被告张某某为离婚纠纷一案一审民事判决书.txt	不准 原告 唐 某某 与 被告 张 某某 离婚 。 

原告唐某某诉被告王某某离婚纠纷一案一审民事判决书.txt	一 、 准予 原告 唐 某某 与 被告 王 某某 离婚 ； 二 、 原告 唐 某某 在 本 判决 生效 之日起 十日 内 一次性 支付 被告 王 某某 离婚 损害 赔偿金 45000 元 ； 三 、 原告 唐 某某 在 本 判决 生效 之日起 十日 内 一次性 支付 被告 王 某某 经济 帮助 费 35000 元 。 

原告喻某某诉被告李某某为离婚纠纷一案一审民事判决书.txt	不准 原告 喻 某某 与 被告 李 某某 离婚 。 

原告夏某某诉被告陈某离婚纠纷案一审民事判决书.txt	不准 原告 夏 某某 与 被告 陈某 离婚 。 

原告姚某某诉被告刘某某离婚纠纷一案民事判决书.txt	一 、 准予 原告 姚 某某 与 被告 刘 某某 离婚 ； 二 、 原告 姚 某某 于 本 判决 生效 后 三日 内 支付 被告 刘 某某 3000 元 。 如果 未 按 本 判决 指定 的 期间 履行 给付 金钱 的 义务 ， 应当 依照 《 中华人民共和国 民事 诉讼法 》 第 二百五十 三条 之 规定 ， 加倍 支付 迟延 履行 期间 的 债务 利息 。 

原告姜某某诉被告赵某某为离婚纠纷一案一审民事判决书.txt	不准 原告 姜 某某 与 被告 赵 某某 离婚 。 

原告孔某某与被告顾某某离婚纠纷民事一审判决书.txt	不 准予 原告 孔 某某 与 被告 顾 某某 离婚 。 

原告孙某某诉被告徐某某离婚纠纷民事判决书.txt	不 准予 原告 孙 某某 与 被告 徐 某某 离婚 。 

原告孙某诉被告邱某离婚纠纷一案一审民事判决书.txt	一 、 准予 原告 孙某 与 被告 邱某 离婚 。 二 、 夫妻 共同 债务 欠 绵竹市 农村信用 合作 联社 遵道 分社 贷款 本金 20000 元 及 利息 由 原 、 被告 各 负担 一半 。 

原告宋某某与被告吴某某离婚纠纷一审民事判决书.txt	不 准予 原告 宋 某某 与 被告 吴 某某 离婚 。 

原告崔某某与被告肖某某离婚纠纷一案的民事判决书.txt	不准 原告 崔 某某 与 被告 肖 某某 离婚 。 

原告张XX诉被告陈XX离婚纠纷一案一审民事判决书.txt	一 、 准予 原告 张  与 被告 陈  离婚 ； 二 、 由 原告 张  一次性 给付 被告 陈  经济 帮助 费 6000 元 （ 此款 已经 当庭 兑现 ） 。 

原告张某与被告李某某离婚纠纷民事一审裁定书.txt	本案 按 撤诉 处理 。 

原告张某某与被告万某离婚纠纷一审民事判决书.txt	一 、 准予 原告 张 某某 与 被告 万某 离婚 。 二 、 婚生女 万某 甲 随 被告 万某 生活 ， 由万某 承担 抚养 、 教育 义务 。 原告 张 某某 享有 探望 婚生女 万某 甲 的 权利 ， 但 在 探望 时 不得 影响 其 正常 学习 、 生活 。 

原告张某某与被告方某某“离婚纠纷”一案民事判决书.txt	一 、 原告 张 某某 与 被告方 某某 离婚 。 二 、 婚生女 张某 甲 随 原告 张 某某 生活 ， 原告 张 某某 自愿 放弃 被告方 某某 应 支付 张某 甲 的 抚养费 。 三 、 被告方 某某 对 婚生女 张某 甲 享有 探望 权 。 

原告张某某与被告曾某甲离婚纠纷一审民事判决书.txt	准予 原告 张 某某 和 被告 曾某 甲 离婚 。 

原告张某某与被告王某甲离婚纠纷一案一审民事判决书.txt	一 、 准予 原告 张 某某 与 被告 王某 甲 离婚 。 二 、 离婚 后 ， 原 、 被告 之 婚生子 王某乙 由 被告 王某 甲 抚养 成年 。 原告 张 某某 从 2016 年 3 月 起 每月 支付 其 婚生子 王某 乙 抚养费 751 元 至 其 成年 时 止 。 原告 张 某某 有 探望 其 婚生子 的 权利 ， 被告 王某 甲 负有 协助 的 义务 。 

原告张某某与被告缪某某离婚纠纷一案民事判决书.txt	不准 原告 张 某某 与 被告 缪 某某 离婚 。 

原告张某某与被告聂某某“离婚纠纷”一案民事判决书.txt	准予 原告 张 某某 与 被告 聂 某某 离婚 。 

原告张某某诉肖某某离婚纠纷案一审民事判决书.txt	不 准予 原告 张 某某 与 被告 肖 某某 离婚 。 

原告张某某诉被告代某甲离婚纠纷案一审民事判决书.txt	不准 原告 张 某某 与 被告 代某 甲 离婚 。 

原告张某某诉被告刘某甲离婚纠纷一案一审民事判决书.txt	一 、 准予 原告 张 某某 与 被告 刘某 甲 离婚 ； 二 、 婚生女 刘某乙 随 原告 张 某某 共同 生活 ， 被告 刘某 甲 自 2016 年 4 月 起 每月 给付 婚生女 刘某 乙 生活费 400 元 至 其 独立 生活 时 止 ， 婚生 女 今后 的 医疗费 、 教育费 凭据 由 原 、 被告 各 承担 一半 ； 三 、 被告 刘某 甲 有 探望 婚生女 刘某乙 的 权利 ， 原告 张 某某 有 协助 的 义务 。 

原告张某某诉被告曹某离婚纠纷一审民事判决书.txt	一 、 准予 原告 张 某某 与 被告 曹某 离婚 ； 二 、 原告 张 某某 抚养 婚生女 曹甲 ， 被告 曹某 抚养 婚生子 曹乙 ， 原告 张 某某 在 本 判决 生效 后 十日 内 一次性 支付 被告 曹某 孩子 抚养费 差 10800 元 ； 三 、 驳回 原告 张 某某 的 其他 诉讼请求 。 如 未 按 本 判决 指定 的 期限 履行 给付 金钱 义务 ， 应当 按照 《 中华人民共和国 民事 诉讼法 》 第 二百五十 三条 之 规定 ， 加倍 支付 延迟 履行 期间 的 利息 。 

原告张某某诉被告李某某离婚纠纷一审民事判决书.txt	不准 原告 张 某某 与 被告 李 某某 离婚 。 

原告张某某诉被告李某某离婚纠纷案民事判决书.txt	不 准予 原告 张 某某 与 被告 李 某某 离婚 。 

原告张某某诉被告滕某某“离婚纠纷”一案民事判决书.txt	一 、 原告 张 某某 与 被告 滕 某某 离婚 。 二 、 婚生子 张某乙 由 原告 张 某某 抚养 ， 婚生女 张某甲 由 被告 滕 某某 抚养 互不 给付 抚养费 。 三 、 双方 对 对方 抚养 的 子女 享有 探望 权 。 四 、 原告 张 某某 于 本 判决 生效 后 10 日 内 给付 被告 滕 某某 生活 帮助 费 5000 元 。 

原告张某某诉被告王甲离婚纠纷一审民事判决书.txt	不 准予 原告 张 某某 与 被告 王甲 离婚 。 

原告张某某诉被告赵某某离婚纠纷一案一审民事判决书.txt	不 准予 原告 张 某某 与 被告 赵 某某 离婚 。 

原告张某甲与被告张某乙离婚纠纷撤诉民事裁定书.txt	准许 原告 张某 甲 撤回 对 被告 张某乙 的 起诉 。 

原告张某甲与被告程某甲离婚纠纷一案一审民事判决书.txt	不准 原告 张某甲 与 被告 程某 甲 离婚 。 

原告彭某与被告严某离婚纠纷一案的民事判决书.txt	一 、 准许 原告 彭某 与 被告 严某 离婚 。 二 、 婚生女 彭 某某 由 原告 彭某 抚养 成年 ， 并 自行 承担 抚养费 。 被告 严某 对 子女 享有 探望 权 ， 原告 彭某 有 协助 的 义务 。 三 、 驳回 原告 彭某 的 其他 诉讼请求 。 

原告彭某某诉被告金某某离婚纠纷案一审判决书.txt	不 准许 原告 彭 某某 与 被告 金 某某 离婚 。 

原告彭某诉被告晏某离婚纠纷一案一审判决书.txt	不准 原告 彭某 与 被告 晏某 离婚 。 

原告彭某诉被告马某某离婚纠纷一案的民事判决书.txt	一 、 准予 原告 彭某 与 被告 马 某某 离婚 ； 二 、 婚生子 彭乙 由 原告 彭某 抚养 成年 ， 并 承担 抚养费 。 被告 马 某某 有 探望 婚生子 彭乙 的 权利 ， 原告 彭某 有 协助 的 义务 。 

原告徐某某与被告张某某离婚纠纷一审民事判决书.txt	不准 原告 徐 某某 与 被告 张 某某 离婚 。 

原告徐某某与被告王某某离婚纠纷一案民事判决书.txt	不准 原告 徐 某某 与 被告 王 某某 离婚 。 

原告徐某某与被告邵某某离婚纠纷一审民事判决书.txt	不 准予 原告 徐 某某 与 被告 邵 某某 离婚 。 

原告徐某某诉被告张某某离婚纠纷一审民事判决书.txt	一 、 准予 原告 徐 某某 与 被告 张 某某 离婚 ； 二 、 婚生女 张某 甲 、 婚生子 张某乙 由 被告 张 某某 抚养 ， 并 由其 自行 承担 子女 抚养费 。 

原告文某诉被告郑某某离婚纠纷一审民事判决书.txt	不准 原告 文某 与 被告 郑 某某 离婚 。 

原告曾强与被告蒋青容离婚后财产纠纷一案民事判决书.txt	由 被告 蒋 某某 在 本 判决 生效 后 十日 内 支付 原告 曾某 欠款 20000 元 。 如果 未 按 本 判决 指定 的 期间 履行 给付 金钱 义务 ， 应当 依照 《 中华人民共和国 民事 诉讼法 》 第 二百五十 三条 之 规定 ， 加倍 支付 迟延 履行 期间 的 债务 利息 。 

原告曾某某诉被告龙某某离婚纠纷案一审民事判决书.txt	不 准予 原告 曾 某某 与 被告 龙 某某 离婚 。 

原告曾某甲诉被告王某某离婚纠纷一案一审民事判决书.txt	不 准予 原告 曾某甲 与 被告 王 某某 离婚 ； 

原告曾某诉被告陈某离婚纠纷一审判决书.txt	不 准予 曾某 与 陈某 离婚 。 

原告朱某与被告张某离婚纠纷一案的民事判决书.txt	不准 原告 朱某 与 被告 张某 离婚 。 

原告朱某某诉被告勾某某离婚纠纷一审民事判决书.txt	准予 原告 朱 某某 与 被告 勾 某某 离婚 。 二 、 婚生子 勾某 甲 跟随 原告 朱 某某 共同 生活 ， 被告 勾 某某 每月 支付 勾某 甲 生活费 600 元 。 勾某 甲 的 教育费 、 医疗费 凭票 由 原 、 被告 各 承担 一半 。 上述 费用 从 本 判决 生效 之日起 支付 至 勾某 甲 独立 生活 时 止 。 

原告李世勇与被告陶凤娟离婚纠纷一案一审裁定书.txt	本案 按 撤诉 处理 。 

原告李伟诉被告黄小英离婚纠纷一案一审民事判决书.txt	一 、 准予 原告 李某 与 被告 黄 某某 离婚 ； 二 、 在 本 判决 生效 之日起 ， 原 、 被告 夫妻 共同财产 门市 即 由 原告 李某 与 被告 黄 某某 按 份 共有 ， 其中 ： 由 原告 李某 享有 该 门市 55 % 的 份额 ， 由 被告 黄 某某 享有 该 门市 45 % 的 份额 。 

原告李某与被告徐某离婚纠纷民事一审判决书.txt	一 、 准予 原告 李某 与 被告 徐某 离婚 ； 二 、 婚生子 徐某 甲 随 被告 徐某 生活 并 由其 抚养 ； 三 、 驳回 原告 李某 的 其他 诉讼请求 。 

原告李某某与被告周某离婚纠纷一案一审民事判决书.txt	准予 原告 李 某某 与 被告 周某 离婚 。 

原告李某某与被告孙某某甲离婚纠纷一案一审民事判决书.txt	不准 原告 李 某某 与 被告 孙某 甲 离婚 。 

原告李某某与被告梁某某离婚纠纷一案民事判决书.txt	一 、 准予 原告 李 某某 与 被告 梁 某某 离婚 ； 二 、 由 被告 梁 某某 于 本 判决 生效 后 十五日 内 给付 原告 李 某某 夫妻 共同财产 分割 款 61977.20 元 ； 三 、 位于 江安县 留 耕镇 农贸 新区 的 房屋 （ 其 房屋 所有权证 号 为 ： 江安 字 第 201003298 号 ） 归 原告 李 某某 所有 ； 四 、 驳回 原告 李 某某 的 其他 诉讼请求 。 

原告李某某与被告蒋某某离婚纠纷一案民事判决书.txt	准予 原告 李 某某 与 被告 蒋 某某 离婚 ； 

原告李某某与被告陈某离婚纠纷一案一审民事判决书.txt	一 、 准予 原告 李 某某 与 被告 陈某 离婚 ； 二 、 婚 生之子 李某 甲 随 原告 李 某某 生活 ， 被告 陈某 从 2016 年 5 月 起 每月 向 原告 李 某某 支付 李某 甲 生活费 500 元 ， 至 李某 甲 18 周岁 止 ， 李某 甲 的 教育费 、 医疗费 凭 票据 由 原 、 被告 各 负担 一半 ， 每年 12 月 31 日前 付清 当年 的 费用 ； 三 、 共同 债务 ： 南部县 某乡 信用社 贷款 30000 元 及 利息 ， 由 原 、 被告 各 承担 一半 ， 原 、 被告 对 该 债务 负 连带 清偿 责任 ； 如 未 按 本 判决 指定 的 期间 履行 给付 金钱 义务 的 ， 应 按照 《 中华人民共和国 民事 诉讼法 》 第 二百五十 三条 之 规定 ， 加倍 支付 迟延 履行 期间 的 债务 利息 。 

原告李某某与被告魏某某离婚纠纷一案一审民事判决书.txt	一 、 准予 原告 李 某某 与 被告 魏 某某 离婚 ； 二 、 被告 魏 某某 给付 原告 李 某某 经济 补偿款 10000 元 ， 此款 在 本 判决 发生 法律效力 后 三日 内 给付 。 如 未 按 本 判决 指定 的 期间 履行 给付 金钱 义务 ， 按照 《 中华人民共和国 民事 诉讼法 》 第 二百五十 三条 的 规定 ， 加倍 支付 迟延 履行 期间 的 债务 利息 。 

原告李某某与被告龙某某离婚纠纷一审民事裁定书.txt	原告 李 某某 与 被告 龙 某某 离婚 纠纷 一案 ， 按 撤诉 处理 。 

原告李某某诉被告张某某离婚纠纷案一审判决书.txt	不 准予 原告 李 某某 与 被告 张 某某 离婚 。 

原告李某某诉被告杨某某离婚纠纷一案一审民事判决书.txt	不准 原告 李 某某 与 被告 杨 某某 离婚 。 

原告李某某诉被告罗某某离婚纠纷一案一审民事判决书.txt	不 准予 原告 李 某某 与 被告 罗 某某 离婚 。 

原告李某某诉被告高某甲离婚纠纷一案一审民事判决书.txt	不 准予 原告 李 某某 与 被告 高某 甲 离婚 。 

原告李某某诉陈某某离婚纠纷一案一审民事判决书.txt	不准 原告 李 某某 与 被告 陈 某某 离婚 。 

原告李某诉被告李某某“离婚纠纷”一案民事判决书.txt	一 、 原告 李某 与 被告 李 某某 离婚 。 二 、 婚生子 李某甲 由 被告 李 某某 抚养 ， 原告 李某 自 2016 年 3 月 起 每月 支付 小孩 抚养费 300 元 至 其 18 周岁 时 止 ， 抚养费 的 给付 方式 ， 每年 的 6 月底 前 、 12 月底 前 结清 前期 的 费用 ， 并 对 小孩 因 教育 、 疾病 产生 的 费用 凭 票据 实 平均 承担 。 原告 李某 对 其子 李某 甲 享有 探望 权 。 

原告李某诉被告詹某甲离婚纠纷一案一审判决书.txt	一 、 准予 原告 李某 与 被告 詹某 甲 离婚 离婚 ； 二 、 婚生子 詹某乙 随 被告 詹某 甲 生活 ， 原告 李某 自 2016 年 5 月 起 每月 25 日前 支付 被告 詹某甲 詹某乙 的 生活费 300.00 元 ， 詹某乙 的 教育 和 医疗费 凭据 原 、 被告 各 承担 50 % ， 前述 三项 费用 由 原告 李某 支付 至 詹某 乙 独立 生活 止 ； 三 、 夫妻 共同财产 中川 CRX 号 车 归 被告 詹某 甲 所有 ， 被告 詹某甲 于 本 判决 生效 之日起 五日 内向 原告 李某 支付 车辆 补差 款 1.75 万元 。 如 未 按 本 判决 指定 的 期间 履行 给付 金钱 义务 ， 应当 依照 《 中华人民共和国 民事 诉讼法 》 第 二百五十 三条 之 规定 ， 加倍 支付 迟延 履行 期间 的 债务 利息 。 

原告杜某某与被告汪某某离婚纠纷一案一审民事判决书.txt	一 、 准予 原告 杜 某某 与 被告 汪 某某 离婚 ； 二 、 婚生女 汪某 甲 、 婚生子 汪某乙 随 被告 汪 某某 生活 ， 原告 杜 某某 从 2016 年 4 月 起 至 其 女 、 其子 分别 年满 18 周岁 时 止 每月 按照 每 子女 各 300 元 的 标准 向 被告 汪 某某 支付 子女 抚养费 ； 三 、 驳回 原告 杜 某某 的 其他 诉讼请求 。 如果 未 按 本 判决 指定 的 期间 履行 给付 金钱 义务 ， 应当 依照 《 中华人民共和国 民事 诉讼法 》 第 二百五十 三条 的 规定 ， 加倍 支付 迟延 履行 期间 的 债务 利息 。 

原告杜某某与被告蒲某某离婚纠纷一案一审民事判决书.txt	准许 原告 杜 某某 与 被告 蒲 某某 离婚 。 

原告杜某某诉被告朱某甲离婚纠纷一审民事判决书.txt	不 准许 原告 杜 某某 与 被告 朱某 甲 离婚 。 

原告杨子让诉被告饶建华离婚纠纷一案民事判决书.txt	准予 原告 杨 某某 与 被 告饶 某某 离婚 。 

原告杨某某诉被告张某某离婚纠纷一审民事判决书.txt	不 准予 原告 杨 某某 与 被告 张 某某 离婚 。 

原告杨某某诉被告曾某某离婚纠纷一案一审判决书.txt	不准 原告 杨 某某 与 被告 曾 某某 离婚 。 

原告杨某某诉被告赵某某离婚纠纷一案一审民事判决书.txt	一 、 准予 原告 杨 某某 与 被告 赵 某某 离婚 ； 二 、 驳回 原告 杨 某某 的 其它 诉讼请求 。 

原告杨某某诉被告马某某“离婚纠纷”一案民事判决书.txt	不准 原告 杨 某某 与 被告 马 某某 离婚 。 

原告杨某某诉被告高某某离婚纠纷一案一审民事判决书.txt	原告 杨 某某 请求 与 被告 高 某某 离婚 ， 不 准予 离婚 。 

原告杨某甲与被告马某甲离婚纠纷一案一审民事判决书.txt	不准 原告 杨某甲 与 被告 马某 甲 离婚 。 

原告林某甲诉被告李某甲离婚纠纷一案一审民事判决书.txt	准予 原告 林某甲 与 被告 李某 甲 离婚 。 

原告查某某诉被告包某甲离婚纠纷一审民事判决书.txt	一 、 准予 原告 查 某某 与 被告 包某 甲 离婚 。 二 、 长女 包某 乙 （ 生于 2007 年 7 月 20 日 ） 、 次女 包某 丙 （ 生于 2010 年 1 月 17 日 ） 随 原告 查 某某 生活 ， 由 被告 包某甲 按 月 支付 两个 子女 抚养费 各 500 元 至 其 年满 十八周岁 时 止 。 

原告梁某某诉被告张某甲离婚纠纷案一审民事判决书.txt	不准 原告 梁 某某 与 被告 张某 甲 离婚 。 

原告段某甲诉被告李某甲离婚纠纷一案一审民事判决书.txt	准予 原告 段某甲 与 被告 李某 甲 离婚 。 

原告汪某某诉被告何某某为离婚纠纷一案一审民事判决书.txt	不准 原告 汪 某某 与 被告 何 某某 离婚 。 

原告汪某某诉被告曾某某离婚纠纷一案一审民事判决书.txt	不准 原告 汪 某某 与 被告 曾 某某 离婚 。 

原告沈某某与被告王某某甲离婚纠纷一案一审民事判决书.txt	不准 原告 沈 某某 与 被告 王 某某 甲 离婚 。 

原告沈某诉被告范某某离婚纠纷一审民事判决书.txt	不准 原告 沈某 与 被告 范 某某 离婚 。 

原告泉某某与被告李某某离婚纠纷一案一审民事判决书.txt	不准 原告 泉 某某 与 被告 李 某某 离婚 。 

原告熊某某与被告曾某某离婚纠纷一案民事判决书.txt	准予 原告 熊 某某 与 被告 曾 某某 离婚 ； 

原告熊某某诉被告何某某离婚纠纷一审民事判决书.txt	一 、 准予 原告 熊 某某 与 被告 何 某某 离婚 。 二 、 原告 熊 某某 一次性 支付 被告 何 某某 经济 帮助 费 1000 元 ， 限 2016 年 5 月 21 日前 支付 。 

原告熊某某诉被告唐某甲离婚纠纷一案一审民事判决书.txt	一 、 准予 原告 熊 某某 与 被告 唐某 甲 离婚 ； 二 、 原 、 被告 的 婚生子 唐某 乙 跟随 原告 熊 某某 生活 。 

原告王XX诉被告戴XX离婚纠纷一案一审民事判决书.txt	准予 原告 王  与 被告 戴  离婚 。 

原告王X诉被告吴XX离婚纠纷一案一审民事判决书.txt	一 、 准予 原告 王 X 与 被告 吴  离婚 ； 二 、 婚 生长 子 吴 X 甲 由 被告 吴  抚养 ， 由 原告 王 X 自 离婚 之日起 每月 月底 前 给付 被告 吴  子女 抚养费 300 元 直至 吴 X 甲 年满 18 周岁 止 ； 婚生 次女 吴 X 乙 、 三子 吴 X 丙 （ 双胞胎 ） 由 原告 王 X 抚养 ， 并 由 被告 吴  自 离婚 之日起 每月 月底 前 给付 原告 王 X 子女 抚养费 600 元 直至 吴 X 乙 与 吴 X 丙 年满 18 周岁 止 。 如果 未 按 本 判决 指定 的 期间 履行 给付 金钱 义务 ， 应当 依照 《 中华人民共和国 民事 诉讼法 》 第 二百五十 三条 之 规定 ， 加倍 支付 迟延 履行 期间 的 债务 利息 。 

原告王凤兰诉被告胡贵云离婚后财产纠纷一案一审民事判决书.txt	在 本 判决 生效 后 十日 内 ， 由 被告 胡 某某 支付 给 原告 王 某某 价款 50000 元 。 如果 被告 胡 某某 未 按 本 判决 指定 的 期间 履行 给付 金钱 义务 ， 应当 依照 《 中华人民共和国 民事 诉讼法 》 第 二百五十 三条 之 规定 ， 加倍 支付 给 原告 王 某某 迟延 履行 期间 的 债务 利息 。 

原告王某与被告叶某甲离婚纠纷一审民事判决书.txt	一 、 准予 原告 王某 与 被告 叶某 甲 离婚 。 二 、 婚生女 叶某乙 随 原告 王某 生活 ， 由 被告 叶某甲 从 强制 戒毒 期满 后 的 次月 起 每月 支付 婚生 女叶 某 乙 生活费 600 元 ， 教育费 、 医疗费 凭 发票 原 、 被告 各 承担 一半 ， 至 婚生 女叶 某 乙 独立 生活 止 。 三 、 夫妻 共同财产 川 AJ5 ＊ ＊ ＊ 号 宝骏 牌 小汽车 归 原告 王某 所有 ， 川 A5G ＊ ＊ ＊ 号 大众 牌 小型汽车 归叶某 甲 所有 。 

原告王某与被告张某离婚纠纷一审民事判决书.txt	不 准予 原告 王某 与 被告 张某 离婚 。 

原告王某某与被告何某某离婚纠纷一审民事判决书.txt	一 、 准予 原告 王 某某 与 被告 何 某某 离婚 ； 二 、 位于 大观 镇长 信 社区 1 村 36 栋 住房 归 被告 何 某某 所有 ； 三 、 被告 何 某某 于 本 判决 生效 之日起 二十日 内 支付 原告 王 某某 房屋 补偿款 26000 元 ； 四 、 驳回 原告 王 某某 的 其他 诉讼请求 。 如果 未 按 本 判决 指定 的 期间 履行 给付 金钱 义务 ， 应当 按照 《 中华人民共和国 民事 诉讼法 》 第 二百五十 三条 之 规定 ， 加倍 支付 迟延 履行 期间 的 债务 利息 。 

原告王某某与被告寇某某离婚纠纷一案一审民事判决书.txt	一 、 准许 原告 王 某某 与 被告 寇 某某 离婚 ； 婚生子 寇某 甲 随 被告 寇 某某 生活 ， 原告 从 2016 年 5 月 起 每月 向 被告 支付 抚养费 500 元 至 寇某 甲 年满 十八周岁 止 ， 每年 12 月 31 日前 付清 当年 费用 。 

原告王某某诉被告甘某甲离婚纠纷一案一审民事判决书.txt	不 准予 王 某某 与 甘某 甲 离婚 。 

原告王某诉被告李某甲离婚纠纷一案一审民事判决书.txt	准予 原告 王某 与 被告 李某 甲 离婚 。 

原告甘某某与被告郭某某离婚纠纷一审民事判决书.txt	不准 原告 甘 某某 与 被告 郭 某某 离婚 。 

原告石某某诉被告熊某甲离婚纠纷案一审民事判决书.txt	不 准予 原告 石 某某 与 被告 熊某 甲 离婚 。 

原告秦某诉被告陈某离婚纠纷一案一审民事判决书.txt	不准 原告 秦某 与 被告 陈某 离婚 。 

原告罗某某与被告兰某甲离婚纠纷一案一审民事判决书.txt	不准 原告 罗 某某 与 被告 兰某 甲 离婚 。 

原告罗某某诉被告刘某某离婚纠纷一案的民事判决书.txt	一 、 准许 原告 罗 某某 与 被告 刘 某某 离婚 ； 二 、 原告 罗 某某 在 2016 年 4 月 1 日 起 每月 向 被告 刘 某某 给付 生活 帮助 费 200 元 ， 限 每年 12 月 31 日前 履行 完 当年度 的 费用 。 三 、 驳回 原告 的 其他 诉讼请求 。 

原告罗某某诉被告滕某某“离婚纠纷”一案民事判决书.txt	不准 原告 罗 某某 与 被告 滕 某某 离婚 。 

原告罗某某诉被告陈某某离婚纠纷一审民事判决书.txt	不 准予 原告 罗 某某 与 被告 陈 某某 离婚 。 

原告罗某诉被告李某离婚纠纷一案一审民事判决书.txt	不准 原告 罗某 与 被告 李某 离婚 。 

原告罗泽辉诉被告高长江离婚纠纷一案民事判决书.txt	不准 原告 罗泽辉 与 被告 高 长江 离婚 。 

原告罗秀英诉被告王雪峰离婚纠纷一案民事判决书.txt	一 、 准予 原告 罗 秀英 与 被告 王 雪峰 离婚 ； 二 、 婚生子 王小飞 随 原告 罗 秀英 生活 ， 被告 王 雪峰 按 月 支付 生活费 300 元 ， 教育费 、 医疗费 凭据 原 、 被告 各 承担 50 % ， 至 婚生子 王小飞 年满 十八周岁 之 日 为止 。 

原告肖乾英诉被告王新明离婚纠纷一案民事判决书.txt	不准 原告 肖乾英 与 被告 王新明 离婚 。 

原告肖某某为与被告张某某离婚纠纷一案的民事判决书.txt	不 准许 原告 肖 某某 与 被告 张 某某 离婚 。 

原告胡某某与被告陈某甲离婚纠纷一审判决书.txt	准予 原告 胡 某某 与 被告 陈某 甲 离婚 。 

原告胡某某诉被告曾某甲离婚纠纷一审民事判决书.txt	不准 胡 某某 与 曾某 甲 离婚 。 

原告苏映忠与被告赵玉香离婚纠纷一案民事判决书.txt	一 、 准予 原告 苏映忠 与 被告 赵玉香 离婚 ； 二 、 婚生女 苏玲 （ 生于 2006 年 7 月 18 日 ） 由 被告 赵玉香 抚养 ， 婚生子 苏心民 （ 生于 2008 年 10 月 14 日 ） 由 原告 苏映忠 抚养 ； 三 、 车牌号码 为 川 YD6860 的 长城牌 小型汽车 归 原告 苏映忠 所有 ， 原告 苏映忠 在 本 判决 生效 之日起 十日 内 给付 被告 赵玉香 人民币 25000.00 元 。 

原告苏某某与被告汪某某离婚纠纷一案民事裁定书.txt	本案 按 撤诉 处理 。 

原告苟某某与被告杨某离婚纠纷一案的民事判决书.txt	不准 原告 苟 某某 与 被告 杨某 离婚 。 

原告苟某某与被告熊某某“离婚纠纷”一案民事判决书.txt	不准 原告 苟 某某 与 被告 熊 某某 离婚 。 

原告苟某某诉被告李某甲离婚纠纷一案一审民事判决书.txt	不准 原告 苟 某某 与 被告 李某 甲 离婚 。 

原告范某某诉被告胡某某为离婚纠纷一案一审民事判决书.txt	不准 原告 范 某某 与 被告 胡 某某 离婚 。 

原告蓝某某诉被告邹某某离婚纠纷一案民事判决书.txt	不准 原告 蓝 某某 与 被告 邹 某某 离婚 。 

原告袁某某诉被告张某离婚纠纷一案的民事判决书.txt	一 、 准予 原告 袁 某某 与 被告 张某 离婚 ； 二 、 婚生女 张某欣 由 被告 张某 抚养 成年 ， 原告 袁 某某 从 2016 年 4 月 1 日 起 每月 承担 抚养费 400 元 至 小孩 成年 时 止 。 原告 袁 某某 享有 探望 权 ， 被告 张某 有 协助 的 义务 。 

原告詹某某诉被告李某某离婚纠纷案一审判决书.txt	不 准予 原告 詹 某某 与 被告 李 某某 离婚 。 

原告谢某与被告何某某离婚纠纷一案的民事判决书.txt	不准 原告 谢某 与 被告 何 某某 离婚 。 

原告谢某甲诉被告程某某离婚纠纷一案民事判决书.txt	驳回 原告 谢某 甲 诉 被告 程 某某 的 离婚 请求 。 

原告谭某某与被告胡某“离婚纠纷”一案民事判决书.txt	不准 原告 谭 某某 与 被告 胡某 离婚 。 

原告谭某某诉被告郑某某离婚纠纷一案民事裁定书.txt	不 准予 原告 谭 某某 与 被告 郑 某某 离婚 。 

原告贺某某诉被告严某某离婚纠纷一审民事判决书.txt	一 、 准予 原告 贺 某某 与 被告 严 某某 离婚 ； 二 、 婚生子 跟随 原告 贺 某某 生活 ， 被告 严 某某 自 2016 年 3 月 起 每月 25 日前 支付 婚生子 抚养费 500 元 ， 直至 婚生子 年满 十八周岁 止 ； 三 、 原 、 被告 双方 各自 的 日常 生活用品 ， 归 原 、 被告 双方 各自 所有 。 

原告贺某某诉被告杨某某为离婚纠纷一案一审民事判决书.txt	不准 原告 贺 某某 与 被告 杨 某某 离婚 。 

原告贺某甲诉被告严某某离婚纠纷一案一审民事判决书.txt	一 、 准予 原告 贺某甲 与 被告 严 某某 离婚 ； 二 、 婚生子 贺某 乙 跟随 原告 贺某 甲 生活 ， 被告 严 某某 自 2016 年 3 月 起 每月 25 日前 支付 婚生子 贺某 乙 抚养费 500 元 ， 直至 婚生子 贺某 乙 年满 十八周岁 止 ； 三 、 原 、 被告 双方 各自 的 日常 生活用品 ， 归 原 、 被告 双方 各自 所有 。 

原告赵某某与被告伍某某离婚纠纷一案一审民事判决书.txt	不准 原告 赵 某某 与 被告 伍 某某 离婚 。 

原告赵某某诉被告何某甲离婚纠纷一案一审民事判决书.txt	不准 原告 赵 某某 与 被告 何某 甲 离婚 。 

原告赵菊容诉被告黄永安离婚一审民事判决书.txt	准予 原告 赵 某某 与 被告 黄 某某 离婚 。 

原告辜某诉被告赵某某“离婚纠纷”一案民事判决书.txt	不准 原告 辜某 诉 被告 赵 某某 离婚 。 

原告邓某某与被告李某离婚纠纷一案的民事判决书.txt	不准 原告 邓 某某 与 被告 李某 离婚 。 

原告邓某某与被告潘某甲离婚纠纷一审民事判决书.txt	一 、 准予 原告 邓 某某 与 被告 潘某 甲 离婚 ； 二 、 婚生子 潘某乙 由 原告 邓 某某 抚养 ， 被告 潘某 甲 每月 给付 生活费 400 元 ／ 月 ， 医疗费 、 教育费 各 承担 一半 至 其 独立 生活 时 止 。 

原告邓某某与被告衡某某离婚纠纷一案民事判决书.txt	不准 原告 邓 某某 与 被告 衡 某某 离婚 。 

原告邓某某诉被告詹某某离婚纠纷一案一审判决书.txt	不准 原告 邓 某某 与 被告 詹 某某 离婚 。 

原告邓某某诉被告贺某某离婚纠纷一案一审民事判决书.txt	一 、 准予 原告 邓 某某 与 被告 贺 某某 离婚 ； 二 、 婚生子 邓某 甲 、 邓某 随 原告 邓 某某 生活 ， 被告 贺 某某 不 承担 两 婚生子 的 抚养费 。 

原告邓某某诉被告赵某某离婚纠纷一案的民事判决书.txt	一 、 准予 原告 邓 某某 与 被告 赵 某某 离婚 ； 二 、 婚生女 赵某 由 被告 赵 某某 抚养 至 成年 时 止 ， 原告 邓 某某 从 2016 年 1 月 起 每月 承担 抚养费 700 元 至 小孩 成年 时 止 ， 限 每年 12 月 30 日前 履行 完 当年度 的 抚养费 。 原告 邓 某某 享有 探望 权 ， 被告 赵 某某 有 协助 的 义务 ； 三 、 驳回 原告 邓 某某 的 其他 诉讼请求 。 

原告邹某某诉被告王某某离婚纠纷一案一审民事判决书.txt	一 、 准许 原告 邹 某某 与 被告 王 某某 离婚 ； 二 、 婚生子 王俊康 随 原告 邹 某某 生活 ， 婚生子 王俊康 的 生活费 、 教育费 、 医疗费 等 抚养费 用 均由 原告 邹 某某 承担 ， 至 婚生子 王俊康 独立 生活 止 。 

原告郭某诉被告庞某离婚纠纷一案一审民事判决书.txt	不准 原告 郭某 与 被告 庞某 离婚 。 

原告鄢某某诉被告周某某离婚纠纷一案的民事判决书.txt	一 、 准予 原告 鄢 某某 与 被告 周 某某 离婚 。 二 、 婚生子 鄢某 和 婚生女 鄢某兰 由 原告 鄢 某某 抚养 成年 ， 被告 周 某某 从 2016 年 3 月 起 分别 承担 鄢某 和 鄢某兰 每月 抚养费 各 400 元 至 鄢某 、 鄢某兰 成年 时 止 ， 被告 周 某某 享有 对 子女 的 探望 权 ， 原告 鄢 某某 有 协助 的 义务 。 三 、 驳回 被告 周 某某 的 其他 诉讼请求 。 

原告钟某某诉被告刘某某离婚纠纷一案一审民事判决书.txt	不准 原告 钟 某某 与 被告 刘 某某 离婚 。 

原告钟某某诉被告刘某某离婚纠纷一案一审民事裁定书.txt	驳回 原告 钟 某某 的 起诉 。 如 不服 本 裁定 可 在 裁定书 送达 日 起 10 日 内向 本院 递交 上诉状 并 按 对方 当事人 人数 提出 副本 上诉 于 四川省 宜宾市 中级 人民法院 。 

原告钱某某诉被告江某某离婚纠纷一审民事判决书.txt	不准 原告 钱 某某 与 被告 江 某某 离婚 。 

原告阮某与被告杨某某离婚纠纷一案民事判决书.txt	不准 原告 阮某 与 被告 杨 某某 离婚 。 

原告陈某与被告林某某离婚纠纷一审民事判决书.txt	不 准予 原告 陈某 与 被告 林 某某 离婚 。 

原告陈某与被告简某某离婚纠纷一案的一审民事判决书.txt	不准 原告 陈某 与 被告 简 某某 离婚 。 

原告陈某某与被告徐某某“离婚纠纷”一案民事判决书.txt	不 准许 原告 陈 某某 与 被告 徐 某某 离婚 。 

原告陈某某与被告樊某离婚纠纷一案的民事判决书.txt	不准 原告 陈 某某 与 被告 樊某 离婚 。 

原告陈某某与被告詹某某离婚纠纷一审判决书.txt	不 准予 原告 陈 某某 与 被告 詹 某某 离婚 。 

原告陈某某诉被告唐某某离婚纠纷案一审民事判决书.txt	不准 原告 陈 某某 与 被告 唐某 甲 离婚 。 

原告陈某某诉被告胡某某为离婚纠纷一案一审民事判决书.txt	不准 原告 陈 某某 与 被告 胡 某某 离婚 。 

原告陈某甲与被告王某甲离婚纠纷一案一审民事判决书.txt	不准 原告 陈某甲 与 被告 王某 甲 离婚 。 

原告陈某甲与被告龙某某离婚纠纷一案一审民事判决书.txt	一 、 准予 原告 陈某 乙甲 与 被告 龙 某某 离婚 ； 二 、 共同财产 处理 ： 位于 射洪县 柳树镇 一楼 一底 房屋 五间 归 原告 陈某 乙甲 所有 ； 

原告陈某甲诉被告杨某某离婚纠纷一案一审民事判决书.txt	一 、 准予 原告 陈某甲 与 被告 杨 某某 离婚 ； 二 、 婚生女 陈某乙 由 原告 陈某 甲 抚养 ， 被告 杨 某某 享有 探视权 ， 且 不 承担 抚养费 。 

原告陈某诉被告余某离婚纠纷一审民事判决书.txt	准予 原告 陈某 与 被告 余某 离婚 。 

原告陈某诉被告王某某离婚纠纷一审民事判决书.txt	不准 原告 陈某 与 被告 王 某某 离婚 。 

原告韩云诉被告吴学林离婚纠纷一案民事判决书.txt	一 、 准予 原告 韩某 与 被告 吴 某某 离婚 。 二 、 女 吴某 甲 、 子吴某 乙 均 随 被告 吴 某某 生活 ， 原告 韩某 自 2016 年 5 月 1 日 起 每月 向 被告 吴 某某 支付 吴某 甲 抚养费 400.00 元 ， 支付 吴某 乙 抚养费 400.00 元 至 两 子女 各自 满 十八周岁 时 止 。 

原告韩某诉被告蔡某离婚纠纷一案一审民事判决书.txt	不准 原告 韩某 和 被告 蔡某 离婚 。 

原告颜某与被告李某某永离婚纠纷一审判决书.txt	不 准予 原告 颜某 与 被告 李 某某 离婚 。 

原告颜某某诉被告李某离婚纠纷案一审民事判决书.txt	不准 原告 颜 某某 与 被告 李某 离婚 。 

原告马某某与被告王某某离婚纠纷一案民事判决书.txt	一 、 准予 原告 马 某某 与 被告 王 某某 离婚 ； 二 、 婚生子 王某 甲 、 婚生子 王某 乙 均 由 被告 王 某某 抚养 ； 三 、 驳回 原告 马 某某 本案 其他 诉讼请求 。 

原告马某某诉被告李某某离婚纠纷一案一审民事判决书.txt	不准 原告 马 某某 与 被告 李 某某 离婚 。 

原告高某诉被告董某某、庞某婚约财产纠纷一案一审民事判决书.txt	一 、 被告 董 某某 返还 原告 高某 彩礼 29800 元 ； 二 、 原告 高某 返还 被告 董 某某 婚约 财产 ： 十床 棉絮 、 长虹 牌 智能 电视机 一台 、 海尔 牌 洗衣机 一台 、 饮水机 一台 ， 十件 套 被子 一套 ； 三 、 驳回 原告 高某 的 其他 诉讼请求 ； 四 、 驳回 被告 董 某某 、 庞某 的 其他 诉讼请求 。 上述 债务 ， 义务人 应于 本 判决 生效 之日起 十日 内 履行 给付 完毕 ， 如果 未 按 本 判决 指定 的 期间 履行 给付 金钱 义务 ， 应当 依照 《 中华人民共和国 民事 诉讼法 》 第 二百五十 三条 之 规定 ， 加倍 支付 迟延 履行 期间 的 债务 利息 。 权利 人 可 在 本 生效 判决 规定 的 履行 期限 最后 一日 起 二年 内向 本院 申请 执行 。 

原告魏XX诉被告唐XX离婚纠纷一案一审民事判决书.txt	驳回 原告 魏  与 被告 唐  离婚 ； 

原告魏某某与被告刘某某离婚纠纷一案的民事判决书.txt	不准 原告 魏 某某 与 被告 刘 某某 离婚 。 

原告魏某某诉被告时某某离婚纠纷一案一审民事判决书.txt	不准 原告 魏 某某 与 被告 时 某某 离婚 。 

原告魏某某诉被告高某某离婚纠纷一审民事判决书.txt	一 、 准予 原告 魏 某某 与 被告 高 某某 离婚 。 二 、 夫妻 共同财产 ： 双开门 冰箱 、 红太阳 太阳能 热水器 各一 归 原告 魏 某某 所有 ； 32 寸 长虹 彩电 、 五羊 电动 三轮车 各一 归 被告 高 某某 所有 。 三 、 驳回 原告 魏 某某 的 其他 诉讼请求 。 

原告黄某与被告陈某离婚纠纷一案民事判决书.txt	一 、 准予 原告 黄某 与 被告 陈某 离婚 ； 二 、 女 陈 某某 随 被告 陈某 生活 ， 由 原告 黄某 于 本 判决 生效 之日起 每年 4 月 30 日前 支付 陈 某某 抚养费 6000 元 至 其 18 周岁 时 止 ； 三 、 由 原告 黄某 于 2016 年 4 月 30 日前 支付 被告 陈某 经济 帮助 费 5000 元 。 

原告黄某某诉被告徐某某离婚纠纷一案的民事判决书.txt	一 、 准予 原告 黄 某某 与 被告 徐 某某 离婚 ； 二 、 徐某 由 被告 徐 某某 抚养 成年 ， 原告 黄 某某 自本 判决 生效 之日起 每月 给付 徐某 抚养费 300 元 至 其 成年 时 止 ； 三 、 驳回 原告 黄 某某 其他 诉讼请求 。 

原告黄泽英诉被告余金泽离婚纠纷一案民事判决书.txt	准许 原告 黄泽英 与 被告 余金泽 离婚 。 

原告龙某某与被告郑某甲离婚纠纷一案一审民事判决书.txt	不准 原告 龙 某某 与 被告 郑某 甲 离婚 。 

原告龙某诉被告黄某甲离婚纠纷一审民事判决书.txt	一 、 准予 原告 龙某 与 被告 黄某 甲 离婚 ； 二 、 婚生女 黄某 乙 （ 生于 2009 年 2 月 24 日 ） 跟随 原告 龙某 一起 生活 、 婚生子 黄某 丙 （ 生于 2011 年 12 月 12 日 ） 跟随 被告 黄某 甲 一起 生活 ， 双方 各自 将 该 子女 抚养 成人 ； 三 、 驳回 原告 龙某 的 其他 诉讼请求 。 

史某某与李某某离婚纠纷一审民事判决书.txt	一 、 准许 原告 史 某某 与 被告 李 某某 离婚 ； 婚生子 李某 甲 （ 生于 2011 年 11 月 8 日 ） 由 被告 李 某某 抚养 ， 原告 史 某某 从 2016 年 4 月 起 每月 给付 李某 甲 抚养费 400 元 至 其 独立 生活 时 止 。 

叶某与何某某离婚纠纷一审民事判决书.txt	准予 原告 叶某 与 被告 何 某某 离婚 ； 二 、 双方 长 子叶 某 甲 、 次女 叶某乙 随 原告 叶某 生活 ， 被告 何 某某 每月 分别 支付 两 子女 的 抚养费 400 元 ， 自 2012 年 1 月 起至 两 子女 分别 具备 独立 生活 能力 时 止 。 如果 未 按 本 判决 指定 的 期间 履行 给付 金钱 的 义务 ， 应当 依照 《 中华人民共和国 民事 诉讼法 》 第 二百五十 三条 之 规定 ， 加倍 支付 迟延 履行 期间 的 债务 利息 。 

叶某某与郭某某离婚纠纷二审民事判决书.txt	驳回上诉 ， 维持原判 。 

叶某洁与汤某桥关于离婚纠纷一审民事判决书.txt	原告 叶某洁 要求 与 被告 汤某桥 离婚 ， 不予 准许 ； 

叶某诉肖某某离婚纠纷一审判决书.txt	不准 原告 叶某 与 被告 肖 某某 离婚 。 

向某某与补某甲离婚纠纷一审民事判决书.txt	一 、 准予 原告 向 某某 与 被告 补 某 甲 离婚 ； 二 、 原 、 被告 婚生子 补 某 丙 、 补 某 丁 跟随 被告 补 某 甲 生活 ， 原告 向 某某 每月 支付 两 小孩 抚养费 500 元 （ 从 2016 年 1 月份 起 支付 ） 直至 两 小孩 独立 生活 时 止 。 

向某某与陈某某离婚纠纷一审民事判决书.txt	准予 原告 向 某某 与 被告 陈 某某 离婚 。 

向某某与雷某某离婚纠纷一审民事判决书.txt	不 准许 原告 向 某某 与 被告 雷 某某 离婚 。 

吕某某与何某甲离婚纠纷一审民事判决书.txt	一 、 准予 原告 吕 某某 与 被告 何某 甲 离婚 ； 二 、 驳回 原告 吕 某某 的 其他 诉讼请求 。 

吕某某诉何某甲离婚纠纷民事判决书.txt	不 准予 原告 吕 某某 与 被告 何某 甲 离婚 。 

吕某诉曾某某离婚纠纷一审民事判决书.txt	不准 原告 吕某 与 被告 曾 某某 离婚 。 

吴某某与周某某离婚纠纷一案民事判决书.txt	不 准予 原告 吴 某某 与 被告 周某 甲 离婚 。 

吴某某与朱某某离婚纠纷一审民事判决书.txt	不 准予 原告 吴 某某 与 被告 朱 某某 离婚 。 

吴某某与梁某甲离婚纠纷一审民事判决书.txt	一 、 准许 原告 吴 某某 与 被告 梁某 甲 离婚 ； 二 、 原告 吴 某某 与 被告 梁某 甲 共育 之 子 梁某 乙 ， 由 原告 吴 某某 抚育 。 

吴某某与熊某某离婚纠纷一审民事判决书.txt	一 、 准予 原告 吴 某某 与 被告 熊 某某 离婚 ； 二 、 原 、 被告 之 子 熊某 甲 随 被告 熊 某某 生活 ， 原告 吴 某某 从 2016 年 4 月 起 每月 支付 熊某 甲 抚养费 600 元 ， 直至 2018 年 6 月 止 。 

吴某某与邓某某离婚纠纷一审民事判决书.txt	不 准予 原告 吴 某某 与 被告 邓 某某 离婚 。 

吴某某诉伍某某离婚纠纷一审民事判决书.txt	一 、 准予 原告 吴 某某 与 被告 伍 某某 离婚 。 二 、 婚生子 吴某 甲 随 原告 吴 某某 生活 ， 被告 伍 某某 每月 承担 抚养费 400 元 至 其 成年 。 （ 执行 时间 ： 2016 年 4 月 ） 三 、 原告 吴 某某 和 被告 伍 某某 离婚 后 ， 婚生子 吴某 甲 的 学费 、 医疗费 （ 经 国家 政策 报销 后 剩余 部分 ） 凭 正式 票据 ， 由 原告 吴 某某 和 被告 伍 某某 各 承担 一半 。 四 、 驳回 原告 吴 某某 其他 诉讼请求 。 

吴某某诉王某某离婚纠纷一审民事判决书.txt	准予 原告 吴 某某 与 被告 王 某某 离婚 。 

吴某某诉郑某离婚纠纷一审民事判决书.txt	准予 原告 吴 某某 与 被告 郑某 离婚 。 

吴某甲与何某某离婚纠纷一案二审民事判决书.txt	驳回上诉 ， 维持原判 。 

吴欢与王杰虹离婚纠纷一审判决书.txt	原告 吴某 要求 与 被告 王某虹 离婚 ， 不予 准许 。 

周某与喻某离婚纠纷一审民事判决书.txt	原告 周某 要求 与 被告 喻某 离婚 ， 本院 不予 准许 。 

周某与宋某甲离婚纠纷案一审民事判决书.txt	不准 原告 周某 与 被告 宋某 甲 离婚 。 

周某与李某某离婚纠纷案一审民事判决书.txt	不准 原告 周某 和 被告 李 某某 离婚 。 

周某与蒋某某离婚纠纷一审民事判决书.txt	不准 原告 周甲 与 被告 蒋 某某 离婚 。 

周某与邱某甲离婚纠纷一审民事判决书.txt	一 、 准予 原告 周某 与 被告 邱某 甲 离婚 ； 二 、 原告 周某 于 本 判决 发生 法律效力 之日起 五日 内 给付 被告 邱某 甲 50 ， 000 元 。 

周某某与张某甲离婚纠纷二审民事判决书.txt	驳回上诉 ， 维持原判 。 

周某某与李某甲离婚纠纷一审民事判决书.txt	准予 原告 周 某某 与 被告 李某 甲 离婚 。 本 判决 发生 法律效力 前 ， 原 、 被告 不得 另行 结婚 。 

周某某与李某离婚纠纷一审民事判决书.txt	一 、 准许 原告 周 某某 与 被告 李某 离婚 ； 二 、 驳回 原告 周 某某 的 其他 诉讼请求 。 

周某某与李某离婚纠纷一案一审民事判决书.txt	不准 原告 周 某某 与 被告 李某 离婚 ； 

周某某与王某某离婚纠纷一审民事判决书.txt	一 、 准许 原告 某某 与 被告 某某 离婚 ； 二 、 原告 付给 被告 经济 帮助 费 10000 元 。 

周某某与胡某离婚纠纷一审民事判决书.txt	准予 原告 周 某某 与 被告 胡某 离婚 ； 婚生 女 ， 胡某 乙 ， 由 被告 胡某 抚养 ， 原告 周 某某 从 2016 年 4 月 开始 ， 每月 28 日前 向 被告 胡某 支付 子女 抚养费 400 元 ／ 月 至 胡某 乙 年满 18 周岁 止 ； 夫妻 共同财产 ： 位于 四川省 安县 的 三套 五 小青瓦 房 一套 ， 由 原告 周 某某 与 被告 胡某 平均 分割 （ 由 原告 周 某某 与 被告 胡某 自行 协商 分割 ） 。 

周某某与陈某甲离婚纠纷一审民事判决书.txt	不准 原告 周 某某 与 被告 陈某 甲 离婚 。 

周某某诉孙某某离婚纠纷案一审民事判决书.txt	不准 原告 周 某某 与 被告 孙 某某 离婚 。 

周某某诉被告王某某离婚纠纷一审民事判决书.txt	不 准予 原告 周 某某 与 被告 王 某某 离婚 。 

周某某诉黄某某离婚纠纷一审民事判决书.txt	不 准予 原告 周 某某 与 被告 黄 某某 离婚 。 

周某甲与罗某离婚纠纷一审民事判决书.txt	一 、 准予 原告 周某甲 与 被告 罗某 离婚 。 二 、 原 、 被告 的 婚生子 罗某乙 随 被告 罗某 生活 并 由其 抚养 。 三 、 原告 周某 甲 的 婚前 财产 （ 被子 3 床 ） ， 归 被告 罗某 所有 。 

周某甲诉熊某某离婚纠纷一案一审民事判决书.txt	一 、 准予 原告 周某甲 与 被告 熊 某某 离婚 ； 二 、 婚生子 周某 乙 、 婚生女 周某 丙 跟随 原告 周某 甲 生活 。 

唐小惠与杨大城离婚纠纷一审民事判决书.txt	准予 原告 唐 某某 和 被告 杨 某某 离婚 。 

唐某与刘某某离婚纠纷一审民事判决书.txt	不准 原告 唐某 与 被告 刘 某某 离婚 。 

唐某与曾某离婚纠纷一审民事裁定书.txt	本案 按 撤诉 处理 。 

唐某容与段某青离婚纠纷一审民事判决书.txt	一 、 准许 原告 唐某容 与 被告 段某青 离婚 ； 二 、 原 、 被告 婚生子 段某杰 由 被告 段某青 直接 抚养 ， 原告 唐某容 每月 支付 生活 400 元 至 独立 生活 时 止 ， 医疗费 和 教育费 凭 票据 由 原 、 被告 各 承担 一半 ； 三 、 驳回 原告 唐某容 的 其他 诉讼请求 。 

唐某某与王某甲离婚纠纷一审民事判决书.txt	不 准予 原告 唐 某某 与 被告 王某 甲 离婚 。 

唐某某与胡某某离婚纠纷一审民事判决书.txt	不准 原告 唐某甲 与 被告 胡 某某 离婚 。 

唐某某与谢某某离婚纠纷二审民事判决书.txt	驳回上诉 ， 维持原判 。 

唐某某与谢某甲离婚纠纷一审民事判决书.txt	不 准许 原告 唐 某某 与 被告 谢某 甲 离婚 。 

唐某某与邓某某离婚纠纷一审民事裁定书.txt	驳回 原告 唐 某某 的 起诉 。 如 不服 本 裁定 ， 可 在 裁定书 送达 之日起 十日 内 ， 向 本院 递交 上诉状 ， 并 按 对方 当事人 或者 代表人 的 人数 提出 副本 ， 上诉 于 四川省 德阳市 中级 人民法院 。 

唐某某与龙某某离婚纠纷一审民事判决书.txt	不 准予 原告 唐某 与 被告 龙 某某 离婚 。 

唐某某诉张某某离婚纠纷一审民事判决书.txt	不准 原告 唐 某某 与 被告 张 某某 离婚 。 

唐某某诉袁某离婚纠纷一案一审民事判决书.txt	不准 原告 唐 某某 与 被告 袁某 离婚 。 

唐某某诉被告周某某离婚纠纷一审民事判决书.txt	不准 原告 唐 某某 与 被告 周 某某 离婚 。 

唐某某诉谢某某离婚纠纷一审民事判决书.txt	一 、 准予 原告 唐 某某 与 被告 谢 某某 离婚 。 二 、 婚生女 唐某 甲 随 被告 谢 某某 生活 ， 原告 唐 某某 不 承担 抚养费 。 

唐某甲与王某甲离婚纠纷一审民事判决书.txt	不准 原告 唐某甲 与 被告 王某 甲 离婚 。 

唐某甲诉谢某某离婚纠纷一审民事判决书.txt	一 、 准予 原告 唐某甲 与 被告 谢 某某 离婚 ； 二 、 婚生女 唐太乙 跟随 原告 唐某 甲 生活 ， 被告 谢 某某 不 给付 子女 抚养费 。 三 、 登记 在 唐某 甲 名下 的 位于 华蓥市 永兴 镇  街 砖木结构 房屋 一座 ［ 共 四间 ， 建筑面积 为 ： 101.02 平方米 ， 房屋产权 证号 为 ： 华蓥市 房 权证 永兴 镇 字 第  号 ， 土地 使用 权证 号 为 ： 华国 用 （ 2001 ） 字 第 X 号 ］ ， 从 东起 （ 与 唐国 某 、 唐国 乙 住宅 相邻 ） 至 西顺 数 第一间 和 第二间 房屋 归 被告 谢 某某 所有 、 第三间 和 第四间 房屋 （ 与 邓龙某 、 王以某 住宅 相邻 ） 归 原告 唐某 甲 所有 。 四 、 驳回 原告 的 其他 诉讼请求 。 

唐某芬与唐甲离婚纠纷一审民事判决书.txt	不 准许 原告 唐某芬 与 被告 唐甲 离婚 。 

喻某某与罗某某离婚纠纷一审民事判决书.txt	一 、 准许 原告 喻 某某 与 被告 罗 某某 离婚 ； 二 、 原 、 被告 的 婚生子 罗某 甲 （ 生于 1998 年 5 月 27 日 ） 、 婚生女 罗某 乙 （ 生于 2004 年 3 月 12 日 ） 由 被告 罗 某某 抚养 ， 原告 喻 某某 从 判决 生效 之日起 每月 给付 罗某 甲 、 罗某 乙 抚养费 各 400 元 至 罗某 甲 、 罗某 乙 分别独立 生活 时 止 。 

夏某与王某离婚纠纷一审民事判决书.txt	不 准予 原告 夏某 与 被告 王某 离婚 。 

夏某与白某离婚纠纷一审民事判决书.txt	准予 原告 夏某 与 被告 白某 离婚 。 

夏某某与何某某离婚纠纷一审民事判决书.txt	不准 原告 夏 某某 与 被告 何 某某 离婚 。 

夏某某与张某某离婚纠纷一审民事判决书.txt	不 准许 原告 夏 某某 与 被告 张 某某 离婚 。 

夏某某与杨某某离婚纠纷一审民事裁定书.txt	驳回 夏 某某 的 起诉 。 如 不服 本 裁定 ， 可 在 裁定书 送达 之日起 十日 内 ， 向 本院 递交 上诉状 ， 并 按 对方 当事人 的 人数 或者 代表人 的 人数 提交 副本 ， 上诉 于 四川省 攀枝花市 中级 人民法院 。 

夏某某与魏某甲离婚纠纷案一审民事判决书.txt	不准 原告 夏 某某 与 被告 魏某 甲 离婚 。 

夏某某与黎某甲离婚纠纷案二审民事判决书.txt	驳回上诉 ， 维持原判 。 

夏某某诉向某甲离婚纠纷一审民事判决书.txt	不准 夏 某某 与 向 某 甲 离婚 。 

姚某与张某甲离婚纠纷一审民事判决书.txt	准予 原告 姚某 和 被告 张某 甲 离婚 。 

姚某某与林某某离婚纠纷一审民事判决书.txt	一 、 准许 原告 姚 某某 与 被告 林 某某 离婚 ； 二 、 离婚 后 ， 婚生子 林乙 由 被告 抚养 ， 原告 承担 抚养费 每月 400 元 ， 直到 林乙 十八周岁 止 ， 每年 12 月 31 日前 付清 当年 抚养费 用 。 

姜某与贺某离婚纠纷一审民事判决书.txt	不准 原告 姜某 与 被告 贺某 离婚 。 

姜某某与杨某某离婚纠纷一审民事判决书.txt	一 、 准予 原告 姜 某某 与 被告 杨 某某 离婚 ； 二 、 婚生女 杨某甲 由 原告 姜 某某 抚养 ， 由 被告 杨 某某 从 2016 年 4 月 1 日 起 按 每月 300 元 的 标准 支付 子女 抚养费 直至 杨某 甲 年满 18 周岁 止 （ 此款 于 每月 月底 前 支付 ） 。 如果 未 按 本 判决 指定 的 期间 履行 给付 金钱 义务 ， 应当 依照 《 中华人民共和国 民事 诉讼法 》 第 二百五十 三条 之 规定 ， 加倍 支付 迟延 履行 期间 的 债务 利息 。 

姜某某与黎某某离婚纠纷一审民事判决书.txt	不 准予 原告 姜 某某 与 被告 黎 某某 离婚 。 

孔某某与何某甲离婚纠纷一审民事判决书.txt	不准 原告 孔 某某 与 被告 何某 甲 离婚 。 

孙某与杨某离婚纠纷一审民事判决书.txt	不准 原告 孙 某某 与 被告 杨 某某 离婚 。 

孙某某与张某某离婚纠纷一审民事判决书.txt	不 准许 原告 孙 某某 与 被告 张 某某 离婚 。 

孙某某与罗某某离婚纠纷一案二审民事裁定书.txt	准许 上诉人 孙 某某 撤回 上诉 。 

孙某某与陈某某离婚纠纷一审民事判决书.txt	不准 原告 孙 某某 与 被告 陈 某某 离婚 。 

孙某某与马某某离婚纠纷一审民事裁定书.txt	一 、 准予 原告 孙 某某 与 被告 马 某某 离婚 ； 二 、 婚生子 孙某甲 由 原告 孙 某某 抚养 ， 被告 马 某某 自本 判决 生效 之日起 每月 5 日前 给付 婚生子 孙某 甲 抚养费 500 元 至 2026 年 8 月 9 日 止 。 

孙某某诉侯某某离婚纠纷一审民事判决书.txt	不 准予 原告 孙 某某 与 被告 侯 某某 离婚 。 

孙某某诉肖某某离婚纠纷一审民事判决书.txt	不 准予 原告 孙 某某 与 被告 肖 某某 离婚 。 

孟芹与罗锟离婚纠纷一审民事判决书.txt	不 准予 原告 孟某 与 被告 罗某 甲 离婚 。 

季某某与李某某离婚纠纷民事判决书.txt	准予 原告 季 某某 与 被告 李 某某 离婚 。 

宋某某与刘某离婚纠纷一审民事判决书.txt	一 、 准予 原告 宋 某某 与 被告 刘某 离婚 ； 二 、 婚生女 刘 某某 由 被告 刘某 负责 抚养 ， 从 本 判决 生效 之日起 原告 宋 某某 每月 支付 刘 某某 抚养费 600 元 ， 至 其 独立 生活 为止 ； 三 、 夫妻 共同财产 泸州市 江阳区 酒 城 大道 一段 X 号 10 号 楼 25 层 2502 号 房屋 归 原告 宋 某某 所有 ， 原告 宋 某某 于 本 判决 生效 之日起 十日 内 支付 被告 刘某 房屋 分割 款 325000 元 ， 被告 刘某 协助 原告 宋 某某 办理 房屋 过户 登记手续 ； 四 、 驳回 原告 宋 某某 的 其他 诉讼请求 。 

宋某某与李某某离婚纠纷一审民事判决书.txt	不 准许 原告 宋 某某 与 被告 李 某某 离婚 。 

宋某某与杨某某离婚纠纷一审民事判决书.txt	不 准予 原告 宋 某某 与 被告 杨 某某 离婚 。 

宋某某与杨某甲离婚纠纷一审民事判决书.txt	一 、 准予 原告 宋 某某 与 被告 杨某 甲 离婚 。 二 、 原 、 被告 的 婚生子 杨某丙 随 原告 宋 某某 生活 ， 被告 从 2016 年 6 月 起 每月 给付 抚养费 300 元 至 杨某 丙 独立 生活 时 止 （ 2016 年 6 月 至 12 月 计 2100 元在 2016 年 12 月 31 日前 付清 ； 从 2017 年 起 ， 每半年 给付 一次 ， 即 每年 的 6 月 1 日 、 7 月 1 日 各 支付 一次 ） 。 三 、 驳回 原告 宋 某某 的 其他 诉讼请求 。 

宋某某与王某甲离婚纠纷案一审民事判决书.txt	不准 原告 宋 某某 与 被告 王某 甲 离婚 。 

宋某某与郑某甲离婚纠纷一审民事判决书.txt	不 准许 原告 宋 某某 与 被告 郑某 甲 离婚 。 

宋某某诉杨某某离婚纠纷一审民事判决书.txt	一 、 准予 原告 宋 某某 与 被告 杨 某某 离婚 。 二 、 原告 宋 某某 个人 名下 的 拆迁 补偿款 18900 元 、 过渡 费 6100 元 ， 合计 25000 元 ， 由 被告 在 2016 年 3 月 24 日前 支付 给 原告 。 

宋某甲与张某甲离婚纠纷案一审民事判决书.txt	不准 原告 宋某甲 与 被告 张某 甲 离婚 。 

宋某甲与邓某某离婚纠纷一审民事判决书.txt	不准 原告 宋某甲 与 被告 邓 某某 离婚 。 

官某某与刘某离婚纠纷一案一审民事判决书.txt	不 准予 原告 官 某某 和 被告 刘某 离婚 。 

尚某某与杨某离婚纠纷一审民事判决书.txt	不准 原告 尚 某某 与 被告 杨某 离婚 。 

尹某甲与唐某某离婚纠纷案一审民事判决书.txt	不准 原告 尹某甲 与 被告 唐 某某 离婚 。 

崔某与王某华离婚纠纷一审民事裁定书.txt	本案 按 撤诉 处理 。 

崔某某与刘某某离婚纠纷一审民事判决书.txt	不准 原告 崔 某某 与 被告 刘 某某 离婚 。 

左某某与陈某甲离婚纠纷一审民事判决书.txt	不准 原告 左 某某 与 被告 陈某 甲 离婚 。 

帅某某与陈某某离婚纠纷案一审民事判决书.txt	准予 原告 帅 某某 与 被告 陈 某某 离婚 。 

干某某与吴某某离婚纠纷一审民事判决书.txt	不 准予 原告 干 某某 与 被告 吴 某某 离婚 。 

庞某某与杨某甲离婚纠纷一审民事判决书.txt	不 准予 原告 庞 某某 与 被告 杨某 甲 离婚 。 

康某某与毛某某离婚纠纷一审民事判决书.txt	不准 康 某某 、 毛 某某 离婚 。 

康某某与陈某某离婚纠纷纷一审民事判决书.txt	不 准予 原告 康 某某 与 被告 陈 某某 离婚 。 

康某某与高某某离婚纠纷一案民事判决书.txt	一 、 准予 康 某某 与 被告 高 某某 离婚 ; 二 、 婚生女 康蕴馨 （ 2012 年 4 月 19 日 出生 ） 由 被告 高 某某 抚养 ， 原告 康 某某 于 2016 年 4 月 起 ， 每月 10 日前 向 被告 高 某某 支付 婚生女 康蕴馨 的 抚养费 1500 元 ， 到 孩子 康蕴馨 18 周岁 时 止 ； 三 、 原 、 被告 共同 所有 的 坐落于 内江市 东兴区 东兴 大道 1668 号 B11 幢 4 单元 601 号 住房 一套 （ 产权证 号 ： 201217417 、 201217417 - 2 ） 、 家具 及 家电 、 被告 住房 公积金 归 被告 高 某某 所有 ， 被告 高 某某 于 本 判决 生效 后 十日 内向 原告 康 某某 支付 214900 元 ； 四 、 原 、 被告 共同 债务 ： 借 被告 父母 高厚珍 与 李改俊 的 借款 220000 元 ， 由 双方 各自 偿还 110000 元 ； 借 原告 父亲 康元 有 的 借款 48000 元 ， 由 双方 各自 偿还 24000 元 ， 均 于 本 判决 生效 后 十日 内 支付 。 如果 未 按 本 判决 指定 的 期间 履行 给付 金钱 义务 ， 应当 按照 《 中华人民共和国 民事 诉讼法 》 第 二百五十 三条 之 规定 ， 加倍 支付 迟延 履行 期间 的 债务 利息 。 

廖某与彭某某离婚纠纷一审民事判决书.txt	不准 原告 廖某 与 被告 彭 某某 离婚 。 

廖某与汪某某离婚纠纷一审民事判决书.txt	不 准予 原告 廖某 与 被告 汪 某某 离婚 。 

廖某与潘某离婚纠纷一审民事判决书.txt	不 准予 原告 廖某 与 被告 潘某 离婚 。 

廖某某与张某某离婚纠纷一审民事判决书.txt	不准 原告 廖 某某 和 被告 张 某某 离婚 。 

廖某某与朱某某离婚纠纷一审民事判决书.txt	一 、 准予 原告 廖 某某 与 被告 朱某 甲 离婚 ； 二 、 婚生女 朱某乙 由 原告 廖 某某 抚养 ， 并 由 被告 朱某甲 从 2016 年 5 月 起 每月 支付 抚养费 500 元 至 朱某 乙 独立 生活 时 止 ， 朱某乙 的 教育费 、 医疗费 凭 票据 由 原 、 被告 各 承担 一半 。 

廖某某与贺某某离婚纠纷一审民事判决书.txt	不准 廖 某某 、 贺 某某 离婚 。 

廖某某与魏某某离婚纠纷一审民事判决书.txt	不准 原告 廖 某某 与 被告 魏 某某 离婚 。 

廖某某诉李某某离婚纠纷一审民事判决书.txt	一 、 准予 原告 廖 某某 与 被告 李云成 离婚 ； 二 、 小孩 李某甲 由 原告 廖武文 抚养 并 随其 生活 ， 被告 李某甲 于 2015 年 6 月 起 每月 支付 小孩 的 生活费 400 元 至 其 独立 生活 时 止 ， 教育费 、 医疗费 凭 发票 各 承担 一半 ； 三 、 夫妻关系 存续 期间 的 存款 29000 元 及 利息 957 元 ， 合计 29957 元 ， 原告 廖 某某 与 被告 李 某某 各 享有 50 % ， 被告 李 某某 于 本 判决 生效 之日起 三日 内 一次性 支付 给 原告 廖 某某 14978.5 元 ； 四 、 驳回 原告 廖 某某 的 其他 诉讼请求 。 

廖某甲诉周某甲离婚纠纷一案民事一审判决书.txt	准予 原告 廖某甲 与 被告 周某 甲 离婚 。 

廖某贵与王某来离婚纠纷一审民事判决书.txt	不 准予 原告 廖某贵 与 被告 王某 来 离婚 。 

张某与杨某离婚纠纷一审民事判决书.txt	不准 原告 张 某某 与 被告 杨 某某 离婚 。 

张某与王某甲离婚纠纷一审民事判决书.txt	不 准予 原告 张某 与 被告 王某 甲 离婚 。 

张某与王某离婚纠纷一审民事判决书.txt	一 、 准予 原告 张 某某 与 被告 王 某某 离婚 。 二 、 原 、 被告 婚生子 张某乙 由 原告 张 某某 抚养 ， 婚生女 张某丙 由 被告 王 某某 抚养 。 原告 张 某某 自愿 支付 婚生女 张某 丙 抚养费 5000 元 。 本院 予以 准许 。 此 费用 在 本 判决 生效 后 立即 支付 。 三 、 原告 张 某某 自愿 清偿 夫妻 共同 债务 在 张某 戊 处 借款 2000 元 。 本院 予以 确认 。 

张某与魏某甲离婚纠纷一案一审民事判决书.txt	不准 原告 张某 与 被告 魏某 甲 离婚 。 

张某某与何某某离婚纠纷一案一审民事判决书.txt	不准 原告 张 某某 与 被告 何 某某 离婚 。 

张某某与唐某甲离婚纠纷一审民事判决书.txt	一 、 准予 原告 张 某某 与 被告 唐某 甲 离婚 ； 二 、 婚生子 唐某乙 由 被告 唐某 甲 抚养 ， 原告 张 某某 自愿 放弃 位于 仪陇县 复兴 镇 复兴 北路 91 号 1 层 1 号 、 2 号 （ 产权 人 唐某 甲 ， 产权证 号 201102366 ； 共 有人 张 某某 ， 共有 证号 201102366 - 1 ） ， 复兴 镇 复兴 北路 91 号 2 层 1 号 （ 产权 人 唐某 甲 ， 产权证 号 201102368 ； 共 有人 张 某某 ， 共有 证号 201102368 - 1 ） 及 复兴 镇 复兴 北路 91 号 3 层 1 号 （ 产权 人 唐某 甲 ， 产权证 号 201102369 ； 共 有人 张 某某 ， 共有 证号 201102369 - 1 ） 的 房层 所 享有 的 份额 ， 以此 折抵 婚生子 唐某乙 的 抚养费 。 

张某某与姚某某离婚纠纷一审裁定书.txt	本案 按 撤诉 处理 。 

张某某与孙某某离婚纠纷一审民事判决书.txt	不准 原告 张 某某 与 被告 孙 某某 离婚 。 

张某某与张某离婚纠纷一审民事判决书.txt	一 、 准予 原告 张 某某 与 被告 张某 离婚 ； 二 、 女 张某甲 由 原告 张 某某 抚养 ， 子张某 乙 由 被告 张某 抚养 ； 三 、 原 、 被告 婚后 共同财产 位于 宣汉县 某镇 的 砖混 结构 房屋 一套 归 被告 张某 所有 。 

张某某与朱某离婚纠纷一审民事判决书.txt	不准 原告 张 某某 与 被告 朱某 离婚 。 

张某某与李某某离婚纠纷案一审民事判决书.txt	一 、 原告 张 某某 与 被告 李 某某 离婚 。 二 、 婚生 男孩 李某甲 由 张 某某 抚养 。 由 李 某某 从 2016 年 1 月 1 日 起 ， 每月 给付 张 某某 子女 抚养费 300 元 至 李某 甲 18 周岁 止 （ 此款 每年 1 月 10 日前 给付 当年 上半年 抚养费 ， 每年 7 月 10 日前 给付 当年 下半年 抚养费 ） 。 

张某某与李某甲离婚纠纷一审民事判决书.txt	不准 原告 张 某某 与 被告 李某 甲 离婚 。 

张某某与温某甲离婚纠纷案一审民事判决书.txt	不准 原告 张 某某 与 被告 温某 甲 离婚 。 

张某某与潘某甲婚姻无效纠纷一审民事判决书.txt	宣告 原告 张 某某 与 被告 潘某 甲 的 婚姻 无效 。 

张某某与王某某离婚纠纷民事一审判决书.txt	不准 张 某某 与 王 某某 离婚 

张某某与田某甲离婚纠纷一审民事判决书.txt	不准 原告 张 某某 与 被告 田某 甲 离婚 。 

张某某与申某甲离婚纠纷一审民事判决书.txt	不 准予 原告 张 某某 与 被告 申某 甲 离婚 。 

张某某与祝某某离婚纠纷一审民事判决书.txt	一 、 准许 原告 张 某某 与 被告 祝 某某 离婚 ； 二 、 原 、 被告 之 婚生子 张某 甲 随 原告 张 某某 生活 ； 由 被告 祝 某某 从 2016 年 4 月 起 每月 给付 张某 甲 生活费 300 元 ， 并 承担 其 教育费 、 医疗费 的 1 ／ 2 至 张某 甲 独立 生活 时 止 （ 该 教育费 、 医疗费 分别 凭 教育 机构 、 医药 机构 出具 的 票据 ， 与 生活费 一起 ， 均 定于 每年 6 月 、 12 月 各 结付 一次 ； 其中 ， 住院 医疗 费用 即时 给付 ） ； 三 、 被告 祝 某某 在 张某 甲 放暑假 期间 ， 可 到 原告 张 某某 处接 走 张某 甲 并 与其 共同 生活 两周 时间 ； 其后 ， 由 被告 祝 某某 及时 将 张某 甲 送 归 张 某某 处 ； 四 、 原 、 被告 夫妻 共同 债务 ： 欠 祝某 甲 和 兰 某某 借款 40000 元 ， 由 原告 张 某某 偿还 20000 元 ， 被告 祝 某某 偿还 20000 元 。 

张某某与苏某某离婚纠纷一审民事判决书.txt	准予 原告 张 某某 与 被告 苏 某某 离婚 。 

张某某与范某某离婚纠纷案一审民事判决书.txt	一 、 张 某某 与 范 某某 离婚 ； 二 、 婚生女 范某 甲 随 范 某某 生活 ， 范 某某 自愿 承担 子女 抚养费 。 

张某某与董某某离婚纠纷一审民事判决书.txt	一 、 准予 原告 张 某某 与 被告 董 某某 离婚 ； 二 、 原告 张 某某 于 本 判决 生效 之日起 一次性 给付 被告 董 某某 生活 帮助 费 5000 元 ； 如 未 按 本 判决 指定 的 期间 履行 给付 金钱 义务 ， 应当 依照 《 中华人民共和国 民事 诉讼法 》 第 二百五十 三条 的 规定 ， 加倍 支付 迟延 履行 期间 的 利息 。 

张某某与蒙某甲离婚纠纷一审民事判决书.txt	不准 原告 张 某某 与 被告 蒙某 甲 离婚 。 

张某某与赵某甲离婚纠纷一审民事判决书.txt	不准 原告 张 某某 与 被告 赵某 甲 离婚 。 

张某某与郭某某离婚纠纷一事民事判决书.txt	不 准许 原告 张 某某 与 被告 郭 某某 离婚 。 

张某某与陈某某离婚纠纷一审民事判决书.txt	不 准予 原告 张 某某 与 被告 陈 某某 离婚 。 

张某某与陈某甲离婚纠纷一审民事判决书.txt	一 、 不准 原告 张 某某 与 被告 陈某 甲 离婚 ； 二 、 驳回 原告 张 某某 的 其他 诉讼请求 。 

张某某与陈某离婚纠纷一审民事判决书.txt	不准 原告 张 某某 与 被告 陈某 离婚 。 

张某某与顾某某离婚纠纷一案一审民事判决书.txt	不 准予 原告 张 某某 与 被告 顾 某某 离婚 。 

张某某与颜某甲离婚纠纷一案一审民事判决书.txt	一 、 准许 原告 张 某某 与 被告 颜某 甲 离婚 。 二 、 婚生子 颜某 乙 、 颜某丙 随 被告 颜某 甲 一起 生活 ， 自本 判决 生效 之日起 由 原告 张 某某 每月 给付 每人 抚养费 296 元 ， 共计 592 元 ， 定于 每月 15 日前 支付 ； 前述 抚养费 给付 至 孩子 年满 十八周岁 时 止 。 如果 未 按 本 判决书 指定 的 期间 履行 给付 金钱 义务 ， 应当 按照 《 中华人民共和国 民事 诉讼法 》 第 二百五十 三条 之 规定 ， 加倍 支付 迟延 履行 期间 的 债务 利息 。 三 、 驳回 原告 张 某某 的 其他 诉讼请求 。 

张某某与高某离婚纠纷一审民事判决书.txt	不准 原告 张 某某 与 被告 高某 离婚 。 

张某某与黄某某离婚纠纷一审民事判决书.txt	一 、 准予 原告 张 某某 与 被告 黄某 甲 离婚 ； 二 、 婚生 次子 黄某丙 随 原告 张 某某 生活 ， 被告 黄某 甲 自 2016 年 3 月 起 每月 10 日前 支付 黄某 丙 当月 生活费 400 元 至 黄某 丙 独立 生活 时 止 ， 在此期间 黄某丙 的 普通 教育费 、 医疗费 （ 医保 报销 后 剩余 部分 ） 由 被告 黄某 甲 承担 50 % ； 三 、 驳回 原告 张 某某 的 其他 诉讼请求 。 

张某某与黄某离婚纠纷一审民事判决书.txt	不准 原告 张 某某 与 被告 黄某 离婚 。 

张某某与龚某某离婚纠纷一审判决书.txt	不准 原告 张 某某 与 被告 龚 某某 离婚 。 

张某某诉何某某离婚纠纷一审民事判决书.txt	一 、 准予 原告 张 某某 与 被告 何 某某 离婚 。 二 、 婚生女 何某甲 由 原告 张 某某 抚养 ， 并 由 原告 张 某某 承担 全部 子女 抚养费 。 

张某某诉康某某离婚纠纷一案一审民事判决书.txt	一 、 准予 原告 张 某某 与 被告 康 某某 离婚 。 二 、 婚生 次女 康某乙 由 原告 张 某某 抚养 ； 婚 生长 女康某 甲 由 被告 康 某某 抚养 （ 被告 康 某某 在 接受 强制 隔离 戒毒 期间 ， 由 原告 张 某某 代为 抚养 康某 甲 ） 。 

张某某诉王某某离婚纠纷一审民事判决书.txt	准予 原告 张 某某 与 被告 王 某某 离婚 。 

张某某诉赵某某离婚纠纷一审民事判决书.txt	一 、 张 某某 与 赵 某某 离婚 。 二 、 婚生女 赵甲某 由 赵 某某 抚养 ， 张 某某 每月 给付 子女 抚养费 人民币 300 元 （ 从 2016 年 4 月 1 日 起 至 赵甲某 年满 十八周岁 时 止 ， 每年 12 月 31 日前 付清 当年 应付 的 子女 抚养费 ） 。 

张某梅与黄某均离婚纠纷一审民事判决书.txt	准许 原告 张某梅 与 被告 黄某 均 离婚 ； 婚生子 黄某松 由 被告 黄某 均 直接 抚养 ， 原告 张某梅 从 2016 年 5 月 起 每月 给付 黄某松 生活费 300 元 ， 教育费 、 医疗费 凭 正式 票据 各 负担 一半 ， 至 黄某松 独立 生活 时 止 。 

张某甲与廖某甲离婚纠纷一审民事判决书.txt	不准 原告 张 某某 与 被告 廖某 甲 离婚 。 

张某甲与张某乙离婚纠纷一审民事判决书.txt	准予 原告 张某甲 与 被告 张某 乙 离婚 。 

张某甲与徐某某离婚纠纷一审民事判决书.txt	二 、 原 、 被告 婚后 共同财产 （ 位于 丹棱县 双桥镇 双桥 路 30 号 的 二楼 一底 的 房屋 共 15 间 ） ， 归 被告 徐 某某 所有 。 

张某甲与欧某某离婚纠纷一审民事判决书.txt	不 准予 原告 张某甲 与 被告 欧 某某 离婚 。 

张某甲与熊某甲离婚纠纷一审民事判决书.txt	不准 原告 张某甲 与 被告 熊某 甲 离婚 。 

张某甲与陈某某离婚纠纷二审民事判决书.txt	一 、 维持 四川省 峨眉山市 人民法院 （ 2016 ） 川 1181 民初 34 号 民事判决 第一项 、 第二项 ， 即 " 一 、 准予 陈 某某 与 张某 甲 离婚 ； 二 、 子张某 乙 随 张某 甲 生活 ， 由 张某 甲 抚养 ， 陈 某某 从 2016 年 3 月 20 日 起 每月 支付 抚养费 400 元 ， 并 承担 子张某 乙 教育费 、 医疗费 的 二分之一 至 子 张某 乙 独立 生活 为止 " ； 二 、 撤销 四川省 峨眉山市 人民法院 （ 2016 ） 川 1181 民初 34 号 民事判决 第三项 。 如果 未 按 本 判决 指定 的 期限 履行 金钱 给付 义务 ， 应当 依照 《 中华人民共和国 民事 诉讼法 》 第 二百五十 三条 之 规定 ， 加倍 支付 迟延 履行 期间 的 债务 利息 。 

张某甲诉李某甲离婚纠纷一案民事一审判决书.txt	一 、 准予 原告 张某甲 与 被告 李某 甲 离婚 ； 二 、 原 、 被告 婚生子 李某乙 由 被告 李某 甲 抚养 成人 ， 由 原告 张某 甲 每月 承担 李某乙 的 抚育费 300 元 ， 直至 李某 乙 年满 18 周岁 止 。 

张清凤与程元华离婚纠纷一审民事判决书.txt	不准 原告 张 某某 与 被告 陈 某某 离婚 。 

张雷与唐凤飞离婚纠纷二审民事判决书.txt	一 、 撤销 四川省 威远县 人民法院 （ 2015 ） 威 民初 字 第 1481 号 民事判决 ； 二 、 不 准予 被上诉人 唐凤飞 与 上诉人 张雷 离婚 。 

强某某与马某某离婚纠纷一审民事判决书.txt	不 准许 原告 强 某某 与 被告 马 某某 离婚 。 

彭某与张某离婚纠纷一审民事判决书.txt	不 准许 原告 彭某 与 被告 张某 离婚 。 

彭某某与冉某甲离婚纠纷一审民事判决书.txt	不准 原告 彭 某某 与 被告 冉某 甲 离婚 。 

彭某某与张某甲离婚纠纷一审民事判决书.txt	不 准予 原告 彭 某某 与 被告 张某 甲 离婚 。 

彭某某与田某甲离婚纠纷案一审民事判决书.txt	不准 原告 彭 某某 与 被告 田某 甲 离婚 。 

彭某甲诉杨某某离婚纠纷一审民事判决书.txt	不准 彭某甲 与 杨 某某 离婚 。 

彭某诉刘某离婚纠纷一案一审民事判决书.txt	不准 原告 彭某 与 被告 刘某 离婚 。 

徐某与黄某离婚纠纷一审民事判决书.txt	不 准予 原告 徐某 与 被告 黄某 离婚 。 

徐某某与刘某某离婚纠纷一案一审民事判决书.txt	一 、 准予 原告 徐 某某 与 被告 刘 某某 离婚 ； 二 、 婚生女 刘 某某 甲 随 被告 刘 某某 生活 ， 并 由其 抚养 ， 原告 徐 某某 从 2016 年 4 月 起 每月 给付 婚生女 刘 某某 甲 抚养费 300 元 ， 直至 其 独立 生活 时 止 。 

徐某某与李某某离婚纠纷一审民事判决书.txt	不 准予 原告 徐 某某 与 被告 李 某某 离婚 。 

徐某某与郑某甲离婚纠纷一审民事判决书.txt	不 准予 原告 徐 某某 与 被告 郑某 甲 离婚 。 

徐某贵与贾某英离婚纠纷一审民事判决书.txt	原告 徐某贵 要求 与 被告 贾某英 离婚 ， 不予 准许 。 

才某某与张某某离婚纠纷一审民事判决书.txt	不 准许 原告 才 某某 与 被告 张 某某 离婚 。 

支某某与陈某某离婚纠纷案一审民事判决书.txt	不准 原告 支 某某 与 被告 陈 某某 离婚 ； 

敬某某与梁某某离婚一审民事判决书.txt	不准 原告 敬 某某 与 被告 梁 某某 离婚 。 

敬某某诉税某某离婚纠纷一审民事判决书.txt	不准 原告 敬 某某 与 被告 税 某某 离婚 。 

敬某甲与敬某乙离婚纠纷一审民事判决书.txt	不准 原告 敬某甲 与 被告 敬某 乙 离婚 。 

敬某甲诉黄某离婚纠纷一审民事判决书.txt	不准 原告 敬某甲 与 被告 黄某 离婚 。 

敬某诉冯某甲婚姻无效纠纷一审民事判决书.txt	宣告 原告 敬某 与 被告 冯某甲 所 登记 （ 结婚证 字号 J511325 - 2013 - 003187 号 ） 的 婚姻关系 无效 。 

敬永杰与敬永莲离婚纠纷一审民事判决书.txt	不 准予 原告 敬 某某 与 被告 敬某 离婚 。 

文某某与何某某离婚纠纷一审民事判决书.txt	准予 原告 文 某某 与 被告 何 某某 离婚 。 

文某某与周某某离婚纠纷一审民事判决书.txt	不 准予 原告 文某 与 被告 周 某某 离婚 。 

文某某与杜某离婚纠纷一审民事判决书.txt	不准 原告 文 某某 与 被告 杜某 离婚 。 

文某甲与胡某离婚纠纷一审民事判决书.txt	不予 准许 原告 文某甲 与 被告 胡某 离婚 。 

方某某与刘某甲离婚纠纷案一审民事判决书.txt	一 、 准许 原告方 某某 与 被告 刘某 甲 离婚 ； 二 、 子刘某 丙 随 原告方 某某 生活 。 从 2016 年 4 月 1 日 起 ， 由 原告 刘某 甲 每月 支付 抚养费 450 元 （ 支付 方式 ： 每 六个月 支付 一次 ， 2016 年 4 月 1 日前 支付 抚养费 2700 元 ， 2016 年 10 月 1 日前 支付 抚养费 2700 元 ， 今后 以此类推 ） 至 子刘某 丙 独立 生活 为止 ； 三 、 驳回 原告方 某某 本案 的 其他 诉讼请求 。 

明某某与何某某离婚纠纷一审民事判决书.txt	原告 明 某某 要求 与 被告 何 某某 离婚 ， 本院 不予 准许 。 

易某某与张某甲离婚纠纷一审民事判决书.txt	准予 原告 易 某某 与 被告 张某 甲 离婚 。 

易某某与雷某某离婚纠纷一审民事判决书.txt	准予 原告 易 某某 与 被告 雷 某某 离婚 。 

易某某诉顾某甲离婚纠纷一审民事判决书.txt	不准 原告 易 某某 与 被告 顾某 甲 离婚 。 

曹某某与周某某离婚纠纷一审民事判决书.txt	不准 原告 曹 某某 与 被告 周某 甲 离婚 。 

曹某某与方某离婚纠纷一审民事判决书.txt	不准 曹某 、 方某 离婚 。 

曹某某与谢某某离婚后财产纠纷一审民事判决书.txt	一 、 位于 渠县 三 汇镇 河街 向阳 茗 楼 503 号 住房 归 被告 谢 某某 所有 ， 在 本 判决 生效 之日起 十五日 内 被告 谢 某某 支付 原告 曹 某某 房屋 折 价款 人民币 81200 元 （ 221200 元 divide ; 2 － 7000 元 － 22400 元 ） ； 二 、 夫妻 共同 债务 由 被告 谢 某某 负责 偿还 。 

曹某某诉杨某某离婚纠纷一案一审民事判决书.txt	不准 原告 曹 某某 与 被告 杨 某某 离婚 。 

曹某甲与李某某离婚纠纷一审民事判决书.txt	不准 原告 曹某甲 与 被告 李 某某 离婚 。 

曹某甲与柳某某离婚纠纷一审民事判决书.txt	不准 原告 曹某甲 与 被告 柳 某某 离婚 。 

曾某与陈某甲离婚纠纷一审民事判决书.txt	一 、 准予 原告 曾某 与 被告 陈某 甲 离婚 。 二 、 夫妻 共同财产 位于 眉山市 东坡区 太和 镇 石莲街 7 号 的 小青瓦 房 四间 归 被告 陈某 甲 所有 。 三 、 夫妻 共同 债务 借 曾光田 的 4000 元 由 原告 曾某 偿还 。 

曾某某与熊某某离婚纠纷一审民事裁定书.txt	一 、 准予 原告 曾 某某 与 被告 熊 某某 解除 婚姻关系 ； 二 、 婚生子 胡 某某 由 原告 原 曾福君 抚养 。 

曾某某与祝某某离婚纠纷一审民事判决书.txt	一 、 准予 原告 曾 某某 与 被告 祝 某某 离婚 ； 二 、 原告 曾 某某 在 本 判决 生效 后 五日 内 一次性 支付 被告 祝 某某 困难 补助费 3 ， 000.00 元 。 

曾某某诉刘某某离婚纠纷一审判决书.txt	不 准予 原告 曾 某某 与 被告 刘 某某 离婚 ； 

曾某某诉刘某某离婚纠纷一审民事判决书.txt	不 准予 原告 曾 某某 与 被告 刘 某某 离婚 。 

曾某某诉王某某离婚纠纷一审民事判决书.txt	不准 原告 曾 某某 与 被告 王 某某 离婚 。 

曾某甲与杨某甲离婚纠纷一审民事判决书.txt	一 、 准予 原告 曾某甲 与 被告 杨某 甲 离婚 ； 二 、 婚生子 曾某丙 随 原告 曾某 甲 生活 ， 至 独立 生活 时 止 ； 被告 杨某 甲 有权 探视 小孩 ， 被告 曾某 甲 应予 协助 ； 三 、 被告 杨某 甲 自 2016 年 3 月 起 每月 向 原告 曾某 甲 支付 小孩 抚育费 700 元 ， 至 小孩 独立 生活 时 止 ； 四 、 原 、 被告 共同财产 即以 原告 曾某 甲 名义 登记 的 位于 岳池县 九龙 镇 九龙 大街 29 号 F 幢 1 - 8 - 2 号 住宅 一套 ， 原告 曾某甲 与 被告 杨某 甲 各 占 50 % 份额 。 五 、 共同 债务 欠 被告 杨某甲 之 弟 杨云 和 妹妹 杨 秀英 共 20 万元 ， 原 、 被告 各 负责 清偿 10 万元 ， 且 相互 承担 连带 清偿 责任 ； 六 、 共同 债权 494862.5 元 ， 原 、 被告 各 享有 247431.25 元 。 

曾然与朱永方离婚纠纷案一审民事判决书.txt	不准 原告 曾某 与 被告 朱某 离婚 。 

未某与杨某甲离婚纠纷一审民事判决书.txt	一 、 准许 原告 未 某 与 被告 杨某 甲 离婚 。 二 、 婚生子 杨某 乙 （ 2003 年 8 月 1 日 生 ） ， 由 原告 未 某 抚养 ， 被告 杨某甲 从 2016 年 4 月 起 每月 给付 原告 未 某 抚养 杨某乙 的 抚养费 500 元 ， 至 杨某 乙 十八周岁 时 止 。 

朱某与杜某离婚纠纷一审民事判决书.txt	一 、 准予 原告 朱某 与 被告 杜某 离婚 。 二 、 婚 生长 女杜某 甲 （  年  月  日 出生 ） 、 婚生 次女 杜某 乙 （  年  月  日 出生 ） 均 由 原告 朱某 抚养 ， 被告 杜某 从 2016 年 3 月 起 每月 月底 前 给付 原告 朱某 抚养 杜某乙 之 抚养费 1500 元 ， 至 杜某 乙 独立 生活 时 止 。 三 、 驳回 原告 朱某 的 其他 诉讼请求 

朱某某与刘某某离婚纠纷一审民事判决书.txt	准予 原告 朱 某某 与 被告 刘 某某 离婚 ； 

朱某某与刘某某离婚纠纷一案一审民事判决书.txt	一 、 准予 原告 朱 某某 与 被告 刘 某某 离婚 。 二 、 夫妻 共同 债务 宁南县 农村 信用社 3 万元 贷款 及 利息 2226 元 由 原 、 被告 各自 承担 16113 元 。 

朱某某与廖某甲离婚纠纷一审民事判决书.txt	原告 朱 某某 诉 与 被告 廖某 甲 离婚 ， 不予 准许 。 

朱某某与张某某离婚纠纷一审民事判决书.txt	准予 原告 朱 某某 与 被告 张 某某 离婚 ； 二 、 婚生子 朱某 甲 、 朱某 乙 ， 随 原告 朱 某某 生活 并 由其 抚养 。 

朱某某与杨某某离婚纠纷案一审民事判决书.txt	一 、 准予 原告 朱 某某 与 被告 杨 某某 离婚 ； 二 、 位于 乐山市 市中区 某某 镇 某某 村 ＊ 组 ＊ ＊ 号 的 一楼 一底 住房 ， 原告 朱 某某 使用 二楼 ， 被告 杨 某某 使用 一楼 ； 三 、 夫妻 共同财产 ： 彩电 2 台 、 电冰箱 一台 、 微波炉 1 台 、 洗衣机 1 台 、 电瓶车 2 辆 、 沙发 一套 ， 衣柜 2 个 、 席梦思床 3 张 ， 归 被告 杨 某某 所有 ； 四 、 存款 65500 元 ， 原告 朱 某某 分得 30000 元 ， 被告 杨 某某 分得 35500 元 ， 被告 杨 某某 尚未 取得 的 30000 元 ， 由 原告 朱 某某 在 本 判决 生效 后 10 日 内 支付 给 被告 杨 某某 。 如果 未 按 本 判决 指定 的 期间 履行 给付 金钱 义务 ， 应当 依照 《 中华人民共和国 民事 诉讼法 》 第 二百五十 三条 之 规定 ， 加倍 支付 迟延 履行 期间 的 债务 利息 。 

朱某某与沈某某离婚纠纷二审民事判决书.txt	一 、 维持 四川省 资阳市 雁江区 人民法院 （ 2015 ） 雁江 民初 字 第 3939 号 民事判决 第一项 " 准予 原告 沈 某某 与 被告 朱 某某 离婚 " 及 第二项 " 原告 沈 某某 在 本 判决 生效 之日起 十日 内 返还 上诉人 朱 某某 的 婚前 个人财产 40000 元 " 二 、 变更 四川省 资阳市 雁江区 人民法院 （ 2015 ） 雁江 民初 字 第 3939 号 民事判决 第三项 " 婚后 共同 存款 58000 元 ， 原告 沈 某某 享有 38000 元 ， 被告 朱 某某 享有 20000 元 " 为 " 上诉人 朱 某某 与 被上诉人 沈 某某 夫妻 共同 存款 58000 元 ， 被上诉人 沈 某某 享有 29000 元 ， 由 上诉人 朱 某某 享有 29000 元 " 

朱某某与王某某离婚纠纷一审民事判决书.txt	准予 原告 朱 某某 与 被告 王 某某 离婚 。 

朱某某与陈某某离婚纠纷一审民事判决书.txt	准予 原告 朱 某某 与 被告 陈 某某 离婚 。 

朱某某诉黄某某离婚纠纷一审民事判决书.txt	不准 原告 朱 某某 与 被告 黄 某某 离婚 。 

权某某与刘某甲离婚纠纷案一审民事判决书.txt	不准 原告 权 某某 与 被告 刘某 甲 离婚 。 

李兰与子龙离婚纠纷一审民事判决书.txt	不 准予 原告 李某 与 被告 王 某某 离婚 。 

李某与何某甲离婚纠纷一案二审民事判决书.txt	驳回上诉 ， 维持原判 。 

李某与刘某离婚纠纷一审民事判决书.txt	准予 原告 李 某某 与 被告 刘 某某 离婚 。 

李某与张某某离婚纠纷一审民事判决书.txt	准予 原告 李某 与 被告 张 某某 离婚 ； 二 、 婚生女 张甲 、 张乙 ， 随 被告 张 某某 生活 并 由其 抚养 至 独立 生活 时 止 。 

李某与曹某甲离婚纠纷一审民事判决书.txt	驳回 原告 李某 的 诉讼请求 。 案件 受理费 150 元 ， 由 原告 李某 负担 。 如 不服 本 判决 ， 可 在 判决书 送达 之日起 十五日 内 ， 向 本院 递交 上诉状 ， 并 按 对方 当事人 的 人数 提出 副本 ， 交纳 上诉 案件 受理费 ， 上诉 于 广安市 中级 人民法院 。 审判员 王长林 二 〇 一 六年 三月 八日 

李某与李某甲离婚纠纷一审民事判决书.txt	不准 原告 李 某某 与 被告 李某 甲 离婚 。 

李某与王某某离婚纠纷一审民事裁定书.txt	驳回 原告 李某 的 起诉 。 如 不服 本 裁定 ， 可 在 裁定书 送达 之日起 十日 内 ， 向 本院 递交 上诉状 ， 并 按 对方 当事人 的 人数 提出 副本 ， 上诉 于 达州市 中级 人民法院 。 

李某与程某某离婚纠纷一审民事判决书.txt	不准 原告 李某 与 被告 程 某某 离婚 。 

李某与赵某离婚纠纷一审民事判决书.txt	不准 原告 李 某某 与 被告 赵 某某 离婚 。 

李某与阿某某离婚纠纷一审民事判决书.txt	不准 原告 李某 与 被告 阿 某某 离婚 。 

李某与陈某离婚纠纷一审民事判决书.txt	不准 原告 李某 与 被告 陈某 离婚 。 

李某与陈某离婚纠纷一审民事裁定书.txt	准许 原告 李某 撤回 起诉 。 

李某冬与李某芳离婚纠纷一审民事判决书.txt	本案 按 自动 撤诉 处理 。 

李某某与付某甲离婚纠纷案一审民事判决书.txt	不准 原告 李 某某 与 被告 付某 甲 离婚 。 

李某某与任某某离婚纠纷一审民事判决书.txt	准予 原告 李 某某 与 被告 任 某某 离婚 ； 二 、 原 、 被告 共同 生育 之 子 任 某 甲 （ 2011 年 2 月 14 日 ） 由 被告 任 某某 抚养 。 

李某某与兰某某离婚纠纷一审民事判决书.txt	准许 原告 李 某某 与 被告 兰 某某 离婚 。 

李某某与刘某某离婚纠纷一审民事判决书.txt	不准 原告 李 某某 与 被告 刘 某某 离婚 。 

李某某与刘某甲离婚纠纷一审民事判决书.txt	不准 原告 李某甲 与 被告 刘某 甲 离婚 。 

李某某与周某甲离婚纠纷一审民事判决书.txt	不准 原告 李 某某 与 被告 周某 甲 离婚 。 

李某某与姜某甲离婚纠纷案一审民事判决书.txt	不准 原告 李 某某 与 被告 姜某 甲 离婚 。 

李某某与孟某甲离婚纠纷一审民事判决书.txt	准予 原告 李 某某 与 被告 孟某 甲 离婚 ； 二 、 次女 孟某丙 由 原告 李 某某 抚养 ， 长女 孟某乙 由 被告 孟某 甲 抚养 ， 抚养费 各自 承担 。 

李某某与宋某某离婚纠纷一审民事判决书.txt	一 、 准许 原告 李 某某 与 被告 宋 某某 离婚 ； 二 、 婚 生长 女 杨某乙 由 被告 宋 某某 抚养 ， 原告 李 某某 从 2016 年 1 月 1 日 起 按 每月 400 元 的 标准 每半年 支付 一次 抚养费 ， 直至 杨某 乙 年满 18 周岁 止 ； 三 、 由 原告 李 某某 向 被告 宋 某某 补偿 1.5 万元 ； 四 、 原告 李 某某 与 被告 宋 某某 的 夫妻 共同财产 即 位于 朝天区 两河口 乡 杨家村 6 组 的 木结构 平房 四间 及 小牛 一头 归 被告 宋 某某 所有 ； 五 、 夫妻 共同 债务 即 在 广元市 朝天区 农村 信用联社 两河口 信用社 的 贷款 本金 3 万元 及其 利息 由 原告 李 某某 与 被告 宋 某某 各自 承担 一半 （ 具体 利息 根据 信用社 的 结算 确定 ） ； 六 、 驳回 原告 李 某某 的 其他 诉讼请求 。 上述 第三 、 五项 判决 ， 限 在 本 判决 生效 后 十日 内 履行 。 

李某某与徐某某离婚纠纷一审民事判决书.txt	不 准予 原告 李 某某 与 被告 徐 某某 离婚 。 

李某某与王某某离婚纠纷一审民事判决书.txt	准予 原告 李 某某 与 被告 王 某某 离婚 。 

李某某与肖某某离婚纠纷一审民事判决书.txt	不 准许 原告 李 某某 与 被告 肖 某某 离婚 。 

李某某与肖甲离婚纠纷一审民事判决书.txt	不 准予 原告 李 某某 与 被告 肖甲 离婚 。 

李某某与胡某甲离婚纠纷一审民事判决书.txt	原告 李 某某 诉 与 被告 胡某 甲 离婚 ， 不予 准许 。 

李某某与莫某甲离婚纠纷一审民事判决书.txt	一 、 准予 原告 李 某某 与 被告 莫某 甲 离婚 ； 二 、 原 、 被告 婚生女 莫某乙 由 被告 莫某 甲 抚养 ， 由 原告 李 某某 自 2016 年 3 月 起 每月 给付 被告 莫某 甲 子女 抚养费 300 元 至 莫某 乙 年满 18 周岁 止 ； 如果 未 按 本 判决 指定 的 期间 给付 金钱 义务 ， 应当 依照 《 中华人民共和国 民事 诉讼法 》 第 二百五十 三条 之 规定 ， 加倍 支付 迟延 履行 期间 的 债务 利息 。 

李某某与蒋某某离婚纠纷一审民事判决书.txt	不 准予 原告 李 某某 与 被告 蒋 某某 离婚 。 

李某某与薛某某离婚纠纷一审民事判决书.txt	一 、 准许 原告 李 某某 与 被告 薛 某某 离婚 ； 二 、 被告 薛 某某 每月 给付 婚生子 薛某 乙 抚养费 500 元 ， 至 婚生子 薛某 乙 完成学业 止 ； 三 、 驳回 原告 其它 诉讼请求 。 

李某某与许某某离婚纠纷一审民事判决书.txt	一 、 准予 原告 李 某某 与 被告 许 某某 离婚 ； 二 、 原告 李 某某 婚前 财产 ： 电脑 、 洗衣机 、 空调 、 热水器 各 一台 ， 冰箱 、 电磁炉 各 一个 、 麻将桌 一张 、 椅子 四 把 、 电饭锅 一个 、 衣柜 一架 、 摩托车 一辆 、 书桌 一张 、 电热水壶 一个 、 电话 座机 一部 归 原告 李 某某 所有 ； 三 、 家庭 共同财产 ： 床 一架 、 梳妆 桌 一张 、 床上用品 一套 ， 归 被告 许 某某 所有 。 

李某某与陈某某离婚纠纷一审判决书.txt	不准 原告 李 某某 与 被告 陈某 甲 离婚 。 

李某某与陈某甲离婚纠纷一审民事判决书.txt	不 准予 原告 李 某某 与 被告 陈某 甲 离婚 。 

李某某与马某甲离婚纠纷一案一审民事判决书.txt	一 、 准予 原告 李 某某 与 被告 马某 甲 离婚 ； 二 、 孩子 马某乙 由 被告 马某 甲 抚养 ， 马某丙 由 原告 抚养 。 

李某某与黄某甲离婚纠纷一审民事判决书.txt	不准 原告 李 某某 与 被告 黄某 甲 离婚 。 

李某某与黄某甲离婚纠纷案一审民事判决书.txt	不准 原告 李 某某 与 被告 黄某 甲 离婚 。 

李某某芬诉袁某离婚纠纷一审民事判决书.txt	不准 原告 李 某某 与 被告 袁某 离婚 。 

李某某诉周某某离婚纠纷民事一审判决书.txt	不 准予 原告 李 某某 与 被告 周 某某 离婚 。 

李某某诉曹某甲离婚纠纷一审民事判决书.txt	准予 原告 李 某某 与 被告 曹某 甲 离婚 ； 婚生女 曹某丙 由 被告 曹某 甲 抚养 ， 原告 李 某某 自 2016 年 4 月 起 每月 5 日前 支付 抚养费 300 元 ， 至 曹某 丙 18 周岁 止 。 

李某某诉王某某离婚纠纷一审判决书.txt	不 准予 原告 李 某某 与 被告 王 某某 离婚 。 

李某某诉王某某离婚纠纷判决书.txt	不 准予 原告 李 某某 与 被告 王某 甲 离婚 。 

李某某诉罗某某离婚纠纷一审判决书.txt	不准 原告 李 某某 与 被告 罗 某某 离婚 。 

李某某诉胡某某离婚纠纷一审民事判决书.txt	不 准予 原告 李 某某 与 被告 胡 某某 离婚 。 

李某某诉陈某某离婚纠纷一审民事判决书.txt	一 、 准予 原告 李 某某 与 被告 陈 某某 离婚 。 二 、 婚生女 陈丽某 乙 随 原告 生活 ， 被告 自 2016 年 3 月 起 每月 给付 原告 子女 抚养费 296 元 至 陈丽某 乙 年满 18 周岁 止 ， 此款 每月 支付 一次 ， 定于 每月 28 日前 支付 。 三 、 婚姻关系 存续 期间 夫妻 共同财产 : 位于 会东县 姜州镇 建设 村 3 组土 木结构 房屋 5 间 ， 其中 正房 3 间 归 原告 李 某某 所有 ， 厢房 2 间 归 被告 陈 某某 所有 。 四 、 驳回 原告 李 某某 其他 诉讼请求 。 

李某波与邓某燕离婚纠纷一审民事判决书.txt	不 准予 原告 李某波 与 被告 邓某燕 离婚 。 

李某甲与冯某甲离婚纠纷一审民事判决书.txt	一 、 准予 原告 李某甲 与 被告 冯某 甲 离婚 ； 二 、 女儿 李某丙 随 原告 李某 甲 生活 ； 从 本 判决 生效 之日起 至 李某 丙 独立 生活 时 止 ， 被告 冯某 甲 每月 承担 李某 丙 400 元 的 生活费 ， 凭 有效 票据 承担 李某 丙 一半 的 教育费 和 医疗费 ； 被告 冯某 甲 应于 每年 12 月 31 日前 跟 原告 李某 甲 结清 自己 当年 应 承担 的 前述 子女 抚养费 。 

李某甲与刘某甲离婚纠纷一审民事判决书.txt	不准 原告 李某甲 与 被告 刘某 甲 离婚 。 

李某甲与卢某某离婚纠纷一审判决书.txt	一 、 准许 原告 李某甲 与 被告 卢 某某 离婚 ； 二 、 婚生子 李某乙 由 被告 卢 某某 抚养 ， 由 原告 李某甲 在 本 判决 生效 之日起 每月 月底 之前 给付 800 元 的 抚育费 ， 至 李某 乙 年满 十八周岁 时 止 。 如果 未 按 本 判决 指定 的 期间 履行 给付 金钱 义务 ， 应当 依照 《 中华人民共和国 民事 诉讼法 》 第 二百五十 三条 之 规定 ， 加倍 支付 迟延 履行 期间 的 债务 利息 。 

李某甲与周某某离婚纠纷一审民事判决书.txt	不 准予 原告 李某甲 与 被告 周 某某 离婚 。 

李某甲与李某乙离婚纠纷一审民事判决书.txt	不 准予 原告 李某甲 与 被告 李某 乙 离婚 。 

李某甲与欧某某离婚纠纷案一审民事判决书.txt	一 、 准许 原告 李某甲 与 被告 欧 某某 离婚 ； 二 、 子李某 乙 、 女 李某丙 随 原告 李某 甲 生活 ； 三 、 驳回 原告 李某 甲 本案 的 其他 诉讼请求 。 

李某甲与被告李某乙离婚纠纷一审民事裁定书.txt	准许 原告 李某 甲 撤回 起诉 。 

李某甲与谢某某离婚纠纷一审民事判决书.txt	原告 李某 甲 诉 与 被告 谢 某某 离婚 ， 不予 准许 。 

李某甲与黄某某离婚纠纷一案一审民事判决书.txt	一 、 准许 原告 李某甲 与 被告 黄 某某 离婚 。 二 、 夫妻 婚生女 中 ， 次女 李某丙 由 原告 李某 甲 自行 抚养 ， 长女 叫 李某乙 由 被告 黄 某某 自行 抚养 ， 原 、 被告 互不 给付 子女 抚养费 。 三 、 夫妻 共同财产 归 被告 黄 某某 所有 。 三 、 夫妻 共同 债务 10000 元 ， 由 原 、 被告 平均 负担 。 四 、 驳回 原告 李某 甲 的 其他 诉讼请求 。 

李某甲诉李某乙离婚纠纷一审民事判决书.txt	不准 原告 李某甲 与 被告 李某 乙 离婚 。 

李某甲诉陈某甲离婚纠纷一审民事判决书.txt	不准 原告 李某甲 与 被告 陈某 甲 离婚 。 

李某诉夏某离婚纠纷判决书.txt	不 准予 原告 李某 与 被告 夏某 离婚 。 

李甲与徐某离婚纠纷案一审民事判决书.txt	不 准予 原告 李 某某 与 被告 徐 某某 离婚 。 

李良伟与雷东梅离婚纠纷一案民事判决书.txt	一 、 准许 李良伟 与 雷东梅 离婚 ； 二 、 李良伟 与 雷东梅 婚生 男孩 李 某某 （ 2013 年 6 月 18 日 出生 ） 由 李良伟 抚养 。 

杜某某与于某某离婚纠纷一审民事判决书.txt	不准 原告 杜 某某 与 被告 于 某某 离婚 。 

杜某某与罗某甲离婚纠纷一案一审民事判决书.txt	不准 原告 杜 某某 与 被告 罗某 甲 离婚 。 

杜某某与袁某某离婚纠纷一审民事判决书.txt	一 、 准予 原告 杜 某某 与 被告 袁 某某 离婚 。 二 、 驳回 原告 杜 某某 的 其他 诉讼请求 。 

杜某某与郑某某离婚纠纷一案二审民事裁定书.txt	准许 上诉人 杜 某某 撤回 上诉 。 

杜某某诉何某某离婚纠纷一审民事裁定书.txt	本案 按 撤诉 处理 。 

杜某某诉牟某甲离婚纠纷判决书.txt	不 准予 原告 杜 某某 与 被告 牟某 甲 离婚 。 

杜某甲与田某某离婚纠纷一审民事判决书.txt	一 、 准许 原告 杜某甲 与 被告 田 某某 离婚 ； 二 、 原 、 被告 女儿 杜某乙 随 原告 杜某 甲 生活 ， 由 原告 自行 抚养 。 

杨光仙诉彭代金离婚纠纷一审民事判决书.txt	一 、 准予 原告 杨 某某 与 被告 彭 某某 离婚 ； 二 、 坐落于 内江市 东兴区 太 安乡 经藏村 8 组 27 号 5 间 砖混 结构 小青瓦 房 5 间 （ 产权证 在 换证 中 ） 归 被告 彭 某某 所有 。 

杨小莉与陈阆离婚纠纷一审民事判决书.txt	一 、 准许 原告 杨 某某 与 被告 陈某 离婚 。 二 、 原 、 被告 婚生女 杨 某某 随 原告 杨 某某 生活 ， 被告 陈某 从 2016 年 5 月 起 每月 给付 小孩 生活费 500 元 至 小孩 独立 生活 时 止 ， 小孩 的 教育 、 医疗 费用 凭 有效 票据 由 原 、 被告 各 承担 一半 。 

杨晓龙与刘彩玉离婚纠纷一审民事判决书.txt	不 准予 原告 杨 某某 与 被告 刘 某某 离婚 。 

杨某与刘某离婚纠纷一审民事判决书.txt	不准 原告 杨某 与 被告 刘某 离婚 。 

杨某与吴某某离婚纠纷一审民事判决书.txt	一 、 原告 杨某 与 被告 吴 某某 离婚 ； 二 、 婚生女 吴某甲 由 原告 杨某 抚养 。 

杨某与夏某某离婚纠纷一审民事裁定书.txt	准许 原告 杨某 撤回 对 被告 夏某 甲 的 起诉 。 

杨某与廖某某离婚纠纷案一审民事判决书.txt	杨某 与 廖 某某 离婚 。 

杨某与成某某离婚纠纷一审民事判决书.txt	不 准予 原告 杨某 与 被告 成 某某 离婚 。 

杨某与李某离婚纠纷一审民事判决书.txt	原告 杨某 要求 与 被告 李某 离婚 ， 不予 准许 。 

杨某与陈某离婚纠纷一审民事判决书.txt	一 、 准予 原告 杨某 与 被告 陈某 离婚 ； 二 、 婚生 次子 杨甲 由 原告 杨某 抚养 。 

杨某会与李某离婚纠纷一审民事判决书.txt	不 准许 原告 杨某 会 与 被告 李某 离婚 。 

杨某某与冯某某离婚纠纷一审民事判决书.txt	原告 杨 某某 要求 与 被告 冯 某某 离婚 ， 本院 不予 准许 。 

杨某某与司某离婚纠纷一审民事判决书.txt	不予 准许 原告 杨 某某 与 被告 司某 离婚 。 

杨某某与孙某某离婚纠纷案一审民事判决书.txt	不准 原告 杨 某某 与 被告 孙 某某 离婚 。 

杨某某与张某某离婚纠纷一审民事判决书.txt	不 准许 原告 杨 某某 与 被告 张 某某 离婚 。 

杨某某与彭某某离婚纠纷案一审民事判决书.txt	不准 原告 杨 某某 与 被告 彭 某某 离婚 。 

杨某某与李某某离婚纠纷一审民事判决书.txt	准予 原告 杨 某某 与 被告 李 某某 离婚 。 在 本 判决 发生 法律效力 前 ， 当事人 双方 不得 另行 结婚 。 

杨某某与李某某离婚纠纷民事一审判决书.txt	不 准予 原告 杨 某某 与 被告 李 某某 离婚 。 

杨某某与李某甲离婚一审民事判决书.txt	不准 原告 杨 某某 与 被告 李某 甲 离婚 。 

杨某某与李某甲离婚纠纷一审民事判决书.txt	不 准予 原告 杨 某某 与 被告 李某 甲 离婚 。 

杨某某与李某离婚纠纷一审民事判决书.txt	一 、 准予 原告 杨 某某 与 被告 李某 离婚 ； 二 、 婚生子 李某 甲 随 被告 李某 生活 ， 原告 杨 某某 于 本 判决 生效 之日起 每月 10 日前 支付 婚生子 李某 甲 当月 生活费 400 元 ， 婚生子 李某 甲 的 教育费 、 医疗费 凭 票据 由 原告 杨 某某 与 被告 李某 各 承担 50 % ， 至 婚生子 李某 甲 独立 生活 止 ； 三 、 驳回 原告 杨 某某 的 其他 诉讼请求 。 

杨某某与潘某某离婚纠纷一审民事判决书.txt	不 准予 原告 杨 某某 与 被告 潘某 甲 离婚 。 

杨某某与王某某离婚纠纷一审民事判决书.txt	不 准予 原告 杨 某某 与 被告 王 某某 离婚 。 

杨某某与王某甲离婚纠纷一审民事判决书.txt	不准 原告 杨 某某 与 被告 王某 甲 离婚 。 

杨某某与窦某甲离婚纠纷一审民事判决书.txt	不准 原告 杨 某某 与 被告 窦某 甲 离婚 。 

杨某某与罗某离婚纠纷一审民事判决书.txt	原告 杨 某某 要求 与 被告 罗某 离婚 ， 本院 不予 准许 。 

杨某某与翟某甲离婚纠纷一审民事判决书.txt	一 、 杨 某某 与 翟某 甲 离婚 。 二 、 婚生子 翟某 丁 （ 16 周岁 ） 由 杨 某某 抚养 。 三 、 夫妻 共同财产 楼房 一楼 一底 2 间 归 翟某 甲 所有 。 四 、 杨 某某 给予 翟某 甲 经济 帮助 人民币 8000 元 ， 限 判决 生效 后 立即 付清 。 

杨某某与陈某某离婚纠纷案一审民事判决书.txt	不 准予 原告 杨 某某 与 被告 陈 某某 离婚 。 

杨某某与鲜某某离婚纠纷一审民事判决书.txt	不 准予 原告 杨 某某 与 被告 鲜 某某 离婚 。 

杨某某诉梁某离婚纠纷一审判决书.txt	准予 原告 杨 某某 与 被告 梁某 离婚 。 

杨某某诉王某离婚纠纷一审民事判决书.txt	一 、 准予 原告 杨 某某 与 被告 王某 离婚 ； 二 、 婚生 女王 某 甲 （ 2009 年 9 月 21 日 ） 跟随 原告 杨 某某 生活 ， 并 由其 抚养 至 十八周岁 时 为止 ； 婚生子 王某 乙 （ 生于 2011 年 9 月 26 日 ） 跟随 被告 王某 生活 ， 并 由其 抚养 至 十八周岁 时 止 ， 原 、 被告 各自 承担 抚养费 。 

杨某某诉蒲某甲离婚纠纷一案民事判决书.txt	一 、 准许 原告 杨 某某 与 被告 蒲某 甲 离婚 ； 二 、 原 、 被告 之 婚生子 蒲某乙 由 被告 蒲某 甲 抚养 ， 原告 杨 某某 从 本 判决 生效 之 当月 起 每月 向 被告 蒲某 甲 支付 婚生子 蒲某乙 的 抚养费 400 元 ， 直至 蒲某 乙 年满 十八周岁 止 。 

杨某甲与向某甲离婚纠纷一审民事判决书.txt	一 、 准予 原告 杨某甲 与 被告 向 某 甲 离婚 ； 二 、 婚生 次女 向某乙 由 原告 杨某 甲 抚养 ， 婚生 三女 向 某 丙由 被告 向 某 甲 抚养 ， 由 原告 杨某甲 于 本 判决 生效 之日起 十日 内 一次性 支付 其三 女向 某 丙 21 个 月 的 抚养费 6300 元 ； 三 、 家庭 共有 财产 位于 安岳县 周礼 镇 荷花 村 6 组 的 砖瓦房 4 间 ， 正 对 大门 左侧 2 间 由 归 被告 向 某 甲 所有 ， 其余 2 间 房屋 归 原告 及 原告 之 父亲 杨某 丙 所有 。 如果 未 按 本 判决 指定 的 期间 履行 给付 金钱 义务 ， 应当 依照 《 中华人民共和国 民事 诉讼法 》 第 二百五十 三条 之 规定 ， 加倍 支付 迟延 履行 期间 的 债务 利息 。 

杨某甲与李某某离婚纠纷一审民事判决书.txt	不 准予 原告 杨某甲 与 被告 李 某某 离婚 。 

杨某甲与李某某离婚纠纷案一审民事判决书.txt	准许 原告 杨某甲 与 被告 李 某某 离婚 。 

杨某甲与李某离婚纠纷一审民事判决书.txt	不 准予 原告 杨某甲 与 被告 李某 离婚 。 

杨某甲与贾某甲离婚纠纷一审民事判决书.txt	不准 原告 杨某甲 与 被告 贾某 甲 离婚 。 

杨某诉朱某某离婚纠纷一审民事判决书.txt	一 、 准予 原告 杨某 与 被告 朱 某某 离婚 。 二 、 原被告 婚生女 朱某甲 由 原告 杨某 负责 抚养 ， 自 2016 年 4 月 起 ， 被告 朱 某某 每月 给付 抚养费 800 元 ， 至 朱某 甲 独立 生活 止 。 三 、 驳回 原告 杨某 的 其它 诉讼请求 。 

杨某诉陈某某离婚纠纷一案一审民事判决书.txt	不准 原告 杨某 与 被告 陈 某某 离婚 。 

杨泽英与程昌荣离婚纠纷案一审民事判决书.txt	不准 原告 杨某 与 被告 程某 离婚 。 

杨甲某某与张某某离婚纠纷一审民事判决书.txt	一 、 准予 杨甲 某某 与 张 某某 离婚 ； 二 、 婚生子 杨乙 某某 由 杨甲 某某 抚养 ， 抚养费 自负 ； 三 、 杨甲 某某 于 本 判决 生效 之日起 十日 内 一次性 给付 张 某某 经济 补助费 20000 元 ； 如果 未 按 本 判决 指定 的 期间 履行 给付 金钱 义务 ， 应当 依照 《 中华人民共和国 民事 诉讼法 》 第 二百五十 三条 之 规定 ， 加倍 支付 迟延 履行 期间 的 债务 利息 。 

杨红与吴维离婚纠纷案一审民事判决书.txt	不准 原告 杨某 与 被告 吴某 离婚 。 

林某某与侯某某离婚纠纷一审民事判决书.txt	不 准予 原告 林 某某 与 被告 侯 某某 离婚 。 

林某某与倪某某离婚纠纷一审民事判决书.txt	不 准予 原告 林 某某 与 被告 倪 某某 离婚 。 

林某某与向某某离婚纠纷一审民事判决书.txt	不 准许 原告 林 某某 与 被告 向 某某 离婚 。 

林某某与吴某甲离婚纠纷一审民事判决书.txt	一 、 准予 原告 林 某某 与 被告 吴某 甲 离婚 。 二 、 原告 林 某某 在 本 判决 生效 后 一次性 给付 被告 吴某 甲 经济 帮助 人民币 2 万元 整 。 

桑某某诉何某某离婚纠纷一审判决书.txt	准予 原告 桑 某某 与 被告 何 某某 离婚 。 两 婚生女 随 被告 何 某某 生活 ， 原告 桑 某某 每月 给付 两 女 何某 甲 、 何某 乙 抚养费 各 400 元 至 其 十八周岁 止 。 

梁某与柳某甲离婚纠纷一审民事判决书.txt	驳回 原告 梁某 的 诉讼请求 。 案件 受理费 150 元 ， 由 原告 梁某 负担 。 如 不服 本 判决 ， 可 在 判决书 送达 之日起 十五日 内 ， 向 本院 递交 上诉状 ， 并 按 对方 当事人 的 人数 提出 副本 ， 交纳 上诉 案件 受理费 ， 上诉 于 广安市 中级 人民法院 。 审判员 钱 嫄 二 〇 一 六年 三月 十四日 

梁某与陈某离婚纠纷一审民事判决书.txt	一 、 准予 原告 梁某 与 被告 陈某 离婚 ； 二 、 婚后 共同财产 有 洗衣机 一台 和 电饭煲 一台 ， 归 被告 陈某 所有 。 

梁某某与彭某某离婚纠纷一审民事判决书.txt	不准 原告 梁 某某 与 被告 彭某 甲 离婚 。 

梁某某与谢某某离婚纠纷一审民事判决书.txt	不 准予 原告 梁 某某 与 被告 谢 某某 离婚 。 

梁某某与贾某某离婚纠纷一审民事判决书.txt	不准 原告 梁 某某 与 被告 贾 某某 离婚 。 

梁某某与赵某某离婚纠纷一审民事判决书.txt	不 准许 原告 梁 某某 与 被告 赵 某某 离婚 。 

梁某某与雷某某离婚纠纷案一审民事判决书.txt	准予 原告 梁 某某 与 被告 雷 某某 离婚 。 

梁某某诉雷某某离婚纠纷一审民事判决书.txt	不准 原告 梁 某某 与 被告 雷 某某 离婚 。 

梁某甲与万某某离婚纠纷一审民事判决书.txt	不准 原告 梁某甲 与 被告 万 某某 离婚 。 

梁某甲与唐某某离婚纠纷一审民事判决书.txt	一 、 准予 原告 梁某甲 与 被告 唐 某某 离婚 ； 二 、 共同财产 即 位于 剑阁县 鹤龄镇 白鹤 村 的 立 木结构 房屋 三间 、 家用 农具 、 加工 机械 、 旋耕机 归 原告 梁某 甲 所有 。 

梅某某与王某离婚纠纷一审民事判决书.txt	准予 原告 梅 某某 与 被告 王某 离婚 。 

樊某某与江某某离婚纠纷一审民事判决书.txt	不准 原告 樊 某某 与 被告 江 某某 离婚 。 

欧某某与张某某离婚纠纷一审民事判决书.txt	原告 欧 某某 诉请 与 被告 张 某某 离婚 ， 本院 不 准予 离婚 。 

段某某与杨某某离婚纠纷一审民事裁定书.txt	本案 按 原告 段 某某 撤诉 处理 。 

段某某与陈某离婚纠纷一审民事判决书.txt	不予 准许 原告 段 某某 与 被告 陈某 离婚 。 

母某某与赵某某离婚纠纷一审民事裁定书.txt	本案 按 撤诉 处理 。 

母某甲与姜某甲离婚纠纷一审民事判决书.txt	准予 原告 母某甲 与 被告 姜某 甲 离婚 。 

母某甲与杨某某离婚纠纷一审民事判决书.txt	一 、 准予 原告 母某甲 与 被告 杨 某某 离婚 二 、 婚生子 母某 乙 、 母某 丙 跟随 原告 母某 甲 生活 ， 被告 杨 某某 每月 支付 子母某 乙 、 母某 丙 生活费 各 300 元 ， 教育 、 医疗费 凭票 原 、 被告 每年 各 承担 一半 ， 至 子 独立 生活 时 止 。 上述 费用 每年 12 月 30 日前 结清 ； 三 、 被告 杨 某某 于 判决 生效 后 十日 内 给付 原告 母某 甲 经济 补偿 费用 15000 元 。 在 本 判决 发生 法律效力 前 ， 原 、 被告 不得 另行 结婚 。 

毛某某与冯某某离婚纠纷一事民事裁定书.txt	本案 按 撤诉 处理 。 

毛某某与李某甲离婚纠纷一审民事判决书.txt	不 准予 原告 毛 某某 与 被告 李某 甲 离婚 。 

毛某某诉黄某甲离婚纠纷一审民事判决书.txt	不 准予 原告 毛 某某 与 被告 黄某 甲 离婚 。 

江某某与张某甲离婚纠纷一审民事判决书.txt	一 、 准予 原告 江 某某 与 被告 张某 甲 离婚 ； 二 、 婚生女 张某乙 由 原告 江 某某 抚养 教育 ， 被告 张某 甲 每月 支付 张某 乙 生活费 600 元 ， 张某乙 的 教育费 、 医疗费 凭 票据 由 原 、 被告 各 承担 一半 ， 上述 费用 支付 至 张某 乙 独立 生活 时 止 ， 并 于 每年 12 月 31 日前 结清 当年 费用 。 

江某琼与赵某离婚纠纷一审民事判决书.txt	不 准予 原告 江某琼 与 被告 赵某 离婚 。 

江某诉陈某某离婚纠纷一审民事判决书.txt	不准 原告 江某 与 被告 陈 某某 离婚 。 

汤某某与何某某离婚后财产纠纷一审民事判决书.txt	何 某某 于 本 判决 生效 后 五日 内 一次性 向 汤 某某 支付 欠款 60000 元 ， 并 支付 逾期 违约金 8100 元 ， 合计 68100 元 。 如果 未 按 本 判决 指定 的 期间 履行 给付 金钱 义务 ， 应当 依照 《 中华人民共和国 民事 诉讼法 》 第 二百五十 三条 之 规定 ， 加倍 支付 迟延 履行 期间 的 债务 利息 。 

汤某某与高某甲离婚纠纷一审民事判决书.txt	一 、 准予 原告 汤 某某 与 被告 高某 甲 离婚 ； 二 、 婚生子 高某丙 随 被告 高某 甲 生活 ， 女高某 乙 随 原告 汤 某某 生活 ， 至 独立 生活 时 止 ； 原 、 被告 有权 探视 随 对方 生活 之 小孩 ， 对方 应予 协助 ； 三 、 自 2016 年 4 月 起 ， 原告 汤 某某 每月 向 被告 高某 甲 支付 小孩 抚育费 500 元 ， 被告 高某 甲 每月 向 原告 汤 某某 支付 小孩 抚育费 500 元 ， 至 小孩 独立 生活 时 止 。 

汤某甲与何某某离婚纠纷一审民事判决书.txt	不 准予 原告 汤某甲 与 被告 何 某某 离婚 。 

汪某与彭某某离婚纠纷一审民事判决书.txt	不 准予 原告 汪某 与 被告 彭 某某 离婚 。 

汪某某与黄某某离婚纠纷案一审民事判决书.txt	不 准予 原告 汪 某某 与 被告 黄 某某 离婚 。 

汪某某诉王某某离婚纠纷一审民事判决书.txt	不准 原告 汪 某某 与 被告 王 某某 离婚 。 

汪某某诉被告陈某甲离婚纠纷一审民事判决书.txt	不 准许 原告 汪 某某 与 被告 陈某 甲 离婚 。 

汪翠蓉与陈建平离婚纠纷一审民事判决书.txt	不 准予 原告 汪 某某 与 被告 陈 某某 离婚 。 

滕某与庞某甲离婚纠纷一审民事判决书.txt	不 准予 原告 滕某 与 被告 庞某 甲 离婚 。 

滕某某与唐某甲离婚纠纷一审民事判决书.txt	准予 原告 滕 某某 与 被告 唐某 甲 离婚 。 

滕某某与李某某离婚纠纷案一审民事判决书.txt	一 、 滕 某某 与 李 某某 离婚 。 二 、 现有 夫妻 共同财产 归 李 某某 所有 。 

潘某与叶某离婚纠纷一审民事判决书.txt	不准 原告 潘某 与 被告 叶某 离婚 。 

潘某与黎某某离婚纠纷一审民事判决书.txt	准予 原告 潘某 与 被告 黎 某某 离婚 。 

潘某某与刘某某离婚纠纷案一审民事判决书.txt	不 准予 原告 潘 某某 与 被告 刘 某某 离婚 。 

焦某某与王某某离婚纠纷一审民事判决书.txt	不准 原告 焦 某某 与 被告 王 某某 离婚 。 

熊某某与张某甲离婚纠纷一审民事判决书.txt	不 准许 原告 熊 某某 与 被告 张某 甲 离婚 。 

熊某某与熊某明离婚纠纷一审民事判决书.txt	被告 熊某明 从 2016 年 4 月 起 每月 支付 原告 熊 某某 生活费 200 元 （ 支付 方式 为 ： 每年 12 月 31 日前 一次性 支付 当年 生活费 。 ） ， 教育费 、 住院 期间 医疗费 凭票 各 负担 一半 。 

熊某某与罗某离婚后财产纠纷一审民事判决书.txt	一 、 位于 达州市 达川 区 （ 原 达县 ） ＊ ＊ 镇 ＊ 村 ＊ 社 砖混 结构 房屋 一套 【 建筑面积 127.53 平方米 ， 房屋 所有权证 号 ： 达 权字 第 ＊ ＊ ＊ ＊ ＊ 号 ， 国有土地 使用证 号 ： 达国 用 （ ＊ ＊ ＊ ＊ ） 字 第 ＊ ＊ ＊ 号 】 归 原告 熊 某某 所有 ； 二 、 被告 罗某 协助 原告 熊 某某 办理 产权 过户 手续 。 

熊某某与胡某某离婚纠纷一审民事判决书.txt	不准 原告 熊 某某 与 被告 胡 某某 离婚 。 

熊某某与陈某某离婚纠纷一审民事判决书.txt	一 、 准许 原告 熊 某某 与 被告 陈 某某 离婚 ； 二 、 离婚 后 ， 婚生女 陈某甲 由 被告 陈 某某 抚养 并 承担 抚养费 ， 婚生子 陈某乙 由 原告 熊 某某 抚养 并 承担 抚养费 。 

牟某成与胡某碧离婚纠纷一审民事判决书.txt	原告 牟某 成 要求 与 被告 胡某 碧 离婚 ， 不予 准许 。 

牟某某与裴某某离婚纠纷一审民事判决书.txt	不 准予 原告 牟 某某 与 被告 裴 某某 离婚 。 

牟某某与龚甲某某离婚纠纷一审民事判决书.txt	一 、 准予 牟 某某 、 龚甲 某某 离婚 ； 二 、 婚生子 龚乙 某某 由 龚甲 某某 抚养 ， 牟 某某 从 2016 年 5 月份 开始 每月 支付 龚乙 某某 抚养费 500 元 ， 直至 其 年满 18 周岁 时 止 ； 三 、 驳回 牟 某某 的 其他 诉讼请求 ； 

王伟、王聪章、杨正芬与牟秀娟、牟进兴、潘华蓉离婚后财产纠纷一案二审民事判决书.txt	驳回上诉 ， 维持原判 。 

王光玉与任中禹离婚纠纷一审民事判决书.txt	不 准许 原告 王 某某 与 被告 任 某某 离婚 。 

王加亮与李秀熙离婚纠纷一审民事判决书.txt	不 准许 原告 王 某某 与 被告 李 某某 离婚 。 

王林与吴文胜离婚纠纷一审民事判决书.txt	不准 原告 王 某某 与 被告 吴某 甲 离婚 。 

王某与刘某离婚纠纷一审民事判决书.txt	原告 王某 要求 与 被告 刘某 离婚 ， 不予 准许 。 

王某与谢某离婚纠纷一审民事判决书.txt	一 、 准予 原告 王某 与 被告 谢某 离婚 ； 二 、 婚生 次子 谢某杰 由 原告 王某 直接 抚养 至 其 独立 生活 为止 ， 婚 生长 子谢甲 由 被告 谢某 直接 抚养 至 其 独立 生活 为止 ； 三 、 驳回 原告 王某 的 其他 诉讼请求 。 

王某与郑某离婚纠纷一审民事判决书.txt	不准 原告 王某 与 被告 郑某 离婚 。 

王某与郭某关于离婚纠纷一审民事判决书.txt	原告 王某 要求 与 被告 郭某 离婚 ， 不予 准许 。 

王某与雷某某离婚纠纷一审民事裁定书.txt	一 、 准予 原告 王某 与 被告 雷 某某 离婚 ； 二 、 婚生女 雷某甲 由 被告 雷 某某 抚养 ， 婚生女 雷某乙 由 原告 王某 抚养 ， 互不 承担 抚养费 。 原 、 被告 双方 应为 对方 探视 子女 提供方便 。 

王某与黄某某离婚纠纷一案一审民事判决书.txt	不 准予 原告 王某 与 被告 黄 某某 离婚 。 

王某全与刘某国离婚纠纷一审民事判决书.txt	一 、 准予 原告 王某全 与 被告 刘 某国 离婚 ； 二 、 驳回 原告 其他 诉讼请求 。 

王某某与何某离婚纠纷一审民事判决书.txt	准予 原告 王 某某 与 被告 何某 离婚 ； 

王某某与叶某某离婚纠纷一审民事判决书.txt	不 准予 原告 王 某某 与 被告 叶 某某 离婚 。 

王某某与吴某某离婚纠纷一审民事判决书.txt	不予 准许 原告 王 某某 与 被告 吴 某某 离婚 。 

王某某与吴某某离婚纠纷案一审民事判决书.txt	一 、 准予 原告 王 某某 与 被告 吴 某某 离婚 。 二 、 婚生女 吴某 甲 、 婚生子 吴某乙 由 被告 吴 某某 抚养 ， 原告 王 某某 每月 给付 吴某 甲 、 吴某 乙 子女 抚养费 各 300.00 元 ， 至 吴某 甲 、 吴某 乙 年满 十八周岁 时 止 。 三 、 原告 王 某某 一次性 给予 被告 吴 某某 经济 帮助 金 10000.00 元 （ 限 在 本 判决 生效 后 十日 内 付清 ） 。 在 本 判决 生效 前 ， 原 、 被告 不得 另行 结婚 。 

王某某与周某某离婚纠纷一审民事判决书.txt	不 准许 原告 王 某某 与 被告 周 某某 离婚 。 

王某某与孙某离婚纠纷一审民事判决书.txt	准予 原告 王 某某 与 被告 孙某 离婚 。 

王某某与寇某某离婚纠纷一审民事判决书.txt	一 、 准予 原告 王 某某 与 被告 寇 某某 离婚 ； 二 、 夫妻 共同财产 ： 原 、 被告 共同 所有 的 位于 盐亭县 五龙 乡 龙潭 村 砖瓦 结构 房屋 4 间 及 附房 2 间 ， 双方 自愿 赠与 婚生子 寇某 所有 ； 三 、 由 被告 寇 某某 于 2016 年 12 月 30 日前 支付 原告 王 某某 人民币 10000.00 元 ； 

王某某与张某某离婚纠纷一审民事判决书.txt	不 准许 原告 王 某某 与 被告 张 某某 离婚 。 

王某某与张某甲离婚纠纷一审民事判决书.txt	一 、 原告 王 某某 与 被告 张某 甲 离婚 ； 二 、 婚生女 张某乙 由 原告 王 某某 抚养 ， 被告 张某 甲 自 2016 年 5 月 起 每月 支付 婚生 女 生活费 500 元 ， 婚生女 张某乙 的 教育费 、 医疗费 由 原 、 被告 各 承担 一半 ， 上述 费用 限 每年 12 月 31 日前 结清 当年 费用 ； 三 、 夫妻 共同 债务 ： 梓潼 农商 银行 金 龙场 支行 贷款 10000 元 ， 由 原 、 被告 各 承担 一半 。 在 本 判决 发生 法律效力 前 ， 原 、 被告 不得 另行 结婚 。 

王某某与李某某离婚纠纷案一审民事判决书.txt	一 、 王 某某 与 李 某某 离婚 。 二 、 婚生子 王某乙 由 原告 抚养 ， 婚生 女王 某 甲 由 李 某某 抚养 ， 双方 互不 给付 子女 抚养费 。 三 、 由 原告 支付 被告 精神 损害 赔偿金 30000 元 四 、 驳回 原告 的 其它 诉讼请求 。 

王某某与李某甲离婚纠纷一审民事判决书.txt	准予 原告 王 某某 与 被告 李某 甲 离婚 ； 

王某某与梁某某离婚纠纷一审民事判决书.txt	不 准予 原告 王 某某 与 被告 梁 某某 离婚 。 

王某某与熊某某离婚纠纷案一审民事判决书.txt	一 、 王 某某 与 熊 某某 离婚 ； 二 、 由 王 某某 一次性 付给 熊 某某 经济 补偿费 6000 元 ， 此款 限 在 本 判决 生效 后 十日 内 付清 。 

王某某与罗某某离婚纠纷一审民事判决书.txt	准予 原告 王 某某 与 被告 罗 某某 离婚 。 

王某某与舒某某离婚纠纷一案一审民事判决书.txt	不 准予 原告 王 某某 与 被告 舒 某某 离婚 。 

王某某与许某某离婚纠纷一案一审民事判决书.txt	准予 王 某某 与 被告 许 某某 离婚 。 

王某某与谢某某离婚纠纷一审民事判决书.txt	原告 王 某某 要求 与 被告 谢 某某 离婚 ， 本院 不予 准许 。 

王某某与赵某某甲离婚纠纷一审民事判决书.txt	不准 原告 王 某某 与 被告 赵 某某 甲 离婚 。 

王某某与赵某某离婚后财产纠纷一审民事判决书.txt	由 被告 赵 某某 在 本 判决 生效 后 十五日 内 支付 原告 王 某某 5 万元 。 如果 未 按 本 判决 指定 的 期间 履行 给付 义务 ， 应当 依照 《 中华人民共和国 民事 诉讼法 》 第 二百五十 三条 之 规定 ， 加倍 支付 迟延 履行 期间 的 债务 利息 。 

王某某与邓某某离婚纠纷一审民事判决书.txt	准予 原告 王 某某 与 被告 邓 某某 离婚 ； 

王某某与马某甲离婚纠纷一审民事判决书.txt	不准 原告 王 某某 与 被告 马某 甲 离婚 。 

王某某与黄某某离婚纠纷一审民事判决书.txt	不予 准许 原告 王 某某 与 被告 黄 某某 离婚 。 

王某某甲与杨某某离婚纠纷一审民事判决书.txt	不准 原告 王 某某 甲 与 被告 杨 某某 离婚 。 

王某某诉代某某离婚纠纷一审判决书.txt	不准 原告 王 某某 与 被告 代 某某 离婚 。 

王某某诉崔某甲离婚纠纷一审民事判决书.txt	不准 王 某某 与 崔某 甲 离婚 。 

王某某诉张某离婚纠纷一审民事判决书.txt	不准 原告 王 某某 与 被告 张某 离婚 。 

王某某诉李某某离婚纠纷一审民事判决书.txt	不 准予 原告 王 某某 与 被告 李 某某 离婚 ； 

王某某诉李某甲离婚纠纷一审民事判决书.txt	不 准予 原告 王 某某 与 被告 李某 甲 离婚 。 

王某某诉杜某甲离婚纠纷判决书.txt	一 、 准予 原告 王 某某 与 被告 杜某 甲 离婚 。 二 、 共同 修建 土 木结构 房屋 一间 及 猪圈 两间 归 被告 杜某 甲 所有 。 

王某某诉王某甲离婚纠纷一案一审民事判决书.txt	不准 原告 王 某某 与 被告 王某 甲 离婚 。 

王某某诉袁某某离婚纠纷一审民事判决书.txt	一 、 准予 原告 王 某某 与 被告 袁 某某 离婚 ； 二 、 婚生子 袁某 甲 随 原告 王 某某 生活 。 

王某某诉雷某离婚纠纷一审民事判决书.txt	不 准予 原告 王 某某 与 被告 雷某 离婚 ； 

王某波与李某离婚纠纷一审民事判决书.txt	原告 王某波 要求 与 被告 李某 离婚 ， 不予 准许 。 

王某甲与易某甲离婚纠纷民事判决书.txt	不予 准许 原告 王某甲 与 被告 易某 甲 离婚 。 

王某甲与王某乙离婚后财产纠纷一审民事判决书.txt	被告 王某乙 在 本 判决 发生 法律效力 之日起 十日 内 支付 原告 王某 甲 欠款 50000 元 。 如果 被告 王某 乙未 按 本 判决 指定 的 期间 履行 给付 金钱 义务 ， 应当 依照 《 中华人民共和国 民事 诉讼法 》 第 二百五十 三条 之 规定 ， 加倍 支付 迟延 履行 期间 的 债务 利息 。 

王某甲与王某乙离婚纠纷一审民事判决书.txt	一 、 准许 原告 王某甲 与 被告 王某 乙 离婚 ； 二 、 原告 王某甲 与 被告 王某 乙婚生 女 ， 王某 丙 ， 现年 七岁 。 由 原告 王某 甲 抚养 ， 被告 王某乙 按 月 300 元 支付 小孩 的 抚养费 至 小孩 独立 生活 时 止 。 三 、 被告 王某乙 的 婚前 财产 ： Ｄ Ｖ Ｄ 音响 一套 、 洗衣机 一个 、 冰箱 一台 、 饮水机 一个 、 皮箱 一口 归王某 乙 所有 。 四 、 原告 王某甲 与 被告 王某乙 在 婚姻 存续 期间 的 共同财产 ， 其中 原 、 被告 在 浙江 务工 时 购买 有 联想 电脑 一台 、 格力 变频空调 一台 、 洗衣机 一台 、 电瓶车 一辆 ， 归 被告 王某 乙 所有 。 二 0 一 三年 购买 的 踏板 摩托车 一辆 归 原告 王某 甲 所有 。 五 、 原告 王某甲 与 被告 王某乙 在 婚姻 存续 期间 在 永宁 信用社 的 贷款 五万元 及 利息 ， 各 承担 偿还 二万五千 及 利息 。 六 、 原告 王某 甲 付 被告 王某 乙 生活 帮助 费 三万元 。 限 在 本 判决书 生效 后 的 十日 内 履行 。 如果 未 按照 本 判决 指定 的 期间 履行 给付 金钱 义务 ， 应当 依照 《 中华人民共和国 民事 诉讼法 》 第 二百五十 三条 之 规定 ， 加倍 支付 迟延 履行 期间 的 债务 利息 。 

王某甲与王甲离婚纠纷一案一审民事判决书.txt	不准 原告 王某甲 与 被告 王甲 离婚 。 

王某甲与石某离婚纠纷一审民事判决书.txt	不准 原告 王某甲 与 被告 石某 离婚 。 

王某甲与童某某离婚纠纷一审民事判决书.txt	不 准予 原告 王某甲 与 被告 童 某某 离婚 。 

王某甲与罗某某离婚纠纷一审民事判决书.txt	不 准许 原告 王某甲 与 被告 罗 某某 离婚 。 

王某甲与邓某某离婚纠纷一审民事判决书.txt	不准 原告 王某甲 与 被告 邓 某某 离婚 。 

王某诉罗某某离婚纠纷一案一审民事判决书.txt	不准 原告 王某 和 被告 罗 某某 离婚 。 

王某诉罗某离婚纠纷一审民事裁定书.txt	本案 按 撤诉 处理 。 

甘某某诉邹某某离婚纠纷一审民事判决书.txt	不 准予 原告 甘 某某 与 被告 邹 某某 离婚 。 

田某某与张某甲离婚纠纷案一审民事判决书.txt	1 、 准予 原告 田 某某 与 被告 张某 甲 离婚 。 2 、 婚生女 张某丙 由 原告 田 某某 抚养 。 三 、 原告 田 某某 在 本 判决书 生效 后 十日 内向 被告 张某 甲 一次性 支付 经济 帮助 金 48000 元 。 如果 未 按 本 判决 指定 的 期间 履行 给付 金钱 的 义务 ， 应当 依照 《 中华人民共和国 民事 诉讼法 》 第 二百五十 三条 的 规定 ， 加倍 支付 迟延 履行 期间 的 债务 利息 。 在 本 判决 生效 前 ， 原 、 被告 不得 另行 结婚 。 

田某某与肖某某离婚纠纷一审民事判决书.txt	不 准许 原告 田 某某 与 被告 肖 某某 离婚 。 

田某某与黄某甲离婚纠纷一审民事判决书.txt	准予 原告 田 某某 与 被告 黄某 甲 离婚 ； 二 、 婚生女 黄某 乙 （ 2010 年 12 月 18 日 生 ） 由 被告 黄某 甲 抚养 ， 原告 田 某某 从 2016 年 3 月 起 每月 支付 黄某 乙 抚养费 500 元 至 其 独立 生活 时 止 ； 原告 于 2016 年 6 月 30 日前 支付 黄某 乙 2016 年 的 抚养费 5000 元 ， 从 2017 年 开始 每半年 支付 一次 ， 分别 于 当年 的 1 月 30 日 、 7 月 30 日前 支付 。 

田某某诉王某某离婚纠纷一审民事判决书.txt	不 准予 原告 田 某某 与 被告 王 某某 离婚 ； 

田某某诉陈某某离婚纠纷一审民事判决书.txt	不准 原告 田燕 与 被告 陈小洪 离婚 。 

白某某与曾某某离婚纠纷一审民事判决书.txt	不准 原告 白 某某 与 被告 曾 某某 离婚 ； 

白某某与杜某某离婚纠纷一审民事判决书.txt	一 、 准予 原告 白 某某 与 被告 杜 某某 离婚 ； 二 、 婚生女 白某甲 由 被告 杜 某某 抚养 。 原告 白 某某 有 探望 婚生女 白某 甲 的 权利 ， 被告 杜 某某 有 协助 、 配合 的 义务 。 

白某某与杨某甲离婚纠纷一审民事判决书.txt	一 、 准予 原告 白 某某 与 被告 杨某 甲 离婚 ； 二 、 夫妻 共同财产 原告 白 某某 分 得 楼房 第一层 一间 ， 其余 的 归 被告 杨某 甲 所有 ； 三 、 共同 债务 53000 元 ， 原告 白 某某 偿还 26500 元 ， 被告 杨某 甲 偿还 26500 元 。 

白某甲诉郑某离婚纠纷一审民事判决书.txt	不准 原告 白某甲 与 被告 郑某 离婚 。 

石某某与蒋某甲离婚纠纷一审民事判决书.txt	不准 原告 石 某某 与 被告 蒋某 甲 离婚 。 

石某某诉被告付某某离婚纠纷一审民事判决书.txt	不准 原告 石 某某 与 被告 付 某某 离婚 。 

石某某诉黎某某离婚纠纷一审民事判决书.txt	不准 原告 石 某某 与 被告 黎 某某 离婚 。 

祝某某与唐某甲离婚纠纷一审民事判决书.txt	不 准予 原告 祝 某某 与 被告 唐某 甲 离婚 。 

祝淑英与赵国辉离婚纠纷一审民事判决书.txt	不 准予 原告 祝 某某 与 被告 赵 某某 离婚 。 

秦某某与谢某某离婚后财产纠纷案二审民事判决书.txt	一 、 维持 四川省 泸州市 江阳区 人民法院 （ 2015 ） 江阳 民初 字 第 2500 号 民事判决 的 第二项 ， 即 " 驳回 原告 秦 某某 的 其他 诉讼请求 。 " ； 二 、 撤销 泸州市 江阳区 人民法院 （ 2015 ） 江阳 民初 字 第 2500 号 民事判决 的 第一项 ， 即 " 被告 谢 某某 在 本 判决 生效 之日起 十日 内 偿还 原告 秦 某某 105000.00 元 。 " ； 三 、 驳回 秦 某某 要求 谢 某某 支付 145000.00 元 的 诉讼请求 。 

程丽萍与黄科贵离婚纠纷二审民事判决书.txt	驳回上诉 ， 维持原判 。 

程某与王某甲离婚纠纷一审民事判决书.txt	不准 原告 程某 与 被告 王某 甲 离婚 。 

程某与谢某离婚纠纷一审民事判决书.txt	不准 原告 程 某某 与 被告 谢 某某 离婚 。 

程某某与被告尤某某离婚纠纷一审民事判决书.txt	不准 原告 程 某某 与 被告 尤 某某 离婚 。 

程某某诉王某某离婚纠纷民事一审判决书.txt	不 准予 原告 程 某某 与 被告 王 某某 离婚 。 

穆某某诉郑某某离婚纠纷民事一审判决书.txt	不准 原告 穆 某某 与 被告 郑 某某 离婚 。 

童某甲与杨某某离婚纠纷一审民事判决书.txt	准予 原告 童某甲 与 被告 杨 某某 离婚 ； 

简某某与彭某某离婚纠纷一审民事判决书.txt	一 、 准予 原告 简 某某 与 被告 彭 某某 离婚 ； 二 、 子女 彭甲 随 被告 彭 某某 生活 。 原告 简 某某 于 本 判决 生效 后 每月 向 被告 彭 某某 支付 子女 彭甲 生活费 人民币 500 元 直至 彭甲 十八周岁 止 。 彭 甲未 满 十八周岁 期间 的 教育费 、 医疗费 凭票 由 原被告 各 承担 一半 ； 三 、 驳回 原告 的 其他 诉讼请求 。 

米某某与杨某某离婚纠纷一审民事判决书.txt	驳回 原告 米 某某 的 诉讼请求 。 案件 受理费 150 元 ， 由 原告 米 某某 负担 。 如 不服 本 判决 ， 可 在 判决书 送达 之日起 十五日 内 ， 向 本院 递交 上诉状 ， 并 按 对方 当事人 的 人数 提出 副本 ， 交纳 上诉 案件 受理费 ， 上诉 于 广安市 中级 人民法院 。 审判员 钱 嫄 二 〇 一 六年 四月 二十五日 

粟某某与向某某离婚纠纷一审民事判决书.txt	准许 原告 粟 某某 与 被告 向 某某 离婚 。 

罗某与康某甲离婚纠纷一审民事判决书.txt	一 、 准予 原告 罗某 与 被告 康某 甲 离婚 ； 二 、 婚生子 康某 乙 ， 随 原告 罗某 生活 ， 由 原告 罗某 自行 抚养 。 

罗某与赵某离婚纠纷一审民事判决书.txt	不准 原告 罗 某某 与 被告 赵某 甲 离婚 。 

罗某与黄某某婚姻无效一审民事判决书.txt	原告 罗某 与 被告 黄 某某 的 婚姻 无效 。 

罗某某与何某甲离婚纠纷一审民事判决书.txt	不 准予 原告 罗 某某 与 被告 何某 甲 离婚 。 

罗某某与刘某某离婚纠纷一审民事判决书.txt	一 、 准予 原告 罗 某某 与 被告 刘 某某 离婚 ； 二 、 婚生女 刘某乙 由 原告 抚养 教育 成年 ， 婚生子 刘某甲 由 被告 刘 某某 抚养 教育 成年 ； 三 、 夫妻 共同财产 位于 剑阁县 瓦屋 一套 归 被告 刘 某某 所有 。 

罗某某与吴某甲离婚纠纷一案一审民事判决书.txt	不准 原告 罗 某某 与 被告 吴某 甲 离婚 。 

罗某某与周某某离婚纠纷一审民事判决书.txt	不准 原告 罗 某某 被告 周 某某 离婚 。 

罗某某与周某某离婚纠纷民事一审判决书.txt	罗 某某 与 周 某某 离婚 ； 婚生女 周某 甲 随 周 某某 生活 并 由其 抚养 至 十八周岁 时 止 。 罗 某某 从 2016 年 5 月 起 每月 承担 子女 抚养费 400 元 （ 含 教育 、 医疗费 ） 。 此款 在 每月 30 日前 自行 由 罗 某某 付给 罗 某某 。 驳回 原告 的 其他 诉讼请求 。 

罗某某与封某甲离婚纠纷一审民事判决书.txt	原告 罗 某某 与 被告 封某 甲 离婚 。 本 判决 发生 法律效力 前 ， 原 、 被告 不得 另行 结婚 。 

罗某某与林某甲离婚纠纷一审民事判决书.txt	一 、 准予 原告 罗 某某 与 被告 林某 甲 离婚 ； 二 、 原 、 被告 婚 生小孩 林某乙 随 被告 林某 甲 生活 ； 三 、 自 2016 年 4 月 起 每月 由 原告 罗 某某 支付 婚生子 林某 乙 抚养费 300 元 至 林某 乙 独立 生活 时 止 。 本案 诉讼费 150 由 原告 罗 某某 负担 。 如 不服 本 判决 ， 可 在 本 判决书 送达 之日起 十五日 内 ， 向 本院 或 广安市 中级 人民法院 递交 上诉状 ， 并 按 对方 当事人 的 人数 提出 副本 ， 上诉 于 四川省 广安市 中级 人民法院 。 

罗某某与胡某某离婚纠纷案一审民事判决书.txt	不 准予 原告 罗 某某 与 被告 胡 某某 离婚 。 

罗某某与谢某某离婚纠纷一审民事判决书.txt	不 准许 原告 罗 某某 与 被告 谢 某某 离婚 。 

罗某某与贾某某离婚纠纷一审民事判决书.txt	不准 原告 罗 某某 与 被告 贾 某某 离婚 。 

罗某某与陈某甲离婚纠纷一审民事判决书.txt	不 准许 原告 罗 某某 与 被告 陈某 甲 离婚 。 

罗某某与陈某甲离婚纠纷一审民事裁定书.txt	不 准许 原告 罗 某某 与 被告 陈某 甲 离婚 。 

罗某某诉吴某某离婚纠纷一案一审民事判决书.txt	不准 原告 罗 某某 与 被告 吴 某某 离婚 。 

罗某某诉孙某某离婚纠纷一案一审民事判决书.txt	一 、 准予 原告 罗 某某 和 被告 孙 某某 离婚 ； 二 、 原告 罗 某某 和 被告 孙 某某 双方 婚生子 罗某甲 由 罗 某某 抚养 ， 孙 某某 每月 支付 孩子 抚养费 1500 元 至 孩子 年满 18 周岁 止 。 三 、 原告 罗 某某 和 被告 孙 某某 夫妻 存续 期间 所欠 原告 舅舅 2 万元 债务 由 原被告 各自 承担 10000 元 。 

罗某甲与张某甲离婚纠纷一审民事判决书.txt	一 、 准予 原告 罗某甲 与 被告 张某 甲 离婚 。 二 、 夫妻 共同 债权 ： 高明 借 被告 5000 元 由 被告 张某 甲 收取 享有 。 三 、 夫妻 共同 债务 ： 借 叶明英 5000 元 ， 借 张云祥 2000 元 由 张某 甲 负责 偿还 ， 借 张丽 2000 元 由 原告 负责 偿还 。 

罗某甲与张某离婚纠纷案一审民事判决书.txt	不准 原告 罗某甲 与 被告 张某 离婚 。 

罗某甲与罗某乙离婚纠纷一审民事判决书.txt	不 准予 原告 罗某甲 与 被告 罗某 乙 离婚 。 

羊某某诉覃某某离婚纠纷一审判决书.txt	不准 原告 羊 某某 与 被告 覃 某某 离婚 。 

翟某诉隆某离婚纠纷一审判决书.txt	准予 原告 翟某 与 被告 隆某 离婚 ： 二 、 婚生子 隆某甲 由 原告 翟某 抚养 ， 婚生女 隆某乙 由 被告 隆某 抚养 。 

聂某某与李某某离婚纠纷一审民事判决书.txt	不准 原告 聂 某某 与 被告 李 某某 离婚 。 

聂某某诉余某某离婚纠纷一审民事判决书.txt	不准 原告 聂 某某 与 被告 余 某某 离婚 。 

肖某与蒲某离婚纠纷一审民事裁定书.txt	本案 按 撤诉 处理 。 

肖某某与严某甲离婚纠纷一审民事判决书.txt	准予 原告 肖 某某 与 被告 严某 甲 离婚 。 

肖某某与倪某某离婚纠纷一审民事判决书.txt	不 准许 原告 肖某甲 与 被告 倪 某某 离婚 。 

肖某某与张某某离婚纠纷一审民事判决书.txt	不 准许 原告 肖 某某 与 被告 张 某某 离婚 。 

肖某某与方某甲离婚纠纷案一审民事判决书.txt	不准 原告 肖 某某 与 被告方 某 甲 离婚 。 

肖某某与杨某某离婚纠纷一审民事判决书.txt	不 准许 原告 肖 某某 与 被告 杨 某某 离婚 。 

肖某某与罗德国罗某甲离婚纠纷一审民事判决书.txt	不 准予 原告 肖 某某 与 被告 罗某 甲 离婚 。 

肖某甲与肖某乙离婚纠纷一审民事判决书.txt	不准 原告 肖某甲 与 被告 肖某 乙 离婚 。 

胡某与周某离婚纠纷案二审民事裁定书.txt	一 、 撤销 四川省 遂宁市 船山区 人民法院 （ 2015 ） 船山 民初 字 第 2505 号 民事判决 ； 二 、 发回 四川省 遂宁市 船山区 人民法院 重审 。 

胡某某与严某某离婚纠纷一审民事判决书.txt	准许 原告 胡 某某 与 被告 严某 甲 离婚 ； 

胡某某与刘某某离婚纠纷一审民事判决书.txt	一 、 准许 原告 胡 某某 与 被告 刘 某某 离婚 ； 二 、 夫妻 共同财产 归 被告 刘 某某 所有 ； 三 、 夫妻 共同 债务 即 在 广元市 朝天区 农村 信用联社 曾家 信用社 的 贷款 本金 2 万元 及其 利息 由 原告 胡 某某 与 被告 刘 某某 各自 承担 一半 （ 具体 利息 根据 信用社 的 结算 确定 ） ； 四 、 驳回 原告 胡 某某 的 其他 诉讼请求 。 

胡某某与王某甲离婚纠纷一审民事判决书.txt	不 准予 原告 胡 某某 与 被告 王某 甲 离婚 。 

胡某某诉张某某离婚纠纷一审民事裁定书.txt	准许 原告 胡 某某 撤回 起诉 。 

胡某某诉李某某离婚纠纷民事一审判决书.txt	一 、 准予 原告 胡 某某 与 被告 李 某某 离婚 ； 二 、 原告 胡 某某 与 被告 李 某某 之 女 胡某乙 随 原告 胡 某某 抚养 生活 。 

胡某梅与杨某学离婚纠纷民事裁定书.txt	本案 按 原告 胡某梅 自动 撤回 起诉 处理 。 

胡英与唐丽珍离婚纠纷一审民事裁定书.txt	驳回 申请 再审 人 胡某 的 再审 申请 。 本 裁定书 送达 后 即 发生 法律效力 。 （ 此 页 无正文 ） 

胥某兰与何某军离婚纠纷一审民事判决书.txt	不 准予 原告 胥某兰 与 被告 何某军 离婚 。 

胥某某与段某某离婚纠纷一审民事判决书.txt	不 准许 原告 胥 某某 与 被告 段 某某 离婚 。 

胥某某与胡某某离婚纠纷一审民事判决书.txt	不准 原告 胥 某某 与 被告 胡 某某 离婚 。 

胥某甲与曹某某离婚纠纷一审民事判决书.txt	不准 原告 胥某甲 与 被告 曹 某某 离婚 。 

胥某甲与覃某某离婚纠纷一审民事判决书.txt	不准 原告 胥某甲 与 被告 覃 某某 离婚 。 

舒某某诉余某某离婚纠纷一审民事判决书.txt	不 准许 原告 舒 某某 与 被告 余 某某 离婚 。 

舒某诉周某离婚纠纷一审民事判决书.txt	不 准予 原告 舒 某某 与 被告 周某 甲 离婚 。 

芶某某与黄某甲离婚纠纷一审民事判决书.txt	不准 原告 芶 某某 与 被告 黄某 甲 离婚 。 

苏呷某甲与纳子某甲婚姻无效纠纷一审民事判决书.txt	宣告 原告 苏 呷 某 甲 与 被告 纳子某 甲 之间 的 婚姻 为 无效 婚姻 。 

苏某与唐某某离婚纠纷一审民事判决书.txt	不准 原告 苏某 和 被告 唐 某某 离婚 。 

苏某某与宋某某离婚纠纷一审民事判决书.txt	不 准予 原告 苏 某某 与 被告 宋 某某 离婚 。 

苏某某与彭某某甲离婚纠纷一审民事判决书.txt	不准 原告 苏 某某 与 被告 彭 某某 甲 离婚 。 

苏某某与舒某某离婚纠纷一事民事判决书.txt	不 准许 原告 苏 某某 与 被告 舒 某某 离婚 。 

苏某某与赵某甲离婚纠纷一审民事判决书.txt	不 准予 原告 苏 某某 与 被告 赵某 甲 离婚 。 

苟某与高某离婚纠纷一案一审民事判决书.txt	不 准予 原告 苟某 与 被告 高某 离婚 。 

苟某甲与张某甲离婚纠纷一审民事判决书.txt	一 、 准予 原告 苟某甲 与 被告 张某 甲 离婚 ； 二 、 共同财产 即 位于 剑阁县 鹤龄 镇化 林村 七组 三楼 一底 的 砖混 结构 房屋 一栋 归 被告 张某 甲 所有 。 

范某丹与陈某离婚纠纷一审民事判决书.txt	不 准予 原告 范某丹 与 被告 陈某 离婚 。 

范某某与张某某离婚纠纷一审民事判决书.txt	不 准许 原告 范 某某 与 被告 张 某某 离婚 。 

范某某与牟某某离婚纠纷一审民事判决书.txt	不准 原告 范 某某 与 被告 牟某 甲 离婚 。 

范某某与罗某离婚纠纷一审民事判决书.txt	不准 原告 范 某某 与 被告 罗某 离婚 。 

范某某与马某某离婚纠纷一审民事判决书.txt	不 准予 原告 范 某某 与 被告 马 某某 离婚 ； 

范某甲与张某某离婚纠纷一审民事判决书.txt	不 准予 原告 范某甲 与 被告 张 某某 离婚 。 

荣某珍与雷某明离婚纠纷一审民事判决书.txt	不 准许 原告 荣某珍 与 被告 雷某明 离婚 。 

莫某某与苏某某离婚纠纷一审民事判决书.txt	一 、 准予 原告 莫 某某 与 被告 苏 某某 离婚 ； 二 、 夫妻 共同财产 （ 营山县 购买 的 住房 一套 ） 归 原告 莫 某某 所有 。 

董某与鲁某离婚纠纷二审民事判决书.txt	驳回上诉 ， 维持原判 。 

董某某与邹某某离婚纠纷一案一审民事判决书.txt	不 准予 原告 董 某某 与 被告 邹 某某 离婚 。 

董某某诉秦某某离婚纠纷案一审民事判决书.txt	不 准予 原告 董 某某 与 被告 秦 某某 离婚 。 

蒋凤英与罗强离婚后财产纠纷一审民事判决书.txt	被告 罗强 自本 判决 生效 之日起 十日 内 偿还 原告 蒋凤英 人民币 30 ， 000 元 ， 并 自 2016 年 3 月 10 日 起 按 中国人民银行 公布 的 同期 贷款 基准利率 计收 利息 至 还清 此款 为止 。 如 未 按 本 判决 指定 的 期间 给付 金钱 义务 ， 应当 按照 《 中华人民共和国 民事 诉讼法 》 第 二百五十 三条 之 规定 ， 加倍 支付 履行 期间 的 债务 利息 。 

蒋某与杜某某离婚纠纷一审民事判决书.txt	不准 原告 蒋某 与 被告 杜 某某 离婚 。 

蒋某某与党某某离婚纠纷一审民事判决书.txt	不 准许 原告 蒋 某某 与 被告 党 某某 离婚 。 

蒋某某与吕某某离婚纠纷一审民事判决书.txt	宣告 原告 蒋 某某 与 被告 吕 某某 的 婚姻 无效 。 

蒋某某与呙某某离婚后财产纠纷一审民事判决书.txt	一 、 位于 泸县 X 镇 X 路 的 门市房 一套 ， 房 权证 号 为 ： 泸县 房 权证 X 字 第 0082  号 ， 土地证 号 为 ： （ 2001 ） 07  号 ， 面积 71.59 平方米 ， 归 原告 蒋 某某 所有 。 二 、 驳回 原告 蒋 某某 的 其他 诉讼请求 。 

蒋某某与李某甲离婚纠纷一审民事判决书.txt	不准 原告 蒋 某某 与 被告 李某 甲 离婚 。 

蒋某某与王某某离婚纠纷一审民事判决书.txt	不 准予 原告 蒋 某某 与 被告 王某 甲 离婚 。 

蒋某某与黄某甲离婚纠纷一审民事判决书.txt	不 准予 原告 蒋 某某 与 被告 黄某 甲 离婚 。 

蒋某某甲与许某某离婚纠纷一审民事判决书.txt	一 、 准予 原告 蒋 某某 甲 与 被告 许 某某 离婚 ； 二 、 婚生女 蒋 某某 乙由 被告 许 某某 抚养 ， 由 原告 蒋 某某 甲 按 每月 400 元 的 标准 向 被告 许 某某 支付 子女 生活费 ， 婚生女 蒋 某某 乙 在校 期间 的 学杂费 和 生病 住院 的 医药费 凭 学校 和 医院 的 有效 票据 由 原告 蒋 某某 甲 承担 50 % ， 至 婚生女 蒋 某某 乙 独立 生活 时 为止 。 上述 应 承担 的 费用 由 原告 蒋 某某 甲 在 每年 12 月 31 日前 向 被告 结算 支付 一次 。 

蒋某甲与吴某甲离婚纠纷一审民事判决书.txt	不准 原告 蒋某甲 与 被告 吴某 甲 离婚 。 

蒋某甲与李某某离婚纠纷案一审民事判决书.txt	准予 原告 蒋某甲 与 被告 李 某某 离婚 。 

蒙某某与敬某甲离婚纠纷一审民事判决书.txt	准予 原告 蒙 某某 与 被告 敬某 甲 离婚 。 

蒲某某与葛某甲离婚纠纷一审民事判决书.txt	不准 原告 蒲 某某 与 被告 葛某 甲 离婚 。 

蒲某某与補某某离婚纠纷一审民事判决书.txt	准予 原告 蒲 某某 与 被告 補 某某 离婚 ； 二 、 婚生子 补 某 乙 由 被告 補 某某 抚养 ， 原告 蒲 某某 自本 判决 生效 后 起 每月 支付 抚养费 300 元 至 其子 能够 独立 生活 时 止 。 

蒲某某诉苏某某离婚纠纷一审民事判决书.txt	一 、 准予 原告 蒲 某某 与 被告 苏 某某 离婚 ； 二 、 婚生子 苏某 随 原告 蒲 某某 生活 ， 抚养费 用 由 原告 蒲 某某 承担 ； 三 、 西充县 某乡 某村 某 组 某 号 房屋内 财产 归 被告 苏 某某 所有 ， 川 R 某某 小型 面包车 归 原告 蒲 某某 所有 。 

蔡某诉李某某离婚纠纷一案一审民事裁定书.txt	本案 按 撤诉 处理 。 

薛某某诉胡某某离婚纠纷民事一审判决书.txt	一 、 准予 原告 薛 某某 与 被告 胡 某某 离婚 ； 二 、 原告 薛 某某 与 被告 胡 某某 之 子 薛甲 随 原告 薛 某某 抚养 生活 ， 被告 胡 某某 每月 支付 原告 薛 某某 子女 抚养费 350 元 至 薛甲 年满 十八周岁 为止 ； 三 、 驳回 原告 薛 某某 的 其他 诉讼请求 。 

薛某诉易某离婚纠纷一案一审民事判决书.txt	不准 原告 薛某 与 被告 易某 离婚 。 

袁某某与吴某某离婚一审判决书.txt	不 准予 原告 袁 某某 与 被告 吴 某某 离婚 。 

袁某某与曾某甲离婚纠纷一审民事判决书.txt	不 准予 原告 袁 某某 与 被告 曾某 甲 离婚 。 

袁某某与王某甲离婚纠纷一审民事判决书.txt	不 准予 原告 袁 某某 与 被告 王某 甲 离婚 。 

袁某某与邓某甲离婚纠纷一审民事裁定书.txt	驳回 原告 袁 某某 的 起诉 。 根据 中华人民共和国国务院 《 诉讼费用 交纳 办法 》 的 规定 ， 本案 不 收取 案件 受理费 。 如 不服 本 裁定 , 可 在 裁定书 送达 之日起 十日 内 , 向 本院 递交 上诉状 , 并 按 对方 当事人 的 人数 提出 副本 , 上诉 于 绵阳市 中级 人民法院 。 

袁某某与陈某某离婚纠纷一案一审民事判决书.txt	一 、 准予 原告 袁 某某 与 被告 陈 某某 离婚 ； 二 、 由 原告 袁 某某 于 判决 生效 后 第三日 一次性 支付 被告 陈 某某 扶助 费 5000 元 。 

袁某某与陈某甲离婚纠纷一审民事判决书.txt	不 准予 原告 袁 某某 与 被告 陈某 甲 离婚 。 

袁某某诉叶某某离婚纠纷一审判决书.txt	准予 原告 袁 某某 与 被告 叶 某某 离婚 。 

袁某某诉黄某某离婚纠纷一审民事判决书.txt	一 、 准予 原告 袁 某某 与 被告 黄 某某 离婚 ； 二 、 婚生子 黄某 随 被告 黄 某某 生活 ， 由 原告 袁 某某 向 被告 黄 某某 支付 黄某 抚养费 用 35000 元 。 

袁某甲与王某离婚纠纷一审民事判决书.txt	准予 原告 袁某甲 与 被告 王 某某 离婚 。 

詹某甲与吴某某离婚纠纷一审民事判决书.txt	准予 原告 詹某甲 与 被告 吴 某某 离婚 。 

譙某某与徐某某甲离婚纠纷一审民事判决书.txt	不准 譙 某某 与 徐 某某 甲 离婚 。 

许某某与姚某某离婚纠纷案一审民事判决书.txt	一 、 许 某某 与 姚 某某 离婚 。 二 、 婚生子 许某甲 由 许 某某 抚养 ， 被告 不 给付 抚养费 。 三 、 夫妻 共同财产 位于 绵阳市 涪城区 西河 西路 42 号 房屋 一套 （ 72.11 平方米 ） 归 原告 许 某某 所有 ， 由 许 某某 给付 姚 某某 该 房屋 分割 款 80000 元 。 

许某某与廖某某离婚纠纷一案一审民事判决书.txt	不准 原告 许 某某 与 被告 廖 某某 离婚 。 

许某某与李某甲离婚纠纷一审民事判决书.txt	不准 原告 许 某某 与 被告 李某 甲 离婚 。 

许某某与杨某某确认婚姻无效纠纷案一审民事判决书.txt	许 某某 与 杨 某某 婚姻 无效 。 

许某某诉被告李某某离婚纠纷一审民事判决书.txt	不准 原告 许 某某 与 被告 李 某某 离婚 。 

许某诉梁某甲离婚纠纷一审民事判决书.txt	不 准许 某 与 梁某 甲 离婚 。 

谌某甲诉郭某某离婚纠纷一审民事裁定书.txt	准许 原告 谌某 甲 撤回 起诉 。 

谢明兰与程德正离婚纠纷一审民事判决书.txt	不准 原告 谢 某某 与 被告 程 某某 离婚 。 

谢某与何某某离婚纠纷一审民事判决书.txt	不准 原告 谢某 与 被告 何 某某 离婚 。 

谢某某与刘某某离婚纠纷一审民事判决书.txt	准予 原告 谢 某某 与 被告 刘 某某 离婚 。 

谢某某与王某某离婚纠纷一审民事裁定书.txt	不 准予 原告 谢 某某 与 被告 王 某某 离婚 。 

谢某某与高某某离婚纠纷一审民事判决书.txt	一 、 准予 原告 谢建英 谢 某某 与 被告 高武雄 高 某某 离婚 ； 二 、 孩子 高 雨露 高 某某 、 高 飞扬 某某 由 随 被告 高武雄 某某 抚养 生活 ， 原告 谢建英 谢 某某 自 2016 年 4 月 起 每月 分别 给付 给付 高 雨露 高 某某 、 生高 飞扬 某某 生活费 500800 元 ， 给付 高 飞扬 生活费 600 元 ， 并 承担 高 雨露 高 某某 、 高 飞扬 某某 50 % 的 教育费 、 医疗费 ， 分别 于 当年 6 月 30 日 、 12 月 30 日前 各 付 半年 。 上述 费用 支付 至 高 雨露 高 某某 、 高 飞扬 某某 18 周岁 成年 时 止 。 

谢某某诉谭某甲离婚纠纷一审民事判决书.txt	准予 原告 谢 某某 与 被告 谭某 甲 离婚 。 

谢某某诉陈某离婚纠纷一审民事判决书.txt	不 准予 原告 谢 某某 与 被告 陈某 离婚 。 

谭某某与王甲、王某乙、王某丙、王丁婚姻家庭、继承纠纷一审民事判决书.txt	一 、 位于 射洪县 大 榆镇 房屋 （ 不 含 王某 乙 扩建 的 部分 ） 原告 谭 某某 享有 的 份额 为 20 % ； 二 、 位于 射洪县 大 榆镇 房屋 （ 不 含 王丁 扩建 的 部分 ） 原告 谭 某某 享有 的 份额 为 60 % ； 三 、 驳回 原告 谭 某某 的 其它 诉讼请求 。 

谭某某与赵某某离婚纠纷案一审民事判决书.txt	一 、 原告 谭 某某 与 被告 赵 某某 离婚 。 二 、 婚生子 谭某 甲 （ 生于 2012 年 1 月 20 日 ） 由 原告 谭 某某 抚养 ， 被告 赵 某某 从 2016 年 4 月 起 每月 支付 抚养费 500 元 自 谭某 甲 年满 十八周岁 。 

谭某甲与何某某离婚纠纷一审民事判决书.txt	原告 谭某 甲 诉请 与 被告 何 某某 离婚 ， 不予 准许 。 

贺某某与赵某某离婚纠纷一审民事判决书.txt	不 准予 原告 贺 某某 与 被告 赵 某某 离婚 。 

贾某华与贾某渠离婚纠纷一审民事判决书.txt	不 准予 原告 贾某华 与 被告 贾某渠 离婚 。 

贾某某与徐某甲离婚纠纷一审民事判决书.txt	不准 原告 贾 某某 与 被告 徐某 甲 离婚 。 

贾某某与汪某甲离婚纠纷一审民事判决书.txt	不准 原告 贾 某某 与 被告 汪某 甲 离婚 。 

贾某某与王某甲离婚纠纷一案二审民事判决书.txt	一 、 撤销 四川省 邻水县 人民法院 （ 2015 ） 邻水 民初 字 第 1581 号 民事判决 ； 二 、 驳回 王某 甲 离婚 的 诉讼请求 。 

贾某诉被告董某离婚纠纷一审民事判决书.txt	一 、 准予 原告 贾某 与 被告 董某 离婚 ； 二 、 婚生子 董  跟随 被告 董某 生活 ， 原告 贾某 于 本 判决书 生效 之日起 至 婚生子 董  独立 生活 止 每月 30 日前 支付 生活费 人民币 500 元 ， 教育费 和 医疗费 凭 票据 由 原告 贾某 和 被告 董某 各 承担 一半 ； 三 、 驳回 原告 贾某 的 其他 诉讼请求 。 

贾菊香与陈猛离婚纠纷一审民事判决书.txt	不 准许 原告 贾 某某 与 被告 陈某 离婚 。 

赖某某与李某甲离婚纠纷一审民事判决书.txt	不 准予 原告 赖 某某 与 被告 李某 甲 离婚 。 

赖某某与龙某某离婚纠纷案一审民事判决书.txt	一 、 赖 某某 与 龙 某某 离婚 。 二 、 现有 位于 三台县 古井 镇心妙 桂花 坝 居民区 一楼 一底 房屋 8 间 （ 其中 一楼 门面 四间 ） 中 一半 归龙 某某 所有 ， 一半 归龙某 所有 。 

赵某某与刘某离婚纠纷一审民事判决书.txt	不准 原告 赵 某某 与 被告 刘某 离婚 。 

赵某某与周某某离婚纠纷一审民事判决书.txt	一 、 准予 原告 赵 某某 与 被告 周 某某 离婚 ； 二 、 婚生子 ， 周某 ， 由 原告 赵 某某 抚养 ， 被告 周 某某 每月 28 日前 向 原告 赵 某某 支付 子女 抚养费 300.00 元 ／ 月 至 周某 年满 18 周岁 止 ； 三 、 驳回 原告 赵 某某 其他 诉讼请求 。 

赵某某与朱某离婚纠纷一民事裁定书.txt	本案 按 撤诉 处理 。 

赵某某与李某离婚纠纷一审民事判决书.txt	不准 原告 赵 某某 与 被告 李某 离婚 。 

赵某某与李某离婚纠纷案一审民事判决书.txt	不准 原告 赵 某某 与 被告 李某 离婚 。 

赵某某与汤某某甲离婚纠纷一审民事判决书.txt	不准 原告 赵 某某 与 被告 汤 某某 甲 离婚 。 

赵某某与汤某某离婚纠纷一审民事判决书.txt	一 、 准予 原告 赵 某某 与 被告 汤 某某 离婚 ； 二 、 婚生子 汤某甲 由 被告 汤 某某 抚养 ， 从 2016 年 3 月 8 日 起 每月 由 原告 付 生活费 500 元 一年 支付 一次 即 2016 年 3 月 8 日前 支付 2016 年 3 月 8 日 至 2017 年 3 月 8 日 的 生活费 ， 2017 年 3 月 8 日前 支付 2017 年 3 月 8 日 至 2018 年 3 月 8 日 的 生活费 依次 类推 。 教育费 、 医疗费 、 保险费 原 、 被告 各 承担 50 % 至 其 独立 生活 时 止 ； 三 、 原告 对 其 婚生子 汤某 甲 有 探视 的 权利 ； 四 、 夫妻 共同财产 川 B 号 轿车 归 原告 所有 ； 五 、 购车 贷款 17230 元 ， 借 原告 父母 现金 5000 元 ， 被告 父亲 现金 10000 元 ， 由 原告 全部 偿还 ， 该 两笔 个人 借款 在 本 判决 生效 后 十日 内 还清 。 案件 受理费 150 元 由 原告 承担 。 如 不服 本 判决 ， 可 在 判决书 送达 之日起 十五日 内向 本院 递交 上诉状 并 按 对方 当事人 的 人数 提出 副本 ， 上诉 于 四川省 绵阳市 中级 人民法院 。 审判员 李世荣 二 〇 一 六年 三月 四日 

赵某某与王某某离婚纠纷一审民事判决书.txt	一 、 准予 原告 赵 某某 与 被告 王 某某 离婚 ； 二 、 驳回 原告 赵 某某 的 其他 诉讼请求 。 

赵某某诉吉某某离婚纠纷一审民事判决书.txt	准许 原告 赵 某某 与 被告 吉 某某 离婚 。 

赵某某诉钟某离婚纠纷一案一审民事判决书.txt	不准 原告 赵 某某 与 被告 钟某 离婚 。 

赵某琴因与被上诉人罗某扬离婚纠纷一案二审民事判决.txt	驳回上诉 ， 维持原判 。 

赵某甲与周某某离婚纠纷一审民事判决书.txt	准许 原告 赵某甲 与 被告 周 某某 离婚 。 

赵某甲与李某甲离婚纠纷一审民事判决书.txt	不准 原告 赵某甲 与 被告 李某 甲 离婚 。 

赵某甲与王某甲离婚纠纷一审民事判决书.txt	准予 原告 赵某甲 与 被告 王某 甲 离婚 。 婚生子 赵某乙 由 原告 赵某 甲 抚养 ， 被告 王某甲 从 2016 年 4 月 起 按 每月 500 元 标准 支付 抚养费 至 婚生子 独立 生活 时 止 。 被告 在 每年 的 12 月 30 日前 付清 当年 应付 的 费用 。 

赵某甲诉王某甲离婚纠纷一审民事判决书.txt	一 、 准予 原告 赵某甲 与 被告 王某 甲 离婚 。 二 、 夫妻 共同财产 分割 ： 除 原告 赵某 甲 带走 的 衣物 归 其 所有 外 ， 其余 财产 （ 含 房屋 ） 全部 归 被告 王某 甲 所有 。 

蹇某与陈某甲离婚纠纷一审民事判决书.txt	一 、 准许 原告 蹇 某 与 被告 陈某 甲 离婚 。 二 、 原告 蹇 某 与 被告 陈某甲 在 婚姻 存续 期间 的 共同财产 ： 二楼 一底 （ 三间 三层 ， 其中 半间 为 楼梯间 ） 的 住房 一幢 ， 其中 一楼 西侧 的 门面房 一间 、 三 楼 ， 猪圈 （ 从中 隔 ） 东 上 、 下 各 半间 、 洗衣机 一台 、 立柜 一台 、 木 沙发 一台 、 茶几 一个 、 梳妆台 一个 、 粉碎机 一台 、 打饼 机 一台 归 原告 蹇 某 所有 ； 一楼 东侧 的 门面房 一间 半 、 猪圈 （ 从中 隔 ） 西 上 、 下 半间 、 洗衣机 一台 、 立柜 一台 、 布 沙发 各 一组 、 电视柜 一个 、 打 米 机 一台 、 潜水泵 一台 、 打饼 机 一台 归 陈某 甲 所有 ； 楼梯间 与 院坝 共同 使用 。 三 、 原告 蹇 某 与 被告 陈某甲 在 婚姻 存续 期间 的 共同 债务 ： 借 李国勇 的 现金 九百 元 ， 原告 蹇 某 与 被告 陈某 甲 各 承担 偿还 四百五十元 。 四 、 驳回 原告 的 其他 诉讼请求 。 

车某与卢某某离婚纠纷一审民事判决书.txt	一 、 原告 车某 与 被告 卢 某某 离婚 ； 二 、 婚生子 车 某某 跟随 原告 生活 ， 被告 自 2016 年 5 月 起 每月 支付 子女 抚养费 400 元 至 其 独立 生活 时 为止 ， 限 每年 12 月 31 日前 付清 当年 费用 。 

车某甲与张某甲离婚纠纷一审民事判决书.txt	一 、 准予 原告 车某甲 与 被告 张某 甲 离婚 ； 二 、 婚生子 张某乙 由 原告 车某 甲 抚养 ， 被告 张某 甲 不 给付 抚养费 。 

邓某与舒某某离婚纠纷一审民事判决书.txt	一 、 准予 原告 邓某 与 被告 舒 某某 离婚 ； 二 、 婚生子 舒某 由 被告 舒 某某 抚养 ， 由 原告 邓某 从 2016 年 4 月 1 日 起 按 每月 300 元 的 标准 按 月 支付 抚养费 直至 舒某 年满 18 周岁 止 （ 此款 于 每月 月底 前 支付 ） 。 如果 未 按 本 判决 指定 的 期间 履行 给付 金钱 义务 ， 应当 依照 《 中华人民共和国 民事 诉讼法 》 第 二百五十 三条 之 规定 ， 加倍 支付 迟延 履行 期间 的 债务 利息 。 

邓某某与刘某离婚纠纷一审民事判决书.txt	不准 原告 邓 某某 与 被告 刘某 离婚 。 

邓某某与唐某某离婚纠纷一审民事判决书.txt	不准 原告 邓 某某 与 被告 唐 某某 离婚 。 

邓某某与张某离婚纠纷一审民事判决书.txt	不准 原告 邓 某某 与 被告 张某 离婚 。 

邓某某与杨某某离婚纠纷一审民事判决书.txt	不 准予 原告 邓 某某 与 被告 杨 某某 离婚 。 

邓某某与瞿某某离婚纠纷一案一审民事判决书.txt	不 准予 原告 邓 某某 与 被告 瞿 某某 离婚 。 

邓某某与蒋某甲离婚纠纷一审民事判决书.txt	一 、 准予 原告 邓 某某 与 被告 蒋某 甲 离婚 ； 二 、 婚生女 蒋某丙 由 原告 邓 某某 抚养 。 

邓某某与陈某某离婚纠纷一审民事判决书.txt	一 、 准予 原告 邓 某某 与 被告 陈 某某 离婚 。 二 、 婚生子女 邓某 甲 、 邓某 乙 、 邓某丙 由 原告 邓 某某 具体 抚养 ， 被告 陈 某某 每年 给付 子女 抚养费 共计 3000 元 至 三名 子女 独立 生活 时 为止 ， 被告 陈 某某 享有 探视 子女 的 权利 ， 原告 邓 某某 负有 协助 的 义务 。 三 、 原 、 被告 在 婚姻关系 存续 期间 所负 的 共同 债务 ， 由 原告 邓 某某 自愿 偿还 。 

邓某甲与邓某乙离婚纠纷一审民事裁定书.txt	准许 原告 邓某 甲 撤回 起诉 。 

邓某甲与陈某甲离婚纠纷一审民事判决书.txt	一 、 邓某甲 与 陈某 甲 离婚 。 二 、 婚生子女 陈某 乙 、 陈某丙 由 陈某 甲 抚养 ， 自 2016 年 2 月 起 ， 原告 邓某 甲 每人 每月 给付 子女 抚养费 人民币 400 元 ， 至 陈某 乙 、 陈某 丙 分别 年满 十八周岁 时 止 ， 限 每年 12 月 30 日前 付清 当年 子女 抚养费 。 三 、 夫妻 共同 债务 ： 欠 邓某 甲 父亲 邓某 乙 人民币 15000 元 ， 由 邓某 甲 偿还 。 

邓玉皎与杜松离婚纠纷一审民事判决书.txt	不 准予 原告 邓 某某 与 被告 杜某 离婚 。 

邓超英与彭江离婚纠纷案一审民事判决书.txt	一 、 准予 原告 邓某 与 被告 彭某 离婚 ； 二 、 女 彭某 甲 随 原告 邓某 生活 ； 三 、 驳回 原告 邓某 在 本案 的 其他 诉讼请求 。 

邱某某与杨某离婚纠纷案一审民事判决书.txt	一 、 准予 原告 邱 某某 与 被告 杨某 离婚 ； 二 、 女儿 杨 某某 随 被告 杨某 生活 ， 由 原告 邱 某某 自本 判决 生效 之 月 起 每月 给付 其 女 抚养费 500 元 。 每 满 六个月 为 一 申请 执行期 。 

邱某某与熊甲离婚纠纷一审民事判决书.txt	准予 原告 邱 某某 与 被告 熊甲 离婚 。 

邱某某诉杨某某离婚纠纷一案一审民事判决书.txt	准予 原告 邱 某某 和 被告 杨 某某 离婚 。 

邱某某诉龚某某离婚纠纷一审民事判决书.txt	准予 原告 邱 某某 与 被告 龚 某某 离婚 。 

邵某某与江某离婚后财产分割管辖纠纷一案二审民事裁定书.txt	驳回上诉 ， 维持 原 裁定 本 裁定 为 终审 裁定 。 

邹某某与任某某离婚纠纷一审民事判决书.txt	不准 原告 邹 某某 与 被告 任 某某 离婚 。 

邹某某与张某某离婚纠纷民事一审判决书.txt	不 准予 原告 邹 某某 与 被告 张 某某 离婚 。 

邹某甲与陈某某离婚纠纷一审民事判决书.txt	一 、 准予 原告 邹某甲 与 被告 陈 某某 离婚 ； 二 、 原告 与 被告 婚生子女 邹某 乙 、 邹某丁 随 原告 邹某 甲 生活 ， 婚生子女 邹某丙 随 被告 陈 某某 生活 ； 

郑某某与叶某甲离婚纠纷一案民事判决书.txt	不 准予 原告 郑 某某 与 被告 叶某 甲 离婚 。 

郑某某与宋某某离婚纠纷二审民事判决书.txt	驳回上诉 ， 维持原判 。 

郑某某与谢某某离婚纠纷一审民事判决书.txt	不 准许 原告 郑 某某 与 被告 谢 某某 离婚 。 

郑某某与陈某离婚纠纷一审民事判决书.txt	准予 原告 郑 某某 与 被告 陈某 离婚 。 

郑某某诉曾某某离婚纠纷一审民事裁定书.txt	本案 按 撤诉 处理 。 

郑某某诉肖某某离婚纠纷一案民事判决书.txt	不 准予 原告 郑 某某 与 被告 肖 某某 离婚 。 

郑某某诉被告李某某离婚纠纷一案一审民事判决书.txt	不准 原告 郑 某某 与 被告 李 某某 离婚 。 

郑某某诉黄某某离婚纠纷民事一审判决书.txt	不 准予 原告 郑 某某 与 被告 黄 某某 离婚 。 

郑甲某某与陈某某离婚纠纷一审民事判决书.txt	一 、 准予 郑甲 某某 与 陈 某某 离婚 。 二 、 婚生子 郑乙 某某 ， 由 郑甲 某某 抚养 ； 陈 某某 从 2016 年 4 月 起 每月 支付 抚养费 1000 元 ， 至 杨梓 瑞其 年满 18 周岁 时 止 。 

郦某某诉周某某离婚纠纷一审民事判决书.txt	不准 原告 郦 某某 与 被告 周 某某 离婚 。 

郭某与张某甲离婚纠纷一审民事判决书.txt	不准 原告 郭某 与 被告 张某 甲 离婚 。 

郭某与林某甲离婚纠纷一审民事判决书.txt	准予 原告 郭某 与 被告 林某 甲 离婚 。 

郭某某与任某甲离婚纠纷一审民事判决书.txt	一 、 准予 原告 郭 某某 与 被告 任某 甲 离婚 ； 二 、 驳回 原告 郭 某某 的 其他 诉讼请求 。 

郭某某与吴某甲离婚纠纷一审民事判决书.txt	一 、 准予 原告 郭 某某 与 被告 吴某 甲 离婚 ； 二 、 婚 生长 女 吴某 乙 、 次子 吴某丙 由 原告 郭 某某 抚养 ， 由 被告 吴某甲 从 2016 年 4 月 起 每月 支付 其子 、 女 抚养费 各 750 元 直至 其子 、 女 分别 年满 18 周岁 止 ； 三 、 夫妻 共同 债务 借 原告 之 父母 的 6.7 万元 由 原告 负责 偿还 ， 借 被告 之父 的 5 万元 由 被告 负责 偿还 ； 四 、 驳回 原告 郭 某某 的 其他 诉讼请求 。 

郭某某与唐某某离婚纠纷案一审民事判决书.txt	不准 原告 郭 某某 与 被告 唐 某某 离婚 ； 

郭某某与景某某离婚纠纷案一审民事判决书.txt	一 、 原告 郭 某某 与 被告 景 某某 离婚 。 二 、 婚生子 郭某 甲 （ 生于 2011 年 5 月 18 日 ） 由 原告 郭 某某 自行 抚养 自 郭某 甲 年满 十八周岁 。 三 、 现 双方 各 持 财产 归 各自 所有 ， 各自 经手 的 债权 、 债务 由 各自 享有 、 清偿 。 

郭某某与李某某离婚纠纷一审民事判决书.txt	不 准许 原告 郭 某某 与 被告 李 某某 离婚 。 

郭某某与赵某某离婚纠纷一审民事判决书.txt	不准 原告 郭 某某 与 被告 赵 某某 离婚 。 

郭某某与邓某某离婚纠纷一审民事判决书.txt	不准 原告 郭 某某 与 被告 邓 某某 离婚 。 

郭某甲诉李某甲离婚纠纷一审民事判决书.txt	一 、 准予 原告 郭某甲 与 被告 李某 甲 离婚 ； 二 、 婚生女 郭某 乙 跟随 原告 郭某 甲 生活 ， 被告 李某 甲 不 给付 子女 抚养费 ； 三 、 原告 郭某甲 在 本 判决书 生效 后 15 日 内 ， 一次性 给付 被告 李某 甲 经济 帮助 60000 元 人民币 。 

郭某诉周某离婚纠纷一审民事判决书.txt	一 、 准予 原告 郭某 与 被告 周某 离婚 ； 二 、 婚生 女周 某某 随 原告 郭某 生活 ， 被告 周某 一次性 支付 抚养费 204000 元 ， 此款 于 本 判决 生效 后 十日 内 支付 ； 三 、 驳回 原告 郭某 的 其他 诉讼请求 。 如 未 按 本 判决书 指定 期间 履行 给付 金钱 义务 ， 应当 依照 《 中华人民共和国 民事 诉讼法 》 第 二百五十 三条 之 规定 ， 加倍 支付 延期 履行 期间 的 债务 利息 。 

金某某与于某某离婚纠纷一审民事判决书.txt	不准 原告 金 某某 与 被告 于 某某 离婚 。 

钟某与罗某甲离婚纠纷一审民事判决书.txt	准予 原告 钟某 与 被告 罗某 甲 离婚 。 

钟某某与夏某甲离婚纠纷一案一审民事判决书.txt	不准 原告 钟 某某 与 被告 夏某 甲 离婚 。 

钱某某与李某某离婚后子女抚养、财产分割纠纷一审民事判决书.txt	一 、 原 、 被告 婚姻关系 存续 期间 所 生育 次女 钱某丙 由 原告 钱 某某 具体 抚养 ， 所 生育 长女 钱某乙 由 被告 李 某某 具体 抚养 ， 双方 互不 给付 子女 抚养费 。 双方 对 对方 所 抚养 的 子女 有 探视 的 权利 ， 对方 有 协助 的 义务 ； 二 、 限 被告 李 某某 在 本 判决 生效 后 三十日 内 支付 原告 钱 某某 100000 元 ； 三 、 驳回 原告 钱 某某 的 其他 诉讼请求 。 

阿某某与薛某某离婚纠纷一审民事判决书.txt	一 、 不准 原告 阿 某某 与 被告 薛 某某 离婚 ； 二 、 驳回 原告 阿 某某 的 其他 诉讼请求 。 

阿衣某某与吴某甲离婚纠纷一审民事判决书.txt	不准 原告 阿衣 某某 与 被告 吴某 甲 离婚 。 

陈某与刘某某离婚纠纷案一审民事判决书.txt	一 、 陈某 与 刘 某某 离婚 。 二 、 现有 夫妻 共同财产 全部 归 陈某 甲 、 刘某 共同 所有 。 

陈某与周某、蒋某素、周某林婚约财产纠纷一审民事判决书.txt	一 、 被告 周某 、 周某林 、 蒋某素 在 本 判决 生效 后 十日 内 共同 向 原告 陈某 返还 彩礼 35000 元 ； 二 、 驳回 原告 陈某 的 其它 诉讼请求 。 若 被告 未 在 规定 的 期限内 履行 本 判决书 所 确定 的 义务 ， 应当 加倍 支付 迟延 履行 期间 的 债务 利息 。 

陈某与周甲离婚纠纷一审民事判决书.txt	不准 原告 陈某 与 被告 周甲 离婚 。 

陈某与尹某离婚纠纷一审民事判决书.txt	准予 原告 陈某 与 被告 尹某 离婚 。 

陈某与李某某离婚纠纷一审民事判决书.txt	不准 原告 陈某 与 被告 李 某某 离婚 。 

陈某与李某某离婚纠纷民事一审民事判决书.txt	不准 原告 陈某 与 被告 李 某某 离婚 。 

陈某与王某某离婚纠纷一审民事裁定书.txt	驳回 原告 陈 某某 对 被告 王 某某 的 起诉 。 

陈某华与孙某朋离婚纠纷一审民事判决书.txt	原告 陈某华 要求 与 被告 孙某 朋 离婚 ， 不予 准许 。 

陈某某与何某甲离婚纠纷一审民事判决书.txt	原告 陈 某某 诉 与 被告 何某 甲 离婚 ， 不予 准许 。 

陈某某与何某离婚纠纷一审民事判决书.txt	不准 原告 陈 某某 与 被告 何某 离婚 。 

陈某某与余某某离婚纠纷一审民事判决书.txt	不 准予 原告 陈某甲 与 被告 余 某某 离婚 。 

陈某某与冯某离婚纠纷一审民事判决书.txt	不准 原告 陈 某某 与 被告 冯某 离婚 。 

陈某某与刘某某离婚纠纷一审民事判决书.txt	不 准许 原告 陈 某某 与 被告 刘 某某 离婚 。 

陈某某与唐某某离婚纠纷一审民事判决书.txt	准许 原告 陈 某某 与 被告 唐 某某 离婚 。 二 、 子唐某 健由 被告 唐 某某 抚养 ， 原告 陈 某某 从 2016 年 5 月 起 ， 每月 承担 小孩 抚养费 300 元 ， 至 其 十八周岁 止 。 本 判决 发生 法律效力 前 双方 不得 另行 结婚 。 

陈某某与明某甲离婚纠纷一审民事判决书.txt	不准 原告 陈 某某 与 被告 明某 甲 离婚 。 

陈某某与毛某某离婚纠纷一审民事判决书.txt	不予 准许 原告 陈 某某 与 被告 毛 某某 离婚 。 

陈某某与江某某离婚纠纷案一审民事判决书.txt	一 、 原告 陈 某某 与 被告 江 某某 离婚 。 二 、 由 陈 某某 给付 江 某某 经济 帮助 款 人民币 8000 元 。 此款 限本 判决书 发生 法律效力 之日起 十日 内 付清 。 如果 未 按 本 判决 指定 的 期限 履行 给付 金钱 义务 ， 应当 依照 《 中华人民共和国 民事 诉讼法 》 第 二百五十 三条 之 规定 ， 加倍 支付 延迟 履行 期间 的 债务 利息 。 

陈某某与王某某离婚纠纷一审民事判决书.txt	不 准许 原告 陈 某某 与 被告 王 某某 离婚 。 

陈某某与谢某甲离婚纠纷一审民事判决书.txt	不准 原告 陈 某某 与 被告 谢某 甲 离婚 。 

陈某某与邓某某离婚纠纷一审民事判决书.txt	不准 原告 陈 某某 与 被告 邓 某某 离婚 ； 

陈某某诉余某甲离婚纠纷一审民事判决书.txt	不准 原告 陈 某某 与 被告 余某 甲 离婚 。 

陈某某诉刘某某离婚纠纷一审民事判决书.txt	不准 原告 陈 某某 与 被告 刘 某某 离婚 。 

陈某某诉被告张某某离婚纠纷一审民事判决书.txt	准予 原告 陈 某某 与 被告 张 某某 离婚 ； 

陈某某诉被告郭某某离婚纠纷一审民事判决书.txt	不 准予 原告 陈 某某 与 被告 郭 某某 离婚 。 

陈某某诉邱某甲离婚纠纷一审民事判决书.txt	不准 原告 陈 某某 与 被告 邱某 甲 离婚 。 

陈某梅与孙某离婚纠纷一审民事判决书.txt	不 准予 原告 陈某梅 与 被告 孙某 离婚 。 

陈某甲与王某甲离婚纠纷一审民事裁定书.txt	本案 按 撤诉 处理 。 

陈某甲与董某某离婚纠纷一审民事判决书.txt	一 、 准予 原告 陈某甲 与 被告 董 某某 离婚 ； 二 、 女 陈某乙 由 原告 陈某 甲 抚养 教育 ， 被告 董 某某 每月 支付 女 陈某 乙 生活费 450 元 ， 女 陈某乙 的 教育费 、 医疗费 凭 有效 票据 原告 陈某 甲 、 被告 董 某某 每年 各 承担 一半 ， 至 女 陈某 乙 独立 生活 时 止 ， 以上 费用 每年 12 月 30 日前 结清 ； 三 、 被告 董 某某 享有 探视 女 陈某乙 的 权利 ， 每月 探视 一 到 两次 ， 女 陈某 乙 上学 后 ， 在 不 影响 女 陈某 乙 学习 、 生活 的 情况 下 ， 每月 探视 一 到 两次 ， 寒暑假 探视 一 到 两周 ， 具体 探视 时间 、 方式 由 双方 自行 协商 。 在 本 判决 发生 法律效力 前 ， 原 、 被告 不得 另行 结婚 。 

陈某诉刘某离婚纠纷一审民事判决书.txt	一 、 准予 原告 陈某 与 被告 刘某 离婚 ； 二 、 婚生女 刘某 甲 随 原告 陈某 生活 ， 被告 刘某 负担 抚养费 500 元 / 月 ， 至 刘某 甲 具有 独立 生活 能力 为止 。 

陈甲某某与刘某某离婚纠纷一审民事判决书.txt	不准 陈甲 某某 与 刘 某某 离婚 。 

陈艳诉姚发强离婚纠纷案一审民事判决书.txt	一 、 不准 原告 陈某 与 被告 姚某 离婚 。 二 、 驳回 原告 陈某 的 其他 诉讼请求 。 

陈英与刘凡刚离婚纠纷二审民事裁定书.txt	一 、 撤销 四川省 资中县 人民法院 （ 2015 ） 资中 民初 字 第 3038 号 民事判决 ； 二 、 发回 四川省 资中县 人民法院 重审 。 

陶某与任某离婚纠纷一审民事判决书.txt	不准 原告 陶 某某 与 被告 任 某某 离婚 。 

陶某与伏某某离婚纠纷一审民事判决书.txt	一 、 准予 原告 陶某 与 被告 伏 某某 离婚 ； 二 、 婚生子 陶 某某 由 原告 陶某 抚养 ， 抚养费 用 由 原告 陶某 自行 负担 。 

陶某某诉杨某某离婚纠纷一案一审民事判决书.txt	不准 原告 陶 某某 与 被告 杨 某某 离婚 。 

雍与黄某某离婚纠纷一审民事判决书.txt	不准 原告 雍 某某 与 被告 黄 某某 离婚 。 

雍某某与黄某某离婚纠纷一审民事判决书.txt	不准 原告 雍 某某 与 被告 黄 某某 离婚 。 

雍某某诉被告王某某、姜某甲、姜某乙离婚后财产纠纷一审民事判决书.txt	一 、 由 被告 王 某某 、 姜某 甲 、 姜某乙 在 本 判决 生效 之日起 十日 内 一次性 支付 原告 雍 某某 现金 125000 元 。 二 、 驳回 原告 雍 某某 的 其他 诉讼请求 。 如果 未 按 本 判决 指定 的 期间 履行 金钱 给付 义务 ， 应当 按照 《 中华人民共和国 民事 诉讼法 》 第 二百五十 三条 之 规定 ， 加倍 支付 迟延 履行 期间 的 债务 利息 。 

雷某与陈某离婚纠纷一审民事判决书.txt	不准 雷某 、 陈某 离婚 。 

韩某与伏某离婚纠纷一审民事判决书.txt	不准 原告 韩 某某 与 被告 伏 某某 离婚 。 

韩某与夏某某离婚纠纷一案一审民事判决书.txt	不准 原告 韩某 与 被告 夏 某某 离婚 。 

韩某某与余某某离婚纠纷一审民事判决书.txt	一 、 原告 韩 某某 与 被告 余 某某 离婚 。 二 、 婚生子 余某乙 由 原告 韩 某某 抚养 。 

韩某某与宗某某离婚纠纷一审民事判决书.txt	原告 韩 某某 要求 与 被告 宗 某某 离婚 ， 本院 不予 准许 。 

顾某与程某某甲离婚纠纷一审民事判决书.txt	不 准予 原告 顾某 与 被告 程 某某 甲 离婚 。 

顾某某与张某某离婚纠纷一审民事判决书.txt	不准 原告 顾 某某 与 被告 张 某某 离婚 。 

顾某某诉尹某某离婚纠纷一审民事判决书.txt	不准 原告 顾 某某 与 被告 尹 某某 离婚 。 

顾某某诉谭某某离婚纠纷一审判决书.txt	不准 原告 顾 某某 与 被告 谭 某某 离婚 。 

颜某某与李某某离婚纠纷案一审民事判决书.txt	一 、 准予 原告 颜 某某 和 被告 李 某某 离婚 ； 二 、 婚生子 随 原告 生活 ， 被告 于 本 判决 生效 之日起 每月 支付 小孩 抚养费 500 元 至 小孩 独立 生活 时 止 。 

马某某与何某甲离婚纠纷一审民事判决书.txt	不 准予 原告 马 某某 与 被告 何某 甲 离婚 。 

马某某与刘某甲离婚纠纷一审民事判决书.txt	原告 马 某某 诉请 与 被告 刘某 甲 离婚 ， 不予 准许 。 

马某某与张某甲离婚纠纷一审民事判决书.txt	一 、 准予 原告 马 某某 与 被告 张某 甲 离婚 ； 二 、 女儿 张某乙 随 原告 马 某某 生活 自行 抚养 。 

骆某某与陈某甲离婚纠纷一审民事判决书.txt	不 准予 原告 骆 某某 与 被告 陈某 甲 离婚 。 

高某与唐某某离婚纠纷一审民事判决书.txt	不准 原告 高某 与 被告 唐某 甲 离婚 。 

高某与杨某某离婚纠纷一审民事裁定书.txt	本案 按 撤诉 处理 。 

高某某与夏某甲离婚纠纷一审民事判决书.txt	一 、 准许 原告 高 某某 与 被告 夏某 甲 离婚 。 二 、 婚生子 夏乙 由 原告 高 某某 抚养 。 

高某某与杨某甲离婚纠纷案一审民事判决书.txt	不准 原告 高 某某 与 被告 杨某 甲 离婚 。 

高某某与邱某某离婚纠纷案一审民事判决书.txt	不准 原告 高 某某 与 被告 邱 某某 离婚 。 

高某甲与聂某某离婚纠纷一审民事判决书.txt	准予 原告 高某甲 与 被告 聂 某某 离婚 。 

魏某某与李某某离婚纠纷一审民事判决书.txt	不 准许 原告 魏 某某 与 被告 李 某某 离婚 。 

魏某某与邱某某离婚纠纷一审民事裁定书.txt	驳回 原告 魏 某某 对 被告 邱 某某 的 起诉 。 

魏某甲诉李某某离婚纠纷民事判决书.txt	一 、 准许 原告 魏某甲 与 被告 李 某某 离婚 ； 二 、 原 、 被告 之 婚生子 魏某乙 由 被告 李 某某 抚养 ， 原告 魏某 甲 自本 判决 生效 之 当月 起 每月 向 被告 李 某某 支付 魏某乙 的 抚养费 400 元 ， 直至 魏某 乙 年满 十八周岁 止 。 

魏某诉王某甲离婚纠纷一审民事判决书.txt	不准 原告 魏某 与 被告 王某 甲 离婚 。 

鲁某某与赵某某离婚纠纷一审民事判决书.txt	一 、 准许 原告 鲁 某某 与 被告 赵 某某 离婚 ； 二 、 婚生子 李 某某 由 被告 赵 某某 抚养 ， 原告 鲁 某某 每月 给付 生活费 500 元 ， 婚生子 李 某某 的 医疗费 、 教育费 凭 有效 正规 票据 由 原 、 被告 各 负担 一半 ， 该款 于 本 判决 生效 后 的 次月 起 每月 月底 存入 被告 赵 某某 在 中国 邮政储蓄 银行 实名 开户 的 账户 内 。 

鲜光琼与何文清离婚纠纷一审民事判决书.txt	不 准许 原告 鲜 某某 与 被告 何 某某 离婚 。 

黄云凤与张开翔、黄云九离婚后财产分割纠纷二审民事判决书.txt	驳回上诉 ， 维持原判 。 

黄某某与余某甲离婚纠纷一审民事判决书.txt	一 、 准予 原告 黄 某某 与 被告 余某 甲 离婚 ； 二 、 原 、 被告 夫妻关系 存续 期间 修建 的 位于 珙县 ＊ ＊ 镇 房屋 归 原告 余某 甲 所有 。 

黄某某与兰某某离婚纠纷二审民事判决书.txt	驳回上诉 ， 维持原判 。 

黄某某与冯某某离婚纠纷案一审民事判决书.txt	一 、 黄 某某 与 冯 某某 离婚 。 二 、 婚生女 冯某甲 由 黄 某某 抚养 ， 婚生子 冯某乙 由 冯 某某 抚养 。 

黄某某与叶某甲离婚纠纷一审民事判决书.txt	一 、 准予 原告 黄 某某 与 被告 叶某 甲 离婚 ； 二 、 原 、 被告 之 女叶 某 乙 随 原告 黄 某某 生活 ， 由 被告 叶某甲 从 2016 年 3 月 起 每月 给付 叶某 乙 抚养费 400 元 ， 直至 叶某 乙 年满 18 周岁 时 止 。 三 、 驳回 原告 的 其他 诉讼请求 。 如果 未 按 本 判决 指定 的 期间 履行 给付 金钱 义务 ， 应当 依照 《 中华人民共和国 民事 诉讼法 》 第二百 二十九条 之 规定 ， 加倍 支付 迟延 履行 期间 的 债务 利息 。 

黄某某与杨某某离婚纠纷案一审民事判决书.txt	黄 某某 与 杨 某某 离婚 。 

黄某某与牟某某离婚纠纷一审民事判决书.txt	一 、 准许 原告 黄 某某 与 被告 牟 某某 离婚 。 二 、 婚生女 牟某甲 由 原告 黄 某某 具体 抚养 ， 被告 牟 某某 每月 支付 子女 抚养费 500 元 直至 牟某 甲 独立 生活 时 止 ， 被告 有 探视 子女 的 权利 ， 原告 有 协助 的 义务 。 三 、 驳回 原告 的 其他 诉讼请求 。 

黄某某与艾某某离婚纠纷一审民事判决书.txt	不予 准许 原告 黄 某某 与 被告 艾 某某 离婚 。 

黄某某与苏某某离婚纠纷一审民事判决书.txt	不准 原告 黄 某某 与 被告 苏 某某 离婚 。 

黄某某与邓某某离婚纠纷一审民事判决书.txt	原告 黄 某某 诉 与 被告 邓 某某 离婚 ， 不予 准许 。 

黄某某与陈某某离婚后财产纠纷一审民事判决书.txt	被告 陈 某某 于 本 判决 生效 后 30 日 内 支付 原告 黄 某某 欠款 5 万元 。 如果 未 按 判决 指定 的 期间 履行 给付 金钱 义务 ， 应当 依照 《 中华人民共和国 民事 诉讼法 》 第 二百五十 三条 之 规定 ， 加倍 支付 迟延 履行 期间 的 债务 利息 。 

黄某某与陈某某离婚纠纷一审民事判决书.txt	不准 黄 某某 、 陈 某某 离婚 。 

黄某某与魏某某离婚纠纷一审民事判决书.txt	不 准予 原告 黄 某某 与 被告 魏 某某 离婚 。 

黄某某诉杨某某离婚纠纷一审民事判决书.txt	不准 原告 黄 某某 与 被告 杨 某某 离婚 。 

黄某某诉王某某离婚纠纷一审民事判决书.txt	一 、 准许 原告 黄 某某 与 被告 王 某某 离婚 ； 二 、 儿子 黄某 甲 随 原告 黄 某某 一起 生活 ， 被告 王 某某 自 2016 年 4 月 起 每月 15 号 前 支付 黄某 甲 的 当月 生活费 400 元 ， 至 黄某 甲 独立 生活 时 止 ， 在此期间 所 产生 的 教育费 、 医疗费 凭 票据 由 原告 黄 某某 、 被告 王 某某 各 负担 一半 。 如果 未 按 本 判决 指定 的 期间 履行 给付 金钱 义务 ， 应当 依照 《 中华人民共和国 民事 诉讼法 》 第 二百五十 三条 之 规定 ， 加倍 支付 迟延 履行 期间 的 债务 利息 。 

黄某甲与刘某甲离婚纠纷二审民事判决书.txt	驳回上诉 ， 维持原判 。 

黄某甲与宋某甲离婚纠纷一审民事判决书.txt	不准 原告 黄某甲 与 被告 宋某 甲 离婚 。 

黄某甲与程某某离婚纠纷一审民事判决书.txt	不准 原告 黄某甲 与 被告 程 某某 离婚 。 

黎某某与周某某离婚纠纷一审民事判决书.txt	不 准予 原告 黎 某某 与 被告 周 某某 离婚 。 

黎某某与杨某某离婚纠纷一审民事判决书.txt	不准 原告 黎 某某 与 被告 杨清定 离婚 。 

龙某某与刘某某离婚纠纷一审民事判决书.txt	准予 原告 龙 某某 、 被告 刘 某某 离婚 。 

龙某某与高某某离婚纠纷案一审民事判决书.txt	不准 原告 龙 某某 与 被告 高 某某 离婚 。 

龙某诉曹某离婚纠纷一审民事判决书.txt	不 准予 原告 龙某 与 被告 曹某 离婚 。 

龚某某与周某某离婚纠纷一审民事判决书.txt	准予 原告 龚 某某 与 被告 周 某某 离婚 。 

龚某某与岳某某离婚纠纷案一审民事判决书.txt	龚 某某 与 岳 某某 离婚 。 

龚某某与方某某离婚纠纷一审民事判决书.txt	不 准予 原告 龚 某某 与 被告方 某某 离婚 。 

龚某某与李某某离婚纠纷一审民事判决书.txt	准予 原告 龚 某某 与 被告 李 某某 离婚 。 

龚某某诉徐某某离婚纠纷一审民事判决书.txt	不 准予 原告 龚 某某 与 被告 徐 某某 离婚 。 

龚某某诉毕某某离婚纠纷一审民事判决书.txt	一 、 准予 原告 龚 某某 与 被告 毕 某某 离婚 ； 二 、 原 、 被告 的 非婚生子 毕某甲 由 原告 龚 某某 抚养 ， 其 抚养费 由 原告 龚 某某 自理 。 

龚某甲与张某某离婚纠纷案一审民事判决书.txt	不准 原告 龚某甲 与 被告 张 某某 离婚 ； 

龚靖与刘华离婚纠纷一审民事判决书.txt	不 准予 原告 龚某 与 被告 刘某 离婚 。 
