丁某某与宋某某离婚纠纷一审民事裁定书.txt	依照 《 中华人民共和国 民事 诉讼法 》 第 一百四十 五条 之 规定 ， 裁定 如下 ： 

丁某某与杨某某离婚纠纷一审民事裁定书.txt	依照 《 中华人民共和国 民事 诉讼法 》 第 一百四十 五条 的 规定 ， 裁定 如下 ： 

丁某某与陈某某离婚纠纷一审民事裁定书.txt	依照 《 中华人民共和国 民事 诉讼法 》 第 一百四十 五条 第一款 、 第一百五十四条 第一款 （ 五项 ） 之 规定 ， 裁定 如下 ： 

万某与刘阳某婚一审民事裁定书.txt	根据 《 中华人民共和国 民事 诉讼法 》 第三十六条 、 最高人民法院 《 关于 适用 ﹤ 中华人民共和国 民事 诉讼法 ﹥ 的 解释 》 第三十五条 的 规定 ， 裁定 如下 ： 

严某某与唐某某离婚纠纷一审民事裁定书.txt	依照 《 中华人民共和国 民事 诉讼法 》 第 一百四十 五条 之 规定 ， 裁定 如下 ： 

严某某与张某某离婚纠纷一审民事裁定书.txt	依照 《 中华人民共和国 民事 诉讼法 》 第 一百四十 五条 之 规定 ， 裁定 如下 ： 

严某某与王某某离婚纠纷案一审民事裁定书.txt	依照 《 中华人民共和国 民事 诉讼法 》 第 一百四十 五条 之 规定 ， 裁定 如下 ： 

严某某诉郑某离婚纠纷一审民事裁定书.txt	根据 《 中华人民共和国 民事 诉讼法 》 第 一百四十 五条 之 规定 ， 裁定 如下 ： 

仁某诉东某离婚纠纷一案民事裁定书.txt	依照 《 中华人民共和国 民事 诉讼法 》 第 一百四十 五条 、 《 中华人民共和国 诉讼费用 交纳 办法 》 第三十四条 第一款 的 规定 ， 裁定 如下 ： 

代某某与庞某某离婚纠纷一审民事裁定书.txt	依照 《 中华人民共和国 民事 诉讼法 》 第十三条 第二款 当事人 有权 在 法律 规定 的 范围 内 处分 自己 的 民事权利 和 诉讼 权利 、 第 一百四十 五条 第一款 宣判 前 ， 原告 申请 撤诉 的 ， 是否 准许 ， 由 人民法院 裁定 的 规定 ， 裁定 如下 ： 

代某某与王某某离婚纠纷一审民事裁定书.txt	依照 《 中华人民共和国 民事 诉讼法 》 第 一百四十 五条 的 规定 ， 裁定 如下 ： 

代某某与罗某某离婚纠纷一审民事裁定书.txt	依照 《 中华人民共和国 民事 诉讼法 》 第 一百四十 五条 第一款 " 宣判 前 ， 原告 申请 撤诉 的 ， 是否 准许 ， 由 人民法院 裁定 " 、 第一百五十四条 第一款 第五项 " 裁定 适用 于 下列 范围 ： （ 五 ） 准许 或者 不 准许 撤诉 " 之 规定 ， 裁定 如下 ： 

代某某诉许某某离婚纠纷一审裁定书.txt	依照 《 中华人民共和国 民事 诉讼法 》 第 一百四十 五条 第一款 " 宣判 前 ， 原告 申请 撤诉 的 ， 是否 准许 ， 由 人民法院 裁定 " 的 规定 ， 裁定 如下 ： 

仲某某与张某离婚纠纷一审民事裁定书.txt	据此 ， 依照 《 中华人民共和国 民事 诉讼法 》 第 一百四十 五条 第一款 " 宣判 前 ， 原告 申请 撤诉 的 ， 是否 准许 ， 由 人民法院 裁定 " 之 规定 ， 裁定 如下 ： 

仲某某与王某某离婚纠纷一审民事裁定书.txt	据此 ， 依照 《 中华人民共和国 民事 诉讼法 》 第 一百四十 五条 第一款 " 宣判 前 ， 原告 申请 撤诉 的 ， 是否 准许 ， 由 人民法院 裁定 。 " 之 规定 ， 裁定 如下 ： 

仲某某诉朱某某离婚纠纷一审民事裁定书.txt	依照 《 中华人民共和国 民事 诉讼法 》 第 一百四十 五条 之 规定 ， 裁定 如下 ： 

任某与王某离婚纠纷一审民事裁定书.txt	依照 《 中华人民共和国 民事 诉讼法 》 第 一百四十 五条 第一款 之 规定 ， 裁定 如下 ： 

任某与陈某离婚纠纷一审民事裁定书.txt	依照 《 中华人民共和国 民事 诉讼法 》 第 一百四十 五条 之 规定 ， 裁定 如下 

任某某与李某某离婚纠纷一审民事裁定书.txt	依照 《 中华人民共和国 民事 诉讼法 》 第 一百四十 五条 第一款 之 规定 ， 裁定 如下 ： 

任某某与汪某离婚纠纷一审民事裁定书.txt	依照 《 中华人民共和国 民事 诉讼法 》 第十三条 第二款 当事人 有权 在 法律 规定 的 范围 内 处分 自己 的 民事权利 和 诉讼 权利 、 第 一百四十 五条 第一款 宣判 前 ， 原告 申请 撤诉 的 ， 是否 准许 ， 由 人民法院 裁定 的 规定 ， 裁定 如下 ： 

任某某与沈某某离婚纠纷一审民事裁定书.txt	据此 ， 依照 《 中华人民共和国 民事 诉讼法 》 第 一百四十 五条 第一款 " 宣判 前 ， 原告 申请 撤诉 的 ， 是否 准许 ， 由 人民法院 裁定 。 " 之 规定 ， 裁定 如下 ： 

任某诉袁某离婚纠纷一审民事裁定书.txt	依照 《 中华人民共和国 民事 诉讼法 》 第 一百四十 五条 规定 ， 裁定 如下 ： 

伍某与胡某离婚纠纷一审民事裁定书.txt	依照 《 中华人民共和国 民事 诉讼法 》 第 一百四十 五条 第一款 之 规定 ， 裁定 如下 ： 

伍某某与陈某离婚纠纷一审民事裁定书.txt	据此 ， 依照 《 中华人民共和国 民事 诉讼法 》 第 一百四十 五条 第一款 之 规定 ， 裁定 如下 ： 

伏某与杨某某离婚纠纷一审民事裁定书.txt	依照 《 中华人民共和国 民事 诉讼法 》 第一百五十四条 之 规定 ， 裁定 如下 ： 

何某与刘某离婚纠纷一审民事裁定书.txt	依照 《 中华人民共和国 民事 诉讼法 》 第 一百四十 五条 第一款 之 规定 ， 裁定 如下 ： 

何某与宁某离婚纠纷一审民事裁定书.txt	根据 《 中华人民共和国 民事 诉讼法 》 第 一百四十 五条 之 规定 ， 裁定 如下 ： 

何某与张某离婚纠纷裁定书.txt	依照 《 中华人民共和国 民事 诉讼法 》 第 一百四十 五条 的 规定 ， 裁定 如下 ： 

何某与彭某某离婚纠纷一案一审民事裁定书.txt	依照 《 中华人民共和国 民事 诉讼法 》 第 一百四十 五条 的 规定 ， 裁定 如下 ： 

何某与赵某离婚纠纷一审民事裁定书.txt	根据 《 中华人民共和国 民事 诉讼法 》 第 一百四十 五条 之 规定 ， 裁定 如下 ： 

何某容与聂某元离婚纠纷民事裁定书.txt	根据 《 中华人民共和国 民事 诉讼法 》 第十三条 二款 、 第 一百四十 五条 之 规定 ， 裁定 如下 ： 

何某某与曹某某离婚纠纷一审民事裁定书.txt	依照 《 中华人民共和国 民事 诉讼法 》 第 一百四十 五条 第一款 之 规定 ， 裁定 如下 ： 

何某某与曾某某离婚纠纷一审民事裁定书.txt	依照 《 中华人民共和国 民事 诉讼法 》 第 一百四十 五条 第一款 宣判 前 ， 原告 申请 撤诉 的 ， 是否 准许 ， 由 人民法院 裁定 、 第一百五十四条 第一款 第五项 裁定 适用 于 下列 范围 ： （ 五 ） 准许 或者 不 准许 撤诉 之 规定 ， 裁定 如下 ： 

何某某与李某某离婚后财产纠纷一审民事裁定书.txt	依照 《 中华人民共和国 民事 诉讼法 》 第十三条 、 第 一百四十 五条 的 规定 ， 裁定 如下 ： 

何某某与李某某离婚纠纷一审民事裁定书.txt	依照 《 中华人民共和国 民事 诉讼法 》 第 一百四十 五条 第一款 的 规定 ， 裁定 如下 ： 

何某某与林某某离婚纠纷一审民事裁定书.txt	依照 《 中华人民共和国 民事 诉讼法 》 第 一百四十 五条 第一款 、 第一百五十四条 第一款 （ 五项 ） 之 规定 ， 裁定 如下 ： 

何某某与秦某某离婚纠纷一审民事裁定书.txt	依照 《 中华人民共和国 民事 诉讼法 》 第十三条 第二款 、 第 一百四十 五条 第一款 之 规定 ， 裁定 如下 ： 

何某某与罗某某离婚纠纷一审民事裁定书.txt	依照 《 中华人民共和国 民事 诉讼法 》 第 一百四十 五条 第一款 的 规定 ， 裁定 如下 ： 

何某某与胡某某离婚纠纷一审民事裁定书.txt	依照 《 中华人民共和国 民事 诉讼法 》 第 一百四十 三条 之 规定 ， 裁定 如下 ： 

何某某与陈某某离婚纠纷一审民事裁定书.txt	根据 《 中华人民共和国 民事 诉讼法 》 第 一百四十 五条 第一款 之 规定 ， 裁定 如下 ： 

何某某诉文某某离婚纠纷一审民事裁定书.txt	依照 《 中华人民共和国 民事 诉讼法 》 第十三条 第二款 、 第 一百四十 五条 之 规定 ， 裁定 如下 ： 

何某某诉李某离婚纠纷一审民事裁定书.txt	依照 《 中华人民共和国 民事 诉讼法 》 第 一百四十 五条 第一款 之 规定 ， 裁定 如下 ： 

何某某诉杨某某离婚纠纷一审民事裁定书.txt	依照 《 中华人民共和国 民事 诉讼法 》 第 一百四十 五条 之 规定 ， 裁定 如下 ： 

何某某诉罗某某离婚纠纷裁定书.txt	依照 《 中华人民共和国 民事 诉讼法 》 第 一百四十 五条 之 规定 ， 裁定 如下 ： 

何某某诉陶某某离婚纠纷案一审民事裁定书.txt	依照 《 中华人民共和国 民事 诉讼法 》 第十三条 第二款 、 第 一百四十 五条 第一款 之 规定 ， 裁定 如下 ： 

余某与曾某离婚纠纷一审民事裁定书.txt	依照 《 中华人民共和国 民事 诉讼法 》 第 一百四十 五条 的 规定 ， 裁定 如下 ： 

余某与赵某离婚纠纷一审民事裁定书.txt	依照 《 中华人民共和国 民事 诉讼法 》 第 一百四十 五条 之 规定 ， 裁定 如下 ： 

余某与陈某离婚纠纷案一审民事裁定书.txt	依照 《 中华人民共和国 民事 诉讼法 》 第 一百四十 五条 之 规定 ， 裁定 如下 ： 

余某平与王某会离婚纠纷一审民事裁定书.txt	依照 《 中华人民共和国 民事 诉讼法 》 第 一百四十 五条 规定 ， 裁定 如下 ： 

余某某与刘某某离婚纠纷一审民事裁定书.txt	依照 《 中华人民共和国 民事 诉讼法 》 第 一百四十 五条 第一款 " 宣判 前 ， 原告 申请 撤诉 的 ， 是否 准许 ， 由 人民法院 裁定 " 之 规定 ， 裁定 如下 ： 

余某某与张某某离婚纠纷案一审民事裁定书.txt	依照 《 中华人民共和国 民事 诉讼法 》 第 一百一十 八条 第一 、 二款 及 《 最高人民法院 关于 适用 ﹤ 中华人民共和国 民事 诉讼法 ﹥ 的 解释 》 第 二百一十三 条 的 规定 ， 裁定 如下 ： 

余某某与方某某离婚纠纷一审民事裁定书.txt	依照 《 中华人民共和国 民事 诉讼法 》 第 一百四十 五条 第一款 " 宣判 前 ， 原告 申请 撤诉 的 ， 是否 准许 ， 由 人民法院 裁定 。 " 的 规定 ， 裁定 如下 ： 

余某某与梁某某离婚后财产纠纷一审民事裁定书.txt	依照 《 中华人民共和国 民事 诉讼法 》 第一百 九十五条 的 规定 ， 裁定 如下 ： 

余某某与罗某某离婚纠纷一审民事裁定书.txt	依照 《 中华人民共和国 民事 诉讼法 》 第 一百四十 五条 第一款 之 规定 ， 裁定 如下 ： 

余某某与苏某某离婚纠纷一审民事裁定书.txt	依照 《 中华人民共和国 民事 诉讼法 》 第 一百四十 五条 之 规定 ， 裁定 如下 ： 

余某某与被告赵某某离婚纠纷民事裁定书.txt	依照 《 中华人民共和国 民事 诉讼法 》 第 一百四十 五条 之 规定 ， 裁定 如下 ： 

余某某与黄某某离婚纠纷一审民事裁定书.txt	依照 《 中华人民共和国 民事 诉讼法 》 第十三条 第二款 、 第 一百四十 五条 第一款 之 规定 ， 裁定 如下 ： 

余某某诉周某某离婚纠纷一审民事裁定书.txt	依照 《 中华人民共和国 民事 诉讼法 》 第十三条 第二款 、 第 一百四十 五条 第一款 的 规定 ， 裁定 如下 ： 

余某燕与张某离婚纠纷一审民事裁定书.txt	依照 《 中华人民共和国 民事 诉讼法 》 第十三条 第二款 、 第一百 二十一条 第一款 、 一百五十 四条 第十一 款 的 规定 ， 裁定 如下 ： 

侯万平与赖国平离婚纠纷一案民事裁定书.txt	依照 《 中华人民共和国 民事 诉讼法 》 第 一百四十 五条 之 规定 ， 裁定 如下 ： 

侯某与邓某某离婚纠纷一审民事裁定书.txt	依照 《 中华人民共和国 民事 诉讼法 》 第 一百四十 五条 第一款 的 规定 ， 裁定 如下 ： 

倪某某与万某某离婚纠纷一审民事裁定书.txt	依照 《 中华人民共和国 民事 诉讼法 》 第 一百四十 五条 的 规定 ， 裁定 如下 ： 

倪某某诉孙某某离婚纠纷一审民事裁定书.txt	依照 《 中华人民共和国 民事 诉讼法 》 第 一百四十 五条 、 第一百五十四条 的 相关 规定 ， 裁定 如下 ： 

兰某与王某离婚纠纷一审民事裁定书.txt	依照 《 中华人民共和国 民事 诉讼法 》 第 一百四十 五条 第一款 之 规定 ， 裁定 如下 ： 

冉某与寇某离婚纠纷一审民事裁定书.txt	根据 《 中华人民共和国 民事 诉讼法 》 第 一百四十 五条 之 规定 ， 裁定 如下 ： 

冉某某与邓某某离婚纠纷一审民事裁定书.txt	据此 ， 依照 《 中华人民共和国 民事 诉讼法 》 第 一百四十 五条 第一款 " 宣判 前 ， 原告 申请 撤诉 的 ， 是否 准许 ， 由 人民法院 裁定 。 " 之 规定 ， 裁定 如下 ： 

冯某某与周某某离婚纠纷一审民事裁定书.txt	根据 《 中华人民共和国 民事 诉讼法 》 第 一百四十 五条 之 规定 ， 裁定 如下 ： 

冯某某与唐某某离婚纠纷一案一审民事裁定书.txt	依照 《 中华人民共和国 民事 诉讼法 》 第 一百四十 五条 的 规定 ， 裁定 如下 ： 

冯某某与张某离婚纠纷一审民事裁定书.txt	依照 《 中华人民共和国 民事 诉讼法 》 第 一百四十 五条 第一款 宣判 前 ， 原告 申请 撤诉 的 ， 是否 准许 ， 由 人民法院 裁定 之 规定 ， 裁定 如下 ： 

冯某某与王某某离婚纠纷一审民事裁定书.txt	依照 《 中华人民共和国 民事 诉讼法 》 第 一百四十 五条 的 规定 ， 裁定 如下 ： 

冯某某与赵某某离婚纠纷一审民事裁定书.txt	依照 《 中华人民共和国 民事 诉讼法 》 第 一百四十 五条 的 规定 ， 裁定 如下 ： 

冯某某诉俞某某离婚纠纷一审民事裁定书.txt	依照 《 中华人民共和国 民事 诉讼法 》 第 一百四十 五条 之 规定 ， 裁定 如下 ： 

冯正桂与王蚁棚离婚纠纷一审民事裁定书.txt	依照 《 中华人民共和国 民事 诉讼法 》 第 一百四十 五条 的 规定 ， 裁定 如下 ： 

刘文婷与张登良离婚后财产纠纷一审民事裁定书.txt	依照 《 中华人民共和国 民事 诉讼法 》 第 一百四十 五条 第一款 之 规定 ， 裁定 如下 ： 

刘春连与张明付离婚后财产纠纷案再审审查民事裁定书.txt	本院认为 ， 本案 已经 四川省 高级人民法院 审查 终结 ， 并 以 （ 2015 ） 川民 申字 第 1120 号 民事裁定 ， 驳回 了 再审 申请人 刘 某某 的 再审 申请 。 因此 ， 刘 某某 向 本院 申请 再审 不 属于 本院 受理 范畴 。 依照 最高人民法院 关于 适用 《 中华人民共和国 民事 诉讼法 》 的 解释 第三 百八十 三条 第一款 第一项 之 规定 ， 裁定 如下 ： 

刘某与周某离婚纠纷一审民事裁定书.txt	依照 《 中华人民共和国 民事 诉讼法 》 第 一百四十 五条 的 规定 ， 裁定 如下 ： 

刘某与康某离婚纠纷一审民事裁定书.txt	依照 《 中华人民共和国 民事 诉讼法 》 第 一百四十 五条 第一款 之 规定 ， 裁定 如下 ： 

刘某与梁某离婚纠纷一审民事裁定书.txt	根据 《 中华人民共和国 民事 诉讼法 》 第 一百四十 五条 之 规定 ， 裁定 如下 ： 

刘某与王某某离婚纠纷一审民事裁定书.txt	根据 《 中华人民共和国 民事 诉讼法 》 第 一百四十 五条 第一款 之 规定 ， 裁定 如下 ： 

刘某与程某离婚后财产纠纷一审民事裁定书.txt	依照 《 中华人民共和国 民事 诉讼法 》 第 一百四十 五条 第一款 的 规定 ， 裁定 如下 ： 

刘某与肖某离婚后财产纠纷一审民事裁定书.txt	依照 《 中华人民共和国 民事 诉讼法 》 第 一百四十 五条 一款 之 规定 ， 裁定 如下 ： 

刘某与袁某离婚纠纷一审民事裁定书.txt	依照 《 中华人民共和国 民事 诉讼法 》 第 一百四十 五条 的 规定 ， 裁定 如下 ： 

刘某与许某离婚纠纷一审民事裁定书.txt	依照 《 中华人民共和国 民事 诉讼法 》 第 一百四十 五条 第一款 之 规定 ， 裁定 如下 ： 

刘某与陈某离婚纠纷一审民事裁定书.txt	依照 《 中华人民共和国 民事 诉讼法 》 第 一百四十 五条 第一款 之 规定 ， 裁定 如下 ： 

刘某某与冯某某离婚纠纷一审民事裁定书.txt	依照 《 中华人民共和国 民事 诉讼法 》 第 一百四十 五条 第一款 的 规定 ， 裁定 如下 ： 

刘某某与匡某某离婚纠纷一审民事裁定书.txt	依照 《 中华人民共和国 民事 诉讼法 》 第 一百四十 五条 的 规定 ， 裁定 如下 ： 

刘某某与吴某某离婚纠纷一审民事裁定书.txt	依照 《 中华人民共和国 民事 诉讼法 》 第 一百四十 五条 第一款 之 规定 ， 裁定 如下 ： 

刘某某与宋某某离婚纠纷一审民事裁定书.txt	据此 ， 依照 《 中华人民共和国 民事 诉讼法 》 第 一百四十四 条 、 第一百五十四条 第一款 （ 十一 ） 项之 规定 ， 裁定 如下 ： 

刘某某与张某某离婚纠纷一审民事裁定书.txt	依照 《 中华人民共和国 民事 诉讼法 》 第 一百四十 五条 第一款 的 规定 ， 裁定 如下 ： 

刘某某与朱某某离婚纠纷一审民事裁定书.txt	依照 《 中华人民共和国 民事 诉讼法 》 第 一百四十 三条 之 规定 ， 裁定 如下 ： 

刘某某与罗某某离婚纠纷一审民事裁定书.txt	依照 《 中华人民共和国 民事 诉讼法 》 第 一百四十 五条 第一款 的 规定 ， 裁定 如下 ： 

刘某某与肖某某离婚纠纷一审民事裁定书.txt	依照 《 中华人民共和国 民事 诉讼法 》 第 一百四十 五条 第一款 之 规定 ， 裁定 如下 ： 

刘某某与范某某离婚纠纷一审民事裁定书.txt	依照 《 中华人民共和国 民事 诉讼法 》 第 一百四十 五条 第一款 之 规定 ， 裁定 如下 ： 

刘某某与谢某某离婚纠纷一审民事裁定书.txt	根据 《 中华人民共和国 民事 诉讼法 》 第 一百四十 五条 之 规定 ， 裁定 如下 ： 

刘某某与郑某某离婚纠纷一审民事裁定书.txt	依照 《 中华人民共和国 民事 诉讼法 》 第 一百四十 五条 第一款 宣判 前 ， 原告 申请 撤诉 的 ， 是否 准许 ， 由 人民法院 裁定 、 第一百五十四条 第一款 第五项 裁定 适用 于 下列 范围 ： （ 五 ） 准许 或者 不 准许 撤诉 之 规定 ， 裁定 如下 ： 

刘某某与陈某某离婚纠纷一审民事裁定书.txt	依照 《 中华人民共和国 民事 诉讼法 》 第 一百四十 五条 的 规定 ， 裁定 如下 ： 

刘某某与陈某某离婚纠纷一案一审民事裁定书.txt	依照 《 中华人民共和国 民事 诉讼法 》 第十三条 第二款 、 第 一百四十 五条 第一款 之 规定 ， 裁定 如下 ： 

刘某某与马某某离婚纠纷一审民事裁定书.txt	依照 《 中华人民共和国 民事 诉讼法 》 第 一百一十 九条 第二款 ， 《 最高人民法院 关于 适用 简易程序 审理 民事案件 的 若干 规定 》 第八条 第二款 之 规定 ， 裁定 如下 ： 

刘某某与鲍某某离婚纠纷一审民事裁定书.txt	依照 《 中华人民共和国 民事 诉讼法 》 第 一百一十 八条 ， 《 诉讼费用 交纳 办法 》 第二十二条 第四款 之 规定 ， 裁定 如下 ： 

刘某某诉被告张某某离婚纠纷一审民事裁定书.txt	依照 《 中华人民共和国 民事 诉讼法 》 第 一百四十 五条 的 规定 ， 裁定 如下 ： 

刘某甲与刘某乙离婚纠纷一审民事裁定书.txt	依照 《 中华人民共和国 民事 诉讼法 》 第 一百四十 五条 第一款 、 第一百五十四条 第一款 第五项 之 规定 ， 裁定 如下 ： 

刘某诉张某某离婚纠纷一审民事裁定书.txt	依照 《 中华人民共和国 民事 诉讼法 》 第 一百四十 五条 的 规定 ， 裁定 如下 ： 

刘某诉郭某某一审离婚纠纷民事裁定书.txt	依照 《 中华人民共和国 民事 诉讼法 》 第 一百四十 五条 第一款 的 规定 ， 裁定 如下 ： 

刘琳诉张洪刚离婚纠纷一审民事裁定书.txt	依照 《 中华人民共和国 民事 诉讼法 》 第 一百四十 五条 之 规定 ， 裁定 如下 ： 

刘甲与刘乙离婚纠纷一审民事裁定书.txt	依照 《 中华人民共和国 民事 诉讼法 》 第 一百四十 五条 之 规定 ， 裁定 如下 ： 

刘贤龙诉雷雪梅离婚纠纷案(2016)川1028民初671号一审民事裁定书.txt	依照 《 中华人民共和国 民事 诉讼法 》 第 一百四十 五条 的 规定 ， 裁定 如下 ： 

卢某某与敖某某离婚纠纷一审民事裁定书.txt	依照 《 中华人民共和国 民事 诉讼法 》 第十三条 、 第 一百四十 五条 第一款 之 规定 ， 裁定 如下 ： 

卢某某与黄某婚约财产纠纷一审民事裁定书.txt	依照 《 中华人民共和国 民事 诉讼法 》 第一 百十 四十五 条 、 第一百五十四条 第一款 （ 五 ） 项 的 规定 ， 裁定 如下 ： 

卿皇利诉冯学洲离婚纠纷一案民事裁定书.txt	根据 《 中华人民共和国 民事 诉讼法 》 第 一百四十 五条 之 规定 ， 裁定 如下 ： 

原告丁某某诉被告吉某某离婚纠纷一审民事裁定书.txt	依照 《 中华人民共和国 民事 诉讼法 》 第 一百四十 五条 第一款 的 规定 ， 裁定 如下 ： 

原告万某某诉被告亢某某离婚纠纷一案一审民事裁定书.txt	依照 《 中华人民共和国 民事 诉讼法 》 第 一百四十 五条 第一款 之 规定 ， 裁定 如下 ： 

原告于某某诉被告李某某离婚纠纷裁定书.txt	依照 《 中华人民共和国 民事 诉讼法 》 第 一百四十 五条 之 规定 ， 裁定 如下 ： 

原告代某某诉被告杨某某离婚后财产纠纷一审民事裁定书.txt	依照 《 中华人民共和国 民事 诉讼法 》 第 一百四十 五条 第一款 的 规定 ， 裁定 如下 ： 

原告代某某诉被告杨某某离婚纠纷案一审民事裁定书.txt	依照 《 中华人民共和国 民事 诉讼法 》 第十三条 第二款 当事人 有权 在 法律 规定 的 范围 内 处分 自己 的 民事权利 和 诉讼 权利 及第 一百四十 五条 第一款 宣判 前 ， 原告 申请 撤诉 的 ， 是否 准许 ， 由 人民法院 裁定 的 规定 ， 裁定 如下 ： 

原告任某某诉被告赖某某离婚纠纷一案一审民事裁定书.txt	依照 《 中华人民共和国 民事 诉讼法 》 第 一百四十 五条 第一款 之 规定 ， 裁定 如下 ： 

原告伍某某与被告王某离婚纠纷一审民事裁定书.txt	依照 《 中华人民共和国 民事 诉讼法 》 第 一百四十 五条 的 规定 ， 裁定 如下 ： 

原告伏某某与被告李某某“离婚纠纷”一案民事裁定书.txt	准许 原告 伏 某某 撤回 对 被告 李 某某 的 起诉 。 

原告何某与被告叶某离婚纠纷民事裁定书.txt	依照 《 中华人民共和国 民事 诉讼法 》 第 一百四十 五条 第一款 ： 宣判 前 ， 原告 申请 撤诉 的 ， 是否 准许 ， 由 人民法院 裁定 、 第一百五十四条 第一款 第 （ 五 ） 项 ： 裁定 适用 于 下列 范围 ： hellip ; hellip ; （ 五 ） 准许 或者 不 准许 撤诉 ； hellip ; hellip ; 之 规定 ， 裁定 如下 ： 

原告何某华与被告廖某国离婚纠纷一案的民事裁定书.txt	依照 《 中华人民共和国 民事 诉讼法 》 第 一百四十 三条 的 规定 ， 裁定 如下 ： 

原告何某某、王某某离婚纠纷一审民事裁定书.txt	依照 《 中华人民共和国 民事 诉讼法 》 第 一百四十 五条 第一款 的 规定 ， 裁定 如下 ： 

原告何某某与被告代某某离婚纠纷一审民事裁定书.txt	根据 《 中华人民共和国 民事 诉讼法 》 第 一百四十 五条 之 规定 ， 裁定 如下 ： 

原告何某某诉被告李某某离婚纠纷一案一审民事裁定书.txt	依照 《 中华人民共和国 民事 诉讼法 》 、 第一百五十四条 第五款 的 规定 。 裁定 如下 ： 

原告余某与被告向某某离婚纠纷一案的民事裁定书.txt	依照 《 中华人民共和国 民事 诉讼法 》 第十三条 第二款 、 第 一百四十 五条 、 第一百五十四条 第一款 第五项 之 规定 ， 裁定 如下 ： 

原告余某某与被告边巴某某离婚纠纷一审民事裁定书.txt	依据 《 中华人民共和国 民事 诉讼法 》 第 一百一十 八条 第一款 、 第一百五十四条 第一款 （ 十一 ） 项 、 《 诉讼费用 交纳 办法 》 第二十二条 第四款 之 规定 ， 裁定 如下 ： 

原告余金平诉被告刘小琼离婚纠纷一审民事裁定书.txt	依照 《 中华人民共和国 民事 诉讼法 》 第十三条 和 第 一百四十 五条 第一款 的 规定 ， 裁定 如下 ： 

原告侯某某诉被告宋某某离婚纠纷一案一审民事裁定书.txt	依照 《 中华人民共和国 民事 诉讼法 》 第 一百四十 五条 之 规定 ， 裁定 如下 ： 

原告兰某某诉被告税某某离婚纠纷一案一审民事裁定书.txt	依照 《 中华人民共和国 民事 诉讼法 》 第 一百四十 五条 第一款 之 规定 ， 裁定 如下 ： 

原告冯某某诉被告包某某离婚纠纷一审民事裁定书.txt	依照 《 中华人民共和国 民事 诉讼法 》 第 一百四十 五条 第一款 之 规定 ， 裁定 如下 ： 

原告凌某某诉被告刘某某离婚纠纷一审民事裁定书.txt	依照 《 中华人民共和国 民事 诉讼法 》 第 一百四十 五条 之 规定 ， 裁定 如下 ： 

原告凌某某诉被告廖某某离婚纠纷一案一审民事裁定书.txt	依照 《 中华人民共和国 民事 诉讼法 》 第 一百四十 五条 第一款 的 规定 ， 裁定 如下 ： 

原告凌某甲诉被告凌某乙等婚姻家庭纠纷一案一审民事裁定书.txt	依照 《 中华人民共和国 民事 诉讼法 》 第 一百四十 五条 第一款 的 规定 ， 裁定 如下 ： 

原告刘某与被告吴某某离婚纠纷一审民事裁定书.txt	依照 《 中华人民共和国 民事 诉讼法 》 第十三条 第二款 、 第 一百四十 五条 第一款 的 规定 ， 裁定 如下 ： 

原告刘某某与被告杨某某离婚纠纷案一审裁定书.txt	依照 《 中华人民共和国 民事 诉讼法 》 第 一百四十 五条 的 规定 ， 裁定 如下 ： 

原告刘某某与被告梁某离婚纠纷一案一审民事裁定书.txt	据此 ， 依照 《 中华人民共和国 民事 诉讼法 》 第 一百四十 五条 第一款 之 规定 ， 裁定 如下 ： 

原告刘某某与被告程某离婚纠纷一审民事裁定书.txt	依照 《 中华人民共和国 民事 诉讼法 》 第 一百四十 五条 的 规定 ， 裁定 如下 ： 

原告刘某某诉被告代某某离婚纠纷一案一审民事裁定书.txt	依照 《 中华人民共和国 民事 诉讼法 》 第 一百四十 五条 第一款 之 规定 ， 裁定 如下 ： 

原告刘某某诉被告吴某某离婚纠纷一案民事裁定书.txt	依照 《 中华人民共和国 民事 诉讼法 》 第 一百四十 五条 第一款 的 规定 ， 裁定 如下 ： 

原告刘某某诉被告杨某某离婚纠纷一审民事裁定书.txt	依照 《 中华人民共和国 民事 诉讼法 》 、 第一百五十四条 第五款 的 规定 。 裁定 如下 ： 

原告刘某某诉被告王某某离婚纠纷一案一审民事裁定书.txt	据此 ， 依照 《 中华人民共和国 民事 诉讼法 》 第 一百四十 五条 之 规定 ， 裁定 如下 ： 

原告刘某诉被告代某某离婚纠纷一案一审民事裁定书.txt	依照 《 中华人民共和国 民事 诉讼法 》 第 一百四十 五条 第一款 之 规定 ， 裁定 如下 ： 

原告卢某某与被告胥某某离婚纠纷民事一审裁定书.txt	依照 《 中华人民共和国 民事 诉讼法 》 第 一百四十 五条 第一款 宣判 前 ， 原告 申请 撤诉 的 ， 是否 准许 ， 由 人民法院 裁定 、 第一百五十四条 第一款 第 （ 五 ） 项 裁定 适用 于 下列 范围 ： 准许 或者 不 准许 撤诉 之 规定 ， 裁定 如下 ： 

原告卢某诉被告吴某离婚纠纷案一案一审裁定书.txt	依照 《 中华人民共和国 民事 诉讼法 》 第 一百四十 五条 第一款 的 规定 ， 裁定 如下 ： 

原告古某某诉被告丁某某离婚纠纷一案一审民事裁定书.txt	依照 《 中华人民共和国 民事 诉讼法 》 第 一百四十 五条 第一款 之 规定 ， 裁定 如下 ： 

原告叶某诉被告邓某某离婚纠纷一审民事裁定书.txt	依照 《 中华人民共和国 民事 诉讼法 》 第十三条 和 一百四十 五条 第一款 的 规定 ， 裁定 如下 ： 

原告吕某某诉被告段某某离婚纠纷一审民事裁定书.txt	根据 《 中华人民共和国 民事 诉讼法 》 第 一百四十 五条 第一款 之 规定 ， 裁定 如下 ： 

原告吴某与被告杨某某离婚纠纷一案一审民事裁定书.txt	依照 《 中华人民共和国 民事 诉讼法 》 第 一百四十 五条 的 规定 ， 裁定 如下 ： 

原告吴某某诉被告姚某某离婚纠纷案一审裁定书.txt	依照 《 中华人民共和国 民事 诉讼法 》 第 一百四十 五条 的 规定 ， 裁定 如下 ： 

原告吴某某诉被告屈某某离婚纠纷一案民事裁定书.txt	据此 ， 依照 《 中华人民共和国 民事 诉讼法 》 第 一百四十 五条 之 规定 ， 裁定 如下 ： 

原告吴某某诉被告李某某离婚纠纷一案裁定书.txt	依照 《 中华人民共和国 民事 诉讼法 》 第 一百四十 五条 第一款 的 规定 ， 裁定 如下 ： 

原告吴某某诉被告申某某离婚纠纷一案一审民事裁定书.txt	依照 《 中华人民共和国 民事 诉讼法 》 第 一百四十 五条 第一款 的 规定 ， 裁定 如下 ： 

原告吴某某诉被告陈某某离婚纠纷一案民事裁定书.txt	依据 《 中华人民共和国 民事 诉讼法 》 第 一百四十 五条 第一款 ， 第一百五十四条 （ 五 ） 项 ， 《 诉讼费 交纳 办法 》 第十五条 的 规定 ， 裁定 如下 ： 

原告周某某诉被告唐某某离婚纠纷一审民事裁定书.txt	依照 《 中华人民共和国 民事 诉讼法 》 第 一百四十 五条 的 规定 ， 裁定 如下 ： 

原告周某某诉被告朱某某离婚纠纷一审民事裁定书.txt	依照 《 中华人民共和国 民事 诉讼法 》 、 第一百五十四条 第五款 的 规定 。 裁定 如下 ： 

原告周某某诉被告禹某某离婚纠纷一审民事裁定书.txt	依照 《 中华人民共和国 民事 诉讼法 》 第 一百四十 五条 第一款 的 规定 ， 裁定 如下 ： 

原告周某某诉被告陈某某离婚纠纷一审民事裁定书.txt	依照 《 中华人民共和国 民事 诉讼法 》 第 一百四十 五条 第一款 之 规定 ， 裁定 如下 ： 

原告周某甲诉被告唐某甲离婚纠纷一审民事裁定书.txt	依照 《 中华人民共和国 民事 诉讼法 》 第 一百三十 一条 之 规定 ， 裁定 如下 ： 

原告唐某某与被告谢某某离婚纠纷一审民事裁定书.txt	据此 ， 依照 《 中华人民共和国 民事 诉讼法 》 第 一百一十 九条 、 第一百五十四条 第一款 （ 三 ） 项 及 最高人民法院 《 关于 适用 简易程序 审理 民事案件 的 若干 规定 》 第八条 第一款 （ 二 ） 项之 规定 ， 裁定 如下 ： 

原告姜某与被告黄某离婚纠纷一审民事裁定书.txt	依照 《 中华人民共和国 民事 诉讼法 》 第 一百四十 三条 的 规定 ， 裁定 如下 ： 

原告宗某诉被告史某离婚纠纷一案一审民事裁定书.txt	依照 《 中华人民共和国 民事 诉讼法 》 第 一百四十 五条 第一款 之 规定 ， 裁定 如下 ： 

原告尹某与被告岳某某离婚纠纷一案一审民事裁定书.txt	依照 《 中华人民共和国 民事 诉讼法 》 第 一百四十 三条 的 规定 ， 裁定 如下 ： 

原告尹某某与被告刘某离婚纠纷一案民事裁定书.txt	依照 《 中华人民共和国 民事 诉讼法 》 第 一百四十 五条 " 宣判 前 ， 原告 申请 撤诉 的 ， 是否 准许 ， 由 人民法院 裁定 " 之 规定 ， 裁定 如下 ： 

原告巫某与被告李某离婚纠纷民事裁定书.txt	依照 《 中华人民共和国 民事 诉讼法 》 第 一百四十 五条 第一款 ： 宣判 前 ， 原告 申请 撤诉 的 ， 是否 准许 ， 由 人民法院 裁定 、 第一百五十四条 第一款 第 （ 五 ） 项 ： 裁定 适用 于 下列 范围 ： hellip ; hellip ; （ 五 ） 准许 或者 不 准许 撤诉 ； hellip ; hellip ; 之 规定 ， 裁定 如下 ： 

原告廖某某与被告王某某离婚纠纷撤诉裁定书.txt	依照 《 中华人民共和国 民事 诉讼法 》 第 一百四十 五条 的 规定 ， 裁定 如下 ： 

原告廖某某诉被告刘某某离婚纠纷一案一审裁定书.txt	依照 《 中华人民共和国 民事 诉讼法 》 第 一百四十 五条 第一款 的 规定 ， 裁定 如下 ： 

原告张某与被告王某离婚纠纷一案一审民事裁定书.txt	根据 《 中华人民共和国 民事 诉讼法 》 第 一百四十 五条 第一款 之 规定 ， 裁定 如下 ： 

原告张某某与被告李某某离婚纠纷一案一审民事裁定书.txt	依照 《 中华人民共和国 民事 诉讼法 》 第 一百四十 五条 第一款 的 规定 ， 裁定 如下 ： 

原告张某某诉被告宗某离婚纠纷一案一审民事裁定书.txt	依照 《 中华人民共和国 民事 诉讼法 》 第 一百四十 五条 第一款 之 规定 ， 裁定 如下 ： 

原告张某某诉被告廖某某离婚纠纷一案一审民事裁定书.txt	依照 《 中华人民共和国 民事 诉讼法 》 第 一百四十 五条 第一款 之 规定 ， 裁定 如下 ： 

原告张某某诉被告程某某离婚纠纷一案一审民事裁定书.txt	依照 《 中华人民共和国 民事 诉讼法 》 第 一百四十 五条 第一款 的 规定 ， 裁定 如下 ： 

原告张某某诉被告肖某某离婚纠纷一案一审民事裁定书.txt	依照 《 中华人民共和国 民事 诉讼法 》 第 一百四十 五条 第一款 之 规定 ， 裁定 如下 ： 

原告张某某诉被告钟某某离婚纠纷一案民事裁定书.txt	依照 《 中华人民共和国 民事 诉讼法 》 第 一百四十 五条 第一款 的 规定 ， 裁定 如下 ： 

原告张某诉被告吴某某离婚纠纷一案民事裁定书.txt	依照 《 中华人民共和国 民事 诉讼法 》 第 一百四十 五条 " 宣判 前 ， 原告 申请 撤诉 的 ， 是否 准许 ， 由 人民法院 裁定 " 之 规定 ， 裁定 如下 ： 

原告张某诉被告黄某离婚纠纷一案一审裁定书.txt	依照 《 中华人民共和国 民事 诉讼法 》 第 一百四十 五条 第一款 的 规定 ， 裁定 如下 ： 

原告彭某某与被告张某某离婚纠纷一审民事裁定书.txt	依照 《 中华人民共和国 民事 诉讼法 》 第 一百四十 五条 第一款 " 宣判 前 ， 原告 申请 撤诉 的 ， 是否 准许 ， 由 人民法院 裁定 " 、 第一百五十四条 第一款 第 （ 五 ） 项 " 裁定 适用 于 下列 范围 ： 准许 或者 不 准许 撤诉 " 之 规定 ， 裁定 如下 ： 

原告彭某某诉被告张某某离婚纠纷案一审裁定书.txt	依照 《 中华人民共和国 民事 诉讼法 》 第 一百四十 五条 的 规定 ， 裁定 如下 ： 

原告彭某某诉被告陈某某离婚纠纷一案一审民事裁定书.txt	依照 《 中华人民共和国 民事 诉讼法 》 、 第一百五十四条 第五款 的 规定 。 裁定 如下 ： 

原告徐某某诉被告张某某离婚纠纷一审民事裁定书.txt	依照 《 中华人民共和国 民事 诉讼法 》 第 一百四十 五条 之 规定 ， 裁定 如下 ： 

原告徐某诉被告王某某离婚纠纷一案一审民事裁定书.txt	依照 《 中华人民共和国 民事 诉讼法 》 第 一百四十 五条 第一款 之 规定 ， 裁定 如下 ： 

原告敖某某诉被告李某某离婚纠纷案一审民事裁定书.txt	依照 《 中华人民共和国 民事 诉讼法 》 第 一百四十 五条 第一款 之 规定 ， 裁定 如下 ： 

原告明某某诉被告王某某离婚纠纷一案一审民事裁定书.txt	依照 《 中华人民共和国 民事 诉讼法 》 第 一百四十 五条 第一款 之 规定 ， 裁定 如下 ： 

原告易某某与被告李某某离婚纠纷一审民事裁定书.txt	根据 《 中华人民共和国 民事 诉讼法 》 第 一百四十 五条 第一款 宣判 前 ， 原告 申请 撤诉 的 ， 是否 准许 ， 由 人民法院 裁定 。 第一百五十四条 第一款 第五项 裁定 适用 于 下列 范围 ： hellip ; hellip ; 准许 或者 不 准许 撤诉 hellip ; hellip ; 的 规定 ， 裁定 如下 ： 

原告曹某某诉被告冯某某离婚纠纷一审民事裁定书.txt	依照 《 中华人民共和国 民事 诉讼法 》 第 一百四十 五条 第一款 之 规定 ， 裁定 如下 ： 

原告曾某与被告尹某某离婚纠纷一审民事裁定书.txt	依照 《 中华人民共和国 民事 诉讼法 》 第 一百四十 五条 之 规定 ， 裁定 如下 ： 

原告曾某某与被告彭某某离婚纠纷一案一审民事裁定书.txt	根据 《 中华人民共和国 民事 诉讼法 》 第 一百四十 五条 第一款 之 规定 ， 裁定 如下 ： 

原告曾某某诉被告吴某某离婚纠纷一审民事裁定书.txt	根据 《 中华人民共和国 民事 诉讼法 》 第 一百四十 五条 之 规定 ， 裁定 如下 ： 

原告朱某某与被告刘某某离婚纠纷一案民事裁定书.txt	依照 《 中华人民共和国 民事 诉讼法 》 第 一百四十 五条 " 宣判 前 ， 原告 申请 撤诉 的 ， 是否 准许 ， 由 人民法院 裁定 " 之 规定 ， 裁定 如下 ： 

原告朱某某诉被告林某某离婚纠纷一案一审民事裁定书.txt	依照 《 中华人民共和国 民事 诉讼法 》 第 一百四十 五条 第一款 之 规定 ， 裁定 如下 ： 

原告李某某与被告伏某某“离婚纠纷”一案民事裁定书.txt	依照 《 中华人民共和国 民事 诉讼法 》 第 一百四十 三条 之 规定 ， 裁定 如下 ： 

原告李某某与被告何某某离婚纠纷一案一审民事裁定书.txt	依照 《 中华人民共和国 民事 诉讼法 》 第 一百四十 五条 < span > < imgsrc = quot ; \ \ \ \ File \ \ \ \ Image \ \ \ \ 7374 b57d - 46 f6 - 45 fc - 924 d - 45 d3d588bdcd0 . jpegquot ; style = quot ; width : 90 pt ; height : 52.5 pt ; name : linepic ; align : leftquot ; xmlns = quot ; http : / / www . w3 . org / 1999 / xhtmlquot ; / > < / span > 第一款 、 第一百五十四条 第一款 （ 五 ） 项之 规定 ， 裁定 如下 ： 

原告李某某与被告白某某离婚纠纷一审民事裁定书.txt	依照 《 中华人民共和国 民事 诉讼法 》 第一百五十四条 第五款 的 规定 ， 裁定 如下 ： 

原告李某某与被告胡某某离婚纠纷一审民事裁定书.txt	依照 《 中华人民共和国 民事 诉讼法 》 第 一百四十 五条 一款 宣判 前 ， 原告 申请 撤诉 的 ， 是否 准许 ， 由 人民法院 裁定 、 第一百五十四条 一款 裁定 适用 于 下列 范围 ： （ 五 ） 准许 或者 不 准许 撤诉 之 规定 ， 裁定 如下 ： 

原告李某某与被告陈某某离婚纠纷一审民事裁定书.txt	依照 《 中华人民共和国 民事 诉讼法 》 第 一百四十 五条 第一款 宣判 前 ， 原告 申请 撤诉 的 ， 是否 准许 ， 由 人民法院 裁定 、 第一百五十四条 第一款 第 （ 五 ） 项 裁定 适用 于 下列 范围 ： 准许 或者 不 准许 撤诉 之 规定 ， 裁定 如下 ： 

原告李某某与被告陈某某离婚纠纷一案的民事裁定书.txt	依据 《 中华人民共和国 民事 诉讼法 》 第 一百四十 五条 之 规定 ， 裁定 如下 ： 

原告李某某诉被告吴某某离婚纠纷一案一审民事裁定书.txt	依照 《 中华人民共和国 民事 诉讼法 》 第 一百四十 五条 第一款 之 规定 ， 裁定 如下 ： 

原告李某某诉被告彭某离婚纠纷一案一审裁定书.txt	依照 《 中华人民共和国 民事 诉讼法 》 第 一百四十 五条 第一款 的 规定 ， 裁定 如下 ： 

原告李某某诉被告肖某某离婚纠纷一审民事裁定书.txt	依照 《 中华人民共和国 民事 诉讼法 》 第 一百四十 五条 第一款 之 规定 ， 裁定 如下 ： 

原告李某某诉被告赖某某离婚纠纷案一审民事裁定书.txt	据此 ， 依照 《 中华人民共和国 民事 诉讼法 》 第 一百四十 五条 第一款 之 规定 ， 裁定 如下 ： 

原告李某诉被告孙某某离婚纠纷一案一审民事裁定书.txt	依照 《 中华人民共和国 民事 诉讼法 》 第 一百四十 五条 第一款 之 规定 ， 裁定 如下 ： 

原告李某诉被告徐某离婚纠纷一审民事裁定书.txt	依照 《 中华人民共和国 民事 诉讼法 》 第 一百四十 五条 第一款 之 规定 ， 裁定 如下 ： 

原告李某诉被告王某某离婚纠纷一案民事裁定书.txt	依照 《 中华人民共和国 民事 诉讼法 》 第 一百四十 五条 第一款 的 规定 ， 裁定 如下 ： 

原告李某诉被告赖某某离婚纠纷一案一审裁定书.txt	依照 《 中华人民共和国 民事 诉讼法 》 第 一百四十 五条 第一款 的 规定 ， 裁定 如下 ： 

原告李某诉被告黄某离婚纠纷一审民事判决书.txt	依照 《 中华人民共和国 民事 诉讼法 》 第 一百四十 五条 第一款 、 第一百五十四条 第一款 第五项 的 规定 ， 裁定 如下 ： 

原告杜某诉被告王某离婚纠纷一审民事裁定书.txt	依照 《 中华人民共和国 民事 诉讼法 》 第 一百四十 五条 第一款 的 规定 ， 裁定 如下 ： 

原告杨某某与被告叶某某离婚纠纷一审民事裁定书.txt	依照 《 中华人民共和国 民事 诉讼法 》 第 一百四十 五条 第一款 " 宣判 前 ， 原告 申请 撤诉 的 ， 是否 准许 ， 由 人民法院 裁定 " 、 第一百五十四条 第一款 第 （ 五 ） 项 " 裁定 适用 于 下列 范围 ： 准许 或者 不 准许 撤诉 " 之 规定 ， 裁定 如下 ： 

原告杨某某与被告梁某某离婚纠纷一案一审民事裁定书.txt	依照 《 中华人民共和国 民事 诉讼法 》 第 一百四十 五条 的 规定 ， 裁定 如下 ： 

原告杨某某诉被告孟某某离婚纠纷一案一审民事裁定书.txt	依照 《 中华人民共和国 民事 诉讼法 》 第 一百四十 五条 第一款 之 规定 ， 裁定 如下 ： 

原告杨某某诉被告徐某某离婚纠纷一审民事裁定书.txt	依照 《 中华人民共和国 民事 诉讼法 》 第 一百四十 三条 之 规定 ， 裁定 如下 ： 

原告杨某某诉被告李某某离婚纠纷一审民事裁定书.txt	依照 《 中华人民共和国 民事 诉讼法 》 第 一百一十 八条 第一款 ， 《 最高人民法院 关于 适用 ＜ 中华人民共和国 民事 诉讼法 ＞ 的 解释 》 第 二百一十三 条 ， 《 诉讼费用 交纳 办法 》 第二十条 、 第二十二条 之 规定 ， 裁定 如下 ： 

原告杨某甲诉被告杨某乙离婚纠纷一案一审民事裁定书.txt	依照 《 中华人民共和国 民事 诉讼法 》 第三十六条 的 规定 ， 裁定 如下 ： 

原告杨某诉被告周某某婚姻家庭纠纷一案一审民事裁定书.txt	依照 《 中华人民共和国 民事 诉讼法 》 第 一百四十 三条 的 规定 ， 裁定 如下 ： 

原告杨某诉被告孟某某离婚纠纷一案一审民事裁定书.txt	依照 《 中华人民共和国 民事 诉讼法 》 第 一百四十 五条 第一款 之 规定 ， 裁定 如下 ： 

原告林某某诉被告刘某某离婚纠纷案一审民事裁定书.txt	依照 《 中华人民共和国 民事 诉讼法 》 第 一百四十 五条 第一款 的 规定 ， 裁定 如下 ： 

原告梁某某与被告罗某某离婚纠纷一案一审民事裁定书.txt	依照 《 中华人民共和国 民事 诉讼法 》 第 一百四十 五条 的 规定 ， 裁定 如下 ： 

原告梁某某与被告黄某某离婚纠纷一案一审民事裁定书.txt	依照 《 中华人民共和国 民事 诉讼法 》 第 一百四十 五条 的 规定 ， 裁定 如下 ： 

原告母小梅与被告黄小朋离婚纠纷一案民事裁定书.txt	依照 《 中华人民共和国 民事 诉讼法 》 第 一百四十 五条 第一款 " 宣判 前 ， 原告 申请 撤诉 的 ， 是否 准许 ， 由 人民法院 裁定 。 " 的 规定 ， 裁定 如下 ： 

原告汤某与被告欧某某离婚纠纷一案一审民事裁定书.txt	依照 《 中华人民共和国 民事 诉讼法 》 第 一百四十 三条 之 规定 ， 裁定 如下 ： 

原告汪某某与被告周某某离婚纠纷一案一审民事裁定书.txt	依照 《 中华人民共和国 民事 诉讼法 》 第 一百四十 五条 的 规定 ， 裁定 如下 ： 

原告熊某某与被告邓某某离婚纠纷民事一审裁定书.txt	依照 《 中华人民共和国 民事 诉讼法 》 第 一百四十 五条 第一款 宣判 前 ， 原告 申请 撤诉 的 ， 是否 准许 ， 由 人民法院 裁定 、 第一百五十四条 第一款 第 （ 五 ） 项 裁定 适用 于 下列 范围 ： 准许 或者 不 准许 撤诉 之 规定 ， 裁定 如下 ： 

原告牟丽诉被告钟方平离婚纠纷民事裁定书.txt	依照 《 中华人民共和国 民事 诉讼法 》 第 一百四十 五条 第一款 之 规定 ， 裁定 如下 ： 

原告王某某与被告叶某某离婚纠纷一审民事裁定书.txt	依照 《 中华人民共和国 民事 诉讼法 》 第 一百四十 五条 一款 宣判 前 ， 原告 申请 撤诉 的 ， 是否 准许 ， 由 人民法院 裁定 、 第一百五十四条 一款 裁定 适用 于 下列 范围 ： （ 五 ） 准许 或者 不 准许 撤诉 之 规定 ， 裁定 如下 ： 

原告王某某与被告罗某某离婚纠纷一审民事裁定书.txt	根据 《 中华人民共和国 民事 诉讼法 》 第一百五十四条 第五款 之 规定 ， 裁定 如下 ： 

原告王某某诉被告刘某某离婚纠纷案一审民事裁定书.txt	依照 《 中华人民共和国 民事 诉讼法 》 第十三条 第二款 当事人 有权 在 法律 规定 的 范围 内 处分 自己 的 民事权利 和 诉讼 权利 及第 一百四十 五条 第一款 宣判 前 ， 原告 申请 撤诉 的 ， 是否 准许 ， 由 人民法院 裁定 的 规定 ， 裁定 如下 ： 

原告王某某诉被告安某某离婚纠纷一审民事裁定书.txt	依照 《 中华人民共和国 民事 诉讼法 》 第 一百一十 八条 第一款 ， 《 最高人民法院 关于 适用 ＜ 中华人民共和国 民事 诉讼法 ＞ 的 解释 》 第 二百一十三 条 ， 《 诉讼费用 交纳 办法 》 第二十条 、 第二十二条 之 规定 ， 裁定 如下 ： 

原告王某某诉被告杨某某离婚纠纷一案一审民事裁定书.txt	依照 《 中华人民共和国 民事 诉讼法 》 第 一百四十 五条 第一款 之 规定 ， 裁定 如下 ： 

原告王某某诉被告蒋某某离婚纠纷一案一审民事裁定书.txt	依照 《 中华人民共和国 民事 诉讼法 》 第 一百四十 五条 第一款 之 规定 ， 裁定 如下 ： 

原告王某某诉被告邱某某离婚纠纷一审民事裁定书.txt	依照 《 中华人民共和国 民事 诉讼法 》 第 一百四十 五条 的 规定 ， 裁定 如下 ： 

原告王某诉被告陈某离婚纠纷一审民事裁定书.txt	依照 《 中华人民共和国 民事 诉讼法 》 第 一百四十 五条 第一款 之 规定 ， 裁定 如下 ： 

原告甘某诉被告黄某离婚纠纷一审民事裁定书.txt	依照 《 中华人民共和国 民事 诉讼法 》 第 一百四十 五条 第一款 之 规定 ， 裁定 如下 ： 

原告田某某诉被告高某某离婚纠纷一案一审民事裁定书.txt	依照 《 中华人民共和国 民事 诉讼法 》 第 一百四十 五条 第一款 的 规定 ， 裁定 如下 ： 

原告白某诉被告秦某某离婚纠纷一审民事裁定书.txt	依照 《 中华人民共和国 民事 诉讼法 》 、 第一百五十四条 第五款 的 规定 。 裁定 如下 ： 

原告祝某某诉被告张某某离婚纠纷一案一审民事裁定书.txt	依照 《 中华人民共和国 民事 诉讼法 》 第 一百四十 五条 第一款 之 规定 ， 裁定 如下 ： 

原告秦某某诉被告牛某某离婚纠纷一案一审民事裁定书.txt	依照 《 中华人民共和国 民事 诉讼法 》 第 一百四十 五条 第一款 之 规定 ， 裁定 如下 ： 

原告罗某与被告何某离婚纠纷民事裁定书.txt	根据 《 中华人民共和国 民事 诉讼法 》 第 一百四十 五条 第一款 宣判 前 ， 原告 申请 撤诉 的 ， 是否 准许 ， 由 人民法院 裁定 。 第一百五十四条 第一款 第 （ 五 ） 项 裁定 适用 于 下列 范围 ： hellip ; hellip ; 准许 或者 不 准许 撤诉 hellip ; hellip ; 的 规定 ， 裁定 如下 ： 

原告罗某某与被告某某离婚纠纷一审民事裁定书.txt	根据 《 中华人民共和国 民事 诉讼法 》 第 一百四十 五条 第一款 宣判 前 ， 原告 申请 撤诉 的 ， 是否 准许 ， 由 人民法院 裁定 。 第一百五十四条 第一款 第五项 裁定 适用 于 下列 范围 ： hellip ; hellip ; 准许 或者 不 准许 撤诉 hellip ; hellip ; 的 规定 ， 裁定 如下 ： 

原告罗某某诉被告汪某某离婚纠纷一审民事裁定书.txt	依照 《 中华人民共和国 民事 诉讼法 》 第 一百四十 三条 ， 第一百五十四条 之 规定 ， 裁定 如下 ： 

原告罗某某诉被告谈某某离婚纠纷一审民事裁定书.txt	依照 《 中华人民共和国 民事 诉讼法 》 第 一百四十 五条 第一款 之 规定 ， 裁定 如下 ： 

原告罗某某诉被告陈某离婚纠纷一案的民事裁定书.txt	依照 《 中华人民共和国 民事 诉讼法 》 第 一百四十 五条 的 规定 ， 裁定 如下 ： 

原告罗某甲诉被告罗某乙离婚纠纷一案民事裁定书.txt	依照 《 中华人民共和国 民事 诉讼法 》 第 一百四十 五条 " 宣判 前 ， 原告 申请 撤诉 的 ， 是否 准许 ， 由 人民法院 裁定 " 之 规定 ， 裁定 如下 ： 

原告罗某诉被告万某某离婚纠纷一案一审裁定书.txt	依照 《 中华人民共和国 民事 诉讼法 》 第 一百四十 五条 第一款 的 规定 ， 裁定 如下 ： 

原告罗某诉被告王某某离婚纠纷一审民事裁定书.txt	依照 《 中华人民共和国 民事 诉讼法 》 第 一百四十 五条 第一款 之 规定 ， 裁定 如下 ： 

原告胡某某诉被告文某离婚纠纷一案一审民事裁定书.txt	据此 ， 依照 《 中华人民共和国 民事 诉讼法 》 第 一百四十 五条 之 规定 ， 裁定 如下 ： 

原告苟某某诉被告李某某离婚纠纷一案一审民事裁定书.txt	依照 《 中华人民共和国 民事 诉讼法 》 第 一百四十 五条 第一款 的 规定 ， 裁定 如下 ： 

原告董某某诉被告陆某某离婚纠纷一审民事裁定书.txt	依照 《 中华人民共和国 民事 诉讼法 》 第十三条 和 一百四十 五条 第一款 的 规定 ， 裁定 如下 ： 

原告蒋某诉被告徐某离婚纠纷一审民事裁定书.txt	依照 《 中华人民共和国 民事 诉讼法 》 第 一百四十 五条 第一款 的 规定 ， 裁定 如下 ： 

原告詹某某诉被告缪某某离婚纠纷一审民事裁定书.txt	依照 《 中华人民共和国 民事 诉讼法 》 第 一百四十 五条 的 规定 ， 裁定 如下 ： 

原告许某某诉被告江某离婚纠纷一审民事裁定书.txt	依照 《 中华人民共和国 民事 诉讼法 》 第 一百四十 五条 第一款 之 规定 ， 裁定 如下 ： 

原告许某某诉被告陈某某离婚纠纷一案一审民事裁定书.txt	依照 《 中华人民共和国 民事 诉讼法 》 、 第一百五十四条 第五款 的 规定 。 裁定 如下 ： 

原告贵某某诉被告杨某某离婚纠纷一审民事裁定书.txt	依照 《 中华人民共和国 民事 诉讼法 》 第 一百四十 五条 第一款 的 规定 ， 裁定 如下 ： 

原告贺某某诉被告周某某离婚纠纷一审民事裁定书.txt	依照 《 中华人民共和国 民事 诉讼法 》 第 一百四十 五条 之 规定 ， 裁定 如下 ： 

原告贾某某诉被告李某某离婚纠纷一审民事裁定书.txt	依照 《 中华人民共和国 民事 诉讼法 》 第 一百四十 三条 ， 第一百五十四条 之 规定 ， 裁定 如下 ： 

原告赵某与被告刘某“离婚纠纷”一案民事裁定书.txt	依照 《 中华人民共和国 民事 诉讼法 》 第 一百四十 五条 第一款 的 规定 ， 裁定 如下 ： 

原告赵某与被告赵甲“离婚纠纷”一案民事裁定书.txt	依照 《 中华人民共和国 民事 诉讼法 》 第 一百四十 三条 之 规定 ， 裁定 如下 ： 

原告邓旭超诉被告朱模胜离婚纠纷一案民事裁定书.txt	依照 《 中华人民共和国 民事 诉讼法 》 第 一百三十 一条 第一款 之 规定 ， 裁定 如下 ： 

原告邓某某诉被告张某某离婚纠纷一案一审民事裁定书.txt	依照 《 中华人民共和国 民事 诉讼法 》 第 一百四十 五条 第一款 的 规定 ， 裁定 如下 ： 

原告邓某诉被告周某离婚纠纷一审民事裁定书.txt	根据 《 中华人民共和国 民事 诉讼法 》 第 一百一十 八条 、 《 诉讼费用 交纳 办法 》 第二十二条 第四款 及 最高人民法院 《 关于 适用 ﹤ 中华人民共和国 民事 诉讼法 ﹥ 的 解释 》 第 二百一十三 条 之 规定 ， 裁定 如下 ： 

原告邱某某诉被告王某某离婚纠纷案一审裁定书.txt	依据 《 中华人民共和国 民事 诉讼法 》 第 二百一十三 条 " 原告 经 传票 传唤 ， 无 正当理由 拒 不 到庭 的 ， 或者 未经 法庭 许可 中途 退庭 的 ， 可以 按 撤诉 处理 ； 被告 反诉 的 ， 可以 缺席判决 。 " 的 规定 ， 裁定 如下 ： 

原告邹某某与被告熊某某离婚纠纷一案民开裁定书.txt	依照 《 中华人民共和国 民事 诉讼法 》 第 一百四十 五条 第一款 " 宣判 前 ， 原告 申请 撤诉 的 ， 是否 准许 ， 由 人民法院 裁定 。 " 的 规定 ， 裁定 如下 ： 

原告邹某某诉被告陈某某离婚纠纷一案一审民事裁定书.txt	依照 《 中华人民共和国 民事 诉讼法 》 第 一百四十 五条 第一款 之 规定 ， 裁定 如下 ： 

原告郑某某诉被告刘某某离婚纠纷案一审民事裁定书.txt	依照 《 中华人民共和国 民事 诉讼法 》 第 一百四十 三条 的 规定 ， 裁定 如下 ： 

原告郑某诉被告刘某离婚纠纷一案一审民事裁定书.txt	依照 《 中华人民共和国 民事 诉讼法 》 第 一百一十 八条 第一款 、 最高人民法院 关于 适用 《 中华人民共和国 民事 诉讼法 》 的 解释 第 二百一十三 条 之 规定 ， 裁定 如下 ： 

原告郭某华与被告邓某离婚纠纷一案的民事裁定书.txt	依照 《 中华人民共和国 民事 诉讼法 》 第一百五十四条 第一款 第五项 的 规定 ， 裁定 如下 ： 

原告郭某某与被告邓某某离婚纠纷一审民事裁定书.txt	依照 《 中华人民共和国 民事 诉讼法 》 第 一百四十 五条 第一款 " 宣判 前 ， 原告 申请 撤诉 的 ， 是否 准许 ， 由 人民法院 裁定 " 、 第一百五十四条 第一款 第 （ 五 ） 项 " 裁定 适用 于 下列 范围 ： 准许 或者 不 准许 撤诉 " 之 规定 ， 裁定 如下 ： 

原告钱某某诉被告肖某某离婚纠纷一案一审民事裁定书.txt	依照 《 中华人民共和国 民事 诉讼法 》 第 一百四十 五条 之 规定 ， 裁定 如下 ： 

原告陈某某与被告周某离婚纠纷一审民事裁定书.txt	根据 《 中华人民共和国 民事 诉讼法 》 第 一百四十 五条 、 第一百五十四条 之 规定 ， 裁定 如下 ： 

原告陈某某与被告唐某某离婚纠纷一审民事裁定书.txt	依照 《 中华人民共和国 民事 诉讼法 》 第 一百四十 五条 的 规定 ， 裁定 如下 ： 

原告陈某某与被告唐某某离婚纠纷一案民事裁定书.txt	依照 《 中华人民共和国 民事 诉讼法 》 第 一百四十 五条 第一款 " 宣判 前 ， 原告 申请 撤诉 的 ， 是否 准许 ， 由 人民法院 裁定 。 " 的 规定 ， 裁定 如下 ： 

原告陈某某与被告唐某离婚纠纷一审民事裁定书.txt	依照 《 中华人民共和国 民事 诉讼法 》 第 一百四十 五条 第一款 的 规定 ， 裁定 如下 ： 

原告陈某某诉被告张某某离婚纠纷一案的民事裁定书.txt	依照 《 中华人民共和国 民事 诉讼法 》 第 一百四十 三条 、 第一百五十四条 之 规定 ， 裁定 如下 ： 

原告陈某诉被告刘某离婚后财产纠纷一审民事裁定书.txt	依照 《 中华人民共和国 民事 诉讼法 》 第 一百四十 五条 第一款 之 规定 ， 裁定 如下 ： 

原告陈某诉被告王某离婚纠纷一案一审民事裁定书.txt	依照 《 中华人民共和国 民事 诉讼法 》 第 一百四十 五条 第一款 之 规定 ， 裁定 如下 ： 

原告陈然富诉被告卢清华离婚纠纷一案民事裁定书.txt	依照 《 中华人民共和国 民事 诉讼法 》 第 一百四十 五条 第一款 之 规定 ， 裁定 如下 ： 

原告雍某某与被告王某某离婚纠纷一案一审民事裁定书.txt	据此 ， 依照 《 中华人民共和国 民事 诉讼法 》 第 一百四十 五条 第一款 之 规定 ， 裁定 如下 ： 

原告雷某某诉被告李某某离婚纠纷一案一审民事裁定书.txt	依照 《 中华人民共和国 民事 诉讼法 》 第一 百十 四五条 第一款 之 规定 ， 裁定 如下 ： 

原告颜某某诉被告张某某离婚纠纷一案一审民事裁定书.txt	依照 《 中华人民共和国 民事 诉讼法 》 第 一百四十 五条 第一款 之 规定 ， 裁定 如下 ： 

原告马某某诉被告鲜某某离婚纠纷一审民事裁定书.txt	依照 《 中华人民共和国 民事 诉讼法 》 第 一百四十 五条 第一款 之 规定 ， 裁定 如下 ： 

原告高某某诉被告刘某某离婚纠纷一案一审民事裁定书.txt	依照 《 中华人民共和国 民事 诉讼法 》 第 一百四十 五条 第一款 之 规定 ， 裁定 如下 ： 

原告高某某诉被告李某某离婚纠纷一审民事裁定书.txt	根据 《 中华人民共和国 民事 诉讼法 》 第 一百四十 五条 第一款 的 规定 ， 裁定 如下 ： 

原告高某某诉被告阚某某离婚纠纷案一审民事裁定书.txt	依照 《 中华人民共和国 民事 诉讼法 》 第十三条 第二款 当事人 有权 在 法律 规定 的 范围 内 处分 自己 的 民事权利 和 诉讼 权利 及第 一百四十 五条 第一款 宣判 前 ， 原告 申请 撤诉 的 ， 是否 准许 ， 由 人民法院 裁定 的 规定 ， 裁定 如下 ： 

原告高某甲与被告高某乙离婚纠纷一案一审民事裁定书.txt	依照 《 中华人民共和国 民事 诉讼法 》 第 一百四十 五条 的 规定 ， 裁定 如下 ： 

原告麻某某与被告赵某离婚纠纷一案民事裁定书.txt	依照 《 中华人民共和国 民事 诉讼法 》 第 一百四十 五条 第一款 " 宣判 前 ， 原告 申请 撤诉 的 ， 是否 准许 ， 由 人民法院 裁定 。 " 的 规定 ， 裁定 如下 ： 

原告黄某某与被告李某某离婚纠纷案一审民事裁定书.txt	依照 《 中华人民共和国 民事 诉讼法 》 第 一百四十 五条 第一款 的 规定 ， 裁定 如下 ： 

原告黄某某与被告陶某某离婚纠纷一审民事裁定书.txt	依照 《 中华人民共和国 民事 诉讼法 》 第 一百四十 五条 第一款 的 规定 ， 裁定 如下 ： 

原告黄某诉被告李某离婚纠纷一案一审民事裁定书.txt	依照 《 中华人民共和国 民事 诉讼法 》 第 一百四十 五条 第一款 之 规定 ， 裁定 如下 ： 

原告龙某某诉被告朱某某离婚纠纷一案一审民事裁定书.txt	依照 《 中华人民共和国 民事 诉讼法 》 第 一百四十 五条 第一款 之 规定 ， 裁定 如下 ： 

原告龚某某诉被告李某某离婚纠纷一审民事裁定书.txt	依照 《 中华人民共和国 民事 诉讼法 》 第 一百四十 五条 第一款 之 规定 ， 裁定 如下 ： 

向某与赵某离婚纠纷一审民事裁定书.txt	根据 《 中华人民共和国 民事 诉讼法 》 第 一百四十 五条 之 规定 ， 裁定 如下 ： 

向某某与侯某某离婚纠纷一审民事裁定书.txt	据此 ， 依照 《 中华人民共和国 民事 诉讼法 》 第 一百四十 五条 第一款 " 宣判 前 ， 原告 申请 撤诉 的 ， 是否 准许 ， 由 人民法院 裁定 。 " 之 规定 ， 裁定 如下 ： 

向某某与刘某某离婚纠纷一审民事裁定书.txt	依据 《 中华人民共和国 民事 诉讼法 》 第 一百四十 五条 第一款 之 规定 ， 裁定 如下 ： 

向某某与李某离婚纠纷一审民事裁定书.txt	据此 ， 依照 《 中华人民共和国 民事 诉讼法 》 第 一百四十 五条 第一款 " 宣判 前 ， 原告 申请 撤诉 的 ， 是否 准许 ， 由 人民法院 裁定 。 " 之 规定 ， 裁定 如下 ： 

吕凤容与兰万里离婚纠纷一案民事裁定书.txt	依照 《 中华人民共和国 民事 诉讼法 》 第 一百四十 五条 之 规定 ， 裁定 如下 ： 

吕利诉胡意川离婚纠纷一审民事裁定书.txt	据此 ， 依照 《 中华人民共和国 民事 诉讼法 》 第 一百四十 五条 第一款 之 规定 ， 裁定 如下 ： 

吕建全与林春燕离婚纠纷二审民事裁定书.txt	依照 《 中华人民共和国 民事 诉讼法 》 第十三条 第二款 、 第一百七 十三条 、 第一百七 十五条 之 规定 ， 裁定 如下 ： 

吕某某与宋某某离婚纠纷一案一审民事裁定书.txt	依照 《 中华人民共和国 民事 诉讼法 》 第 一百一十 八条 ， 《 最高人民法院 关于 适用 ﹤ 中华人民共和国 民事 诉讼费 法 ﹥ 若干 问题 的 意见 》 第 一百四十 三条 ， 《 诉讼费用 交纳 办法 》 第二十条 、 第二十二条 的 规定 裁定 如下 ： 

吕某某与张某某离婚纠纷一审民事裁定书.txt	依照 《 中华人民共和国 民事 诉讼法 》 第 一百四十 五条 " 宣判 前 ， 原告 申请 撤诉 的 ， 是否 准许 ， 由 人民法院 裁定 。 " 之 规定 ， 裁定 如下 ： 

吕某某与张某离婚纠纷一审民事裁定书.txt	依照 《 中华人民共和国 民事 诉讼法 》 第 一百四十 五条 第一款 的 规定 ， 裁定 如下 ： 

吕某某诉文某某离婚后财产纠纷一案一审民事裁定书.txt	依照 《 中华人民共和国 民事 诉讼法 》 第 一百四十 五条 第一款 " 宣判 前 ， 原告 申请 撤诉 的 ， 是否 准许 ， 由 人民法院 裁定 。 " 之 规定 ， 裁定 如下 ： 

吕某某诉陈某离婚纠纷一审民事裁定书.txt	依照 《 中华人民共和国 民事 诉讼法 》 第 一百四十 五条 的 规定 ， 裁定 如下 ： 

吴某与刘某离婚纠纷一审民事裁定书.txt	依照 《 中华人民共和国 民事 诉讼法 》 第 一百四十 五条 的 规定 ， 裁定 如下 ： 

吴某与杨某某离婚纠纷一审民事裁定书.txt	依照 《 中华人民共和国 民事 诉讼法 》 第 一百四十 五条 第一款 之 规定 ， 裁定 如下 ： 

吴某某与侯某某离婚纠纷一审民事裁定书.txt	依照 《 中华人民共和国 民事 诉讼法 》 第 一百四十 五条 的 规定 ， 裁定 如下 ： 

吴某某与张某某离婚纠纷一审民事裁定书.txt	依据 《 中华人民共和国 民事 诉讼法 》 第 一百四十 五条 、 一百五十 四条 第一款 第五项 、 第三款 之 规定 ， 裁定 如下 ： 

吴某某与李某离婚纠纷一审民事裁定书.txt	据此 ， 依照 《 中华人民共和国 民事 诉讼法 》 第 一百四十 五条 第一款 " 宣判 前 ， 原告 申请 撤诉 的 ， 是否 准许 ， 由 人民法院 裁定 " 之 规定 ， 裁定 如下 ： 

吴某某与杨某某离婚纠纷一审民事裁定书.txt	依照 《 中华人民共和国 民事 诉讼法 》 第 一百四十 五条 之 规定 ， 裁定 如下 ： 

吴某某与杨某某离婚纠纷一案一审民事裁定书.txt	依照 《 中华人民共和国 民事 诉讼法 》 第十三条 第二款 、 第 一百四十 五条 第一款 之 规定 ， 裁定 如下 ： 

吴某某与桑某某离婚纠纷一审民事裁定书.txt	依照 《 中华人民共和国 民事 诉讼法 》 第 一百四十 五条 第一款 的 规定 ， 裁定 如下 ： 

吴某某与王某某离婚纠纷一案一审民事裁定书.txt	依照 《 中华人民共和国 民事 诉讼法 》 第 一百零八 条 " 起诉 必须 符合 下列 条件 ： （ 二 ） 有 明确 的 被告 " ， 《 最高人民法院 关于 适用 简易程序 审理 民事案件 的 若干 规定 》 第八条 第二款 " 原告 不能 提供 被告 准确 的 送达 地址 ， 人民法院 经 查证 后 仍 不能 确定 被告 送达 地址 的 ， 可以 被告 不 明确 为 由 裁定 驳回 原告 起诉 " 的 规定 ， 裁定 如下 ： 

吴某某与税某某离婚纠纷一审民事裁定书.txt	依照 《 中华人民共和国 民事 诉讼法 》 第 一百四十 五条 的 规定 ， 裁定 如下 ： 

吴某某与罗某某离婚纠纷一审民事裁定书.txt	根据 《 中华人民共和国 民事 诉讼法 》 第一百 二十三条 、 第一百 二十四条 之 规定 ， 裁定 如下 ： 

吴某某与莫某某离婚纠纷一审民事裁定书.txt	依照 《 中华人民共和国 民事 诉讼法 》 第 一百四十 三条 的 规定 ， 裁定 如下 ： 

吴某某与陈某某离婚纠纷一审民事裁定书.txt	据此 ， 依照 《 中华人民共和国 民事 诉讼法 》 第 一百四十 五条 第一款 之 规定 ， 裁定 如下 ： 

吴某某与马某某离婚纠纷一审民事裁定书.txt	据此 ， 依照 《 中华人民共和国 民事 诉讼法 》 第 一百四十 五条 第一款 " 宣判 前 ， 原告 申请 撤诉 的 ， 是否 准许 ， 由 人民法院 裁定 " 之 规定 ， 裁定 如下 ： 

吴某某诉被告张某某离婚纠纷一审民事裁定书.txt	依照 《 中华人民共和国 民事 诉讼法 》 第十三条 、 第 一百四十 五条 第一款 之 规定 ， 裁定 如下 ： 

吴某某诉马某某离婚纠纷一审民事裁定书.txt	依照 《 中华人民共和国 民事 诉讼法 》 第 一百四十 五条 之 规定 ， 裁定 如下 ： 

吴某诉张某离婚纠纷民事裁定书.txt	依照 《 中华人民共和国 民事 诉讼法 》 第一百 四十五 第一款 之 规定 ， 裁定 如下 ： 

吴某诉沈某离婚纠纷一审民事裁定书.txt	依照 《 中华人民共和国 民事 诉讼法 》 第 一百四十 五条 的 规定 ， 裁定 如下 ： 

吴白花诉钟建明离婚纠纷一审民事裁定书.txt	据此 ， 依照 《 中华人民共和国 民事 诉讼法 》 第 一百四十 五条 第一款 之 规定 ， 裁定 如下 ： 

呈某某诉田某某离婚纠纷一审民事裁定书.txt	依照 《 中华人民共和国 民事 诉讼法 》 第 一百四十 五条 第一款 之 规定 ， 裁定 如下 ： 

周兴会诉陈登洪离婚纠纷一审民事裁定书.txt	依照 《 中华人民共和国 民事 诉讼法 》 第 一百四十 五条 第一款 之 规定 ， 裁定 如下 ： 

周勇与李娟离婚纠纷一审民事裁定书.txt	依照 《 中华人民共和国 民事 诉讼法 》 第 一百四十 五条 第一款 的 规定 ， 裁定 如下 ： 

周某与姚某离婚纠纷一审民事裁定书.txt	根据 《 中华人民共和国 民事 诉讼法 》 第 一百四十 五条 之 规定 ， 裁定 如下 ： 

周某与张某某离婚纠纷一审民事裁定书.txt	依照 《 中华人民共和国 民事 诉讼法 》 第 一百四十 五条 的 规定 ， 裁定 如下 ： 

周某与杨某离婚纠纷一审民事裁定书.txt	依照 《 中华人民共和国 民事 诉讼法 》 第 一百四十 五条 第一款 之 规定 ， 裁定 如下 ： 

周某某与万某某离婚纠纷一审民事裁定书.txt	根据 《 中华人民共和国 民事 诉讼法 》 第 一百四十 五条 之 规定 ， 裁定 如下 ： 

周某某与付某某离婚纠纷一审民事裁定书.txt	根据 《 中华人民共和国 民事 诉讼法 》 第 一百四十 五条 第一款 之 规定 ， 裁定 如下 ： 

周某某与徐某某离婚纠纷一审民事裁定书.txt	依照 《 中华人民共和国 民事 诉讼法 》 第 一百四十 五条 的 规定 ， 裁定 如下 ： 

周某某与杨某某离婚纠纷案一审民事裁定书.txt	依照 《 中华人民共和国 民事 诉讼法 》 第 一百四十 五条 第一款 的 规定 ， 裁定 如下 ： 

周某某与王某某离婚纠纷一审民事裁定书.txt	依照 《 中华人民共和国 民事 诉讼法 》 第 一百四十 五条 之 规定 ， 裁定 如下 ： 

周某某与程某某离婚纠纷一审民事裁定书.txt	根据 《 中华人民共和国 民事 诉讼法 》 第 一百四十 五条 第一款 宣判 前 ， 原告 申请 撤诉 的 ， 是否 准许 ， 由 人民法院 裁定 、 第一百五十四条 第一款 第五项 裁定 适用 于 下列 范围 ： hellip ; hellip ; 准许 或者 不 准许 撤诉 hellip ; hellip ; 的 规定 ， 裁定 如下 ： 

周某某与罗某某离婚纠纷二审民事裁定书.txt	依照 《 中华人民共和国 民事 诉讼法 》 第一百七十条 第一款 第 （ 二 ） 项 和 第一百七 十五条 之 规定 ， 裁定 如下 ： 

周某某诉罗某离婚纠纷案一审民事裁定书.txt	依照 《 中华人民共和国 民事 诉讼法 》 第 一百四十 五条 、 一百五十 四条 第一款 第五项 的 规定 ， 裁定 如下 ： 

周某诉李某某离婚纠纷一审民事裁定书.txt	依照 《 中华人民共和国 民事 诉讼法 》 第 一百四十 五条 第一款 之 规定 ， 裁定 如下 ： 

周某诉罗某某离婚纠纷一案一审民事裁定书.txt	依照 《 中华人民共和国 民事 诉讼法 》 第 一百四十 五条 之 规定 ， 裁定 如下 ： 

周秀兰与张清友离婚纠纷一审民事裁定书.txt	据此 ， 依照 《 中华人民共和国 民事 诉讼法 》 第 一百四十 五条 、 第一百五十四条 第五项 之 规定 ， 裁定 如下 ： 

唐某与万某某离婚纠纷一案一审民事裁定书.txt	依照 《 中华人民共和国 民事 诉讼法 》 第 一百四十 五条 的 规定 ， 裁定 如下 ： 

唐某与余某离婚纠纷一审民事裁定书.txt	依照 《 中华人民共和国 民事 诉讼法 》 第 一百四十 五条 一款 之 规定 ， 裁定 如下 ： 

唐某某与余某某离婚纠纷一审民事裁定书.txt	依照 《 中华人民共和国 民事 诉讼法 》 第 一百四十 五条 第一款 之 规定 ， 裁定 如下 ： 

唐某某与刘某某离婚纠纷一审民事裁定书.txt	根据 《 中华人民共和国 民事 诉讼法 》 第 一百四十 五条 之 规定 ， 裁定 如下 ： 

唐某某与周某离婚纠纷案一审民事裁定书.txt	依照 《 中华人民共和国 民事 诉讼法 》 第 一百四十 五条 第一款 之 规定 ， 裁定 如下 ： 

唐某某与朝某某离婚纠纷一审民事裁定书.txt	根据 《 中华人民共和国 民事 诉讼法 》 第 一百四十 五条 、 第一百五十四条 的 规定 ， 裁定 如下 ： 

唐某某与李某某离婚纠纷一审民事裁定书.txt	依照 《 中华人民共和国 民事 诉讼法 》 第 一百四十 五条 第一款 、 第一百五十四条 第一款 （ 五项 ） 之 规定 ， 裁定 如下 ： 

唐某某与王某离婚纠纷一审民事裁定书.txt	依照 《 中华人民共和国 民事 诉讼法 》 第 一百三十 一条 第一款 ： " 宣判 前 原告 申请 撤诉 的 ， 是否 准许 ， 由 人民法院 裁定 " 的 规定 ， 裁定 如下 ： 

唐某某与范某某离婚纠纷一审民事裁定书.txt	依照 《 中华人民共和国 民事 诉讼法 》 第 一百四十 五条 的 规定 ， 裁定 如下 ： 

唐某某与被告龚某某离婚纠纷案一审民事裁定书.txt	依照 《 中华人民共和国 民事 诉讼法 》 第 一百四十 五条 第一款 的 规定 ， 裁定 如下 ： 

唐某某与谌某某离婚纠纷案一审民事裁定书.txt	依照 《 中华人民共和国 民事 诉讼法 》 第 一百四十 五条 之 规定 ， 裁定 如下 ： 

唐某某与金某某离婚纠纷案一审民事裁定书.txt	依照 《 中华人民共和国 民事 诉讼法 》 第 一百四十 五条 之 规定 ， 裁定 如下 ： 

唐某某与陈某某离婚纠纷一审民事裁定书.txt	依照 《 中华人民共和国 民事 诉讼法 》 第 一百四十 五条 的 规定 ， 裁定 如下 ： 

唐某某诉吴某某离婚纠纷一案一审民事裁定书.txt	依照 《 中华人民共和国 民事 诉讼法 》 第 一百四十 五条 第一款 " 宣判 前 ， 原告 申请 撤诉 的 ， 是否 准许 ， 由 人民法院 裁定 " 之 规定 ， 裁定 如下 ： 

唐某某诉周某某离婚纠纷一审民事裁定书.txt	依照 《 中华人民共和国 民事 诉讼法 》 第十三条 第二款 、 第 一百四十 五条 之 规定 ， 裁定 如下 ： 

唐某某诉宋某离婚纠纷民事裁定书.txt	依照 《 中华人民共和国 民事 诉讼法 》 第 一百四十 五条 第一款 ： " 宣判 前 ， 原告 申请 撤诉 的 ， 是否 准许 ， 由 人民法院 裁定 " 的 规定 ， 裁定 如下 ： 

唐某某诉欧某某离婚纠纷一审民事裁定书.txt	依照 《 中华人民共和国 民事 诉讼法 》 第 一百四十 三条 的 规定 ， 现 裁定 如下 ： 

喻某某与陈某某离婚纠纷一审民事裁定书.txt	依照 《 最高人民法院 关于 适用 ﹤ 诉讼费用 交纳 办法 ﹥ 的 通知 》 第二条 之 规定 ， 裁定 如下 ： 

夏某与陶某离婚纠纷一审民事裁定书.txt	根据 《 中华人民共和国 民事 诉讼法 》 第 一百四十 五条 之 规定 ， 裁定 如下 ： 

夏某某与吴某某离婚纠纷案一审民事裁定书.txt	依照 《 中华人民共和国 民事 诉讼法 》 第 一百四十 五条 第一款 之 规定 ， 裁定 如下 ： 

夏某某与谢某某离婚纠纷一审民事裁定书.txt	依照 《 中华人民共和国 民事 诉讼法 》 第 一百四十 五条 第一款 之 规定 ， 裁定 如下 ： 

夏某某与马某某离婚纠纷一审民事裁定书.txt	依照 《 中华人民共和国 民事 诉讼法 》 第 一百四十 五条 （ 一 ） 项 的 规定 ， 裁定 如下 ： 

如某与白某离婚纠纷一审民事裁定书.txt	依照 《 中华人民共和国 民事 诉讼法 》 第 一百四十 五条 第一款 之 规定 ， 裁定 如下 ： 

姚某与何某离婚纠纷一审民事裁定书.txt	根据 《 中华人民共和国 民事 诉讼法 》 第 一百四十 五条 " 宣判 前 ， 原告 申请 撤诉 的 ， 是否 准许 ， 由 人民法院 裁定 。 " 之 规定 ， 裁定 如下 ： 

孔某与蒲某某离婚纠纷一审民事裁定书.txt	依照 《 中华人民共和国 民事 诉讼法 》 第 一百四十 五条 的 规定 ， 裁定 如下 ： 

孙某与任某离婚纠纷一审民事裁定书.txt	依照 《 最高人民法院 关于 适用 〈 中华人民共和国 民事 诉讼法 〉 的 解释 》 第二百 零 八条 、 二百一十 四条 之 规定 ， 裁定 如下 ： 

孙某与彭某某离婚纠纷一审民事裁定书.txt	依照 《 中华人民共和国 民事 诉讼法 》 第 一百一十 九条 第二款 ， 《 最高人民法院 关于 适用 简易程序 审理 民事案件 的 若干 规定 》 第八条 第二款 之 规定 ， 裁定 如下 ： 

孙某与杨某离婚纠纷一审民事裁定书.txt	据此 ， 依照 《 中华人民共和国 民事 诉讼法 》 第 一百四十 五条 的 规定 ， 裁定 如下 ： 

孙某某诉陶某某离婚纠纷一审民事裁定书.txt	依照 《 中华人民共和国 民事 诉讼法 》 第 一百四十 五条 第一款 之 规定 ， 裁定 如下 ： 

孙某诉陈某离婚纠纷一审民事裁定书.txt	依照 《 中华 民 共和国 民事 诉讼法 》 第 一百四十 五条 第一款 之 规定 ， 裁定 如下 ： 

安某与王某离婚纠纷一审民事裁定书.txt	根据 《 中华人民共和国 民事 诉讼法 》 第 一百四十 五条 之 规定 ， 裁定 如下 ： 

安某某与任某某离婚纠纷一审民事裁定书.txt	依照 《 中华人民共和国 民事 诉讼法 》 第 一百四十 五条 之 规定 ， 裁定 如下 ： 

宋某与刘某某离婚纠纷二审民事裁定书.txt	依照 《 中华人民共和国 民事 诉讼法 》 第一百七 十三条 之 规定 ， 裁定 如下 ： 

宋某某与张某某离婚纠纷一审民事裁定书.txt	依照 《 中华人民共和国 民事 诉讼法 》 第 一百四十 五条 的 规定 ， 裁定 如下 ： 

宋某某与郑某某离婚纠纷一审民事裁定书.txt	依照 《 中华人民共和国 民事 诉讼法 》 第 一百四十 五条 第一款 之 规定 ， 裁定 如下 ： 

宋某某诉何某某离婚纠纷一审民事裁定书.txt	依照 《 中华人民共和国 民事 诉讼法 》 第 一百四十 五条 的 规定 ， 裁定 如下 ： 

审查杨某某诉陶某某离婚纠纷一审民事裁定书.txt	依照 《 中华人民共和国 民事 诉讼法 》 第 一百四十 五条 第一款 之 规定 ， 裁定 如下 ： 

审理原告曾某某与被告陈某某离婚纠纷撤诉裁定书.txt	依照 《 中华人民共和国 民事 诉讼法 》 第 一百四十 五条 的 规定 ， 裁定 如下 ： 

审理原告陈某某诉被告高某某离婚纠纷案一审民事裁定书.txt	依照 《 中华人民共和国 民事 诉讼法 》 第 一百四十 五条 第一款 之 规定 ， 裁定 如下 ： 

审理原告陶某某诉被告曾某某离婚纠纷一案一审民事裁定书.txt	依照 《 中华人民共和国 民事 诉讼法 》 第 一百四十 五条 之 规定 ， 裁定 如下 ： 

屈某诉杨某离婚纠纷一案一审民事裁定书.txt	依照 《 中华人民共和国 民事 诉讼法 》 第 一百四十 五条 第一款 之 规定 ， 裁定 如下 ： 

岳某与袁某离婚纠纷一审民事裁定书.txt	依照 《 中华人民共和国 民事 诉讼法 》 第 一百四十 五条 一款 之 规定 ， 裁定 如下 ： 

左某某与黄某离婚纠纷一审民事裁定书.txt	据此 ， 依照 《 中华人民共和国 民事 诉讼法 》 第 一百四十 五条 第一款 之 规定 ， 裁定 如下 ： 

常某某诉冯某某离婚纠纷一审民事裁定书.txt	依照 《 中华人民共和国 民事 诉讼法 》 第 一百四十 五条 第一款 之 规定 ， 裁定 如下 ： 

庞某某诉庞甲离婚纠纷一审民事裁定书.txt	依照 《 中华人民共和国 民事 诉讼法 》 第 一百四十 五条 的 规定 ， 裁定 如下 ： 

庞某某诉张某某离婚纠纷一审民事裁定书.txt	依照 《 中华人民共和国 民事 诉讼法 》 第 一百四十 五条 之 规定 ， 裁定 如下 ： 

康某与徐某某离婚纠纷一案一审民事裁定书.txt	根据 《 中华人民共和国 民事 诉讼法 》 第 一百四十 五条 之 规定 ， 裁定 如下 ： 

廖某与马某离婚纠纷一审民事裁定书.txt	根据 《 中华人民共和国 民事 诉讼法 》 第 一百四十 五条 之 规定 ， 裁定 如下 ： 

廖某某与盛某某离婚纠纷一审民事裁定书.txt	依照 《 最高人民法院 关于 适用 〈 中华人民共和国 民事 诉讼法 〉 的 解释 》 第 二百一十三 条 ： " 原告 应当 预交 而 未 预交 案件 受理费 ， 人民法院 应当 通知 其 预交 ， 通知 后 仍 不 预交 或者 申请 减 、 缓 、 免 未获 批准 而 仍 不 预交 的 ， 裁定 按 撤诉 处理 " 的 规定 ， 裁定 如下 ： 

张习敏诉彭文军离婚纠纷一审民事裁定书.txt	根据 《 中华人民共和国 民事 诉讼法 》 第 一百四十 五条 第一款 之 规定 ， 裁定 如下 ： 

张小英与朱兴武离婚纠纷一审民事裁定书.txt	据此 ， 依照 《 中华人民共和国 民事 诉讼法 》 第 一百四十 五条 、 第一百五十四条 之 规定 ， 裁定 如下 ： 

张建英与钏有树离婚纠纷一案民事裁定书.txt	依照 《 中华人民共和国 民事 诉讼法 》 第 一百四十 五条 之 规定 ， 裁定 如下 ： 

张某与刘某某离婚纠纷一审民事裁定书.txt	依据 《 中华人民共和国 民事 诉讼法 》 第 一百四十 五条 第一款 之 规定 ， 裁定 如下 ： 

张某与刘某离婚纠纷一审民事判决书.txt	依照 《 中华人民共和国 婚姻法 》 第三十二条 之 规定 ， 判决 如下 ： 

张某与刘某离婚纠纷一审民事裁定书.txt	依照 《 中华人民共和国 民事 诉讼法 》 第 一百四十 五条 之 规定 ， 裁定 如下 ： 

张某与彭某离婚纠纷一审民事裁定书.txt	依照 《 中华人民共和国 民事 诉讼法 》 第 一百四十 五条 的 规定 ， 裁定 如下 ： 

张某与沈某某离婚纠纷一审民事裁定书.txt	根据 《 中华人民共和国 民事 诉讼法 》 第 一百四十 五条 之 规定 ， 裁定 如下 ： 

张某与游某某离婚纠纷一案一审民事裁定书.txt	依照 《 中华人民共和国 民事 诉讼法 》 第 一百四十 五条 之 规定 ， 裁定 如下 ： 

张某与王某某离婚纠纷一审民事裁定书.txt	依照 《 中华人民共和国 民事 诉讼法 》 第 一百四十 五条 第一款 之 规定 ， 裁定 如下 ： 

张某与王某离婚纠纷一审民事裁定书.txt	根据 《 中华人民共和国 民事 诉讼法 》 第 一百四十 五条 之 规定 ， 裁定 如下 ： 

张某春与朱某容离婚纠纷一审民事裁定书.txt	依照 《 中华人民共和国 民事 诉讼法 》 第 一百四十 五条 的 规定 ， 裁定 如下 ： 

张某某与丁某离婚纠纷一审民事裁定书.txt	依照 《 中华人民共和国 民事 诉讼法 》 第十三条 、 第 一百四十 五条 之 规定 ， 裁定 如下 ： 

张某某与何某某离婚纠纷一案民事裁定书.txt	依照 《 中华人民共和国 民事 诉讼法 》 第 一百四十 五条 第一款 的 规定 ， 裁定 如下 ： 

张某某与冯某某离婚纠纷一审裁定书.txt	依照 《 中华人民共和国 民事 诉讼法 》 第 一百四十 五条 第一款 的 规定 ， 裁定 如下 ： 

张某某与刘某某离婚纠纷一审民事裁定书.txt	依照 《 中华人民共和国 民事 诉讼法 》 第 一百四十 五条 第一款 的 规定 ， 裁定 如下 ： 

张某某与叶某某离婚纠纷一审民事裁定书.txt	依照 《 中华人民共和国 民事 诉讼法 》 第 一百四十 五条 第一款 的 规定 ， 裁定 如下 ： 

张某某与姜某某离婚纠纷案一审民事裁定书.txt	据此 ， 依照 《 中华人民共和国 民事 诉讼法 》 第 一百四十 五条 第一款 " 宣判 前 ， 原告 申请 撤诉 的 ， 是否 准许 ， 由 人民法院 裁定 。 " 的 规定 ， 裁定 如下 ： 

张某某与廖某某离婚纠纷一审民事裁定书.txt	依照 《 中华人民共和国 民事 诉讼法 》 第 一百四十 五条 第一款 " 宣判 前 ， 原告 申请 撤诉 的 ， 是否 准许 ， 由 人民法院 裁定 。 " 、 第一百五十四条 第一款 " 裁定 适用 于 下列 范围 ： ...... （ 五 ） 准许 或者 不 准许 撤诉 ； " 之 规定 ， 裁定 如下 ： 

张某某与徐某某离婚纠纷一审裁定书.txt	依照 《 中华人民共和国 民事 诉讼法 》 第十三条 第二款 和 第 一百四十 五条 第一款 的 规定 ， 裁定 如下 ： 

张某某与曹某某离婚纠纷一审民事裁定书.txt	据此 ， 依照 《 中华人民共和国 民事 诉讼法 》 第 一百四十 五条 第一款 " 宣判 前 ， 原告 申请 撤诉 的 ， 是否 准许 ， 由 人民法院 裁定 " 之 规定 ， 裁定 如下 ： 

张某某与曾某某离婚纠纷一审民事裁定书.txt	依照 《 诉讼费用 交纳 办法 》 第二十二条 、 《 最高人民法院 关于 适用 ﹤ 中华人民共和国 民事 诉讼法 ﹥ 的 解释 》 第 二百一十三 条 之 规定 ， 裁定 如下 ： 

张某某与李某某离婚纠纷一审民事裁定书.txt	依照 《 最高人民法院 关于 适用 ﹤ 诉讼费用 交纳 办法 ﹥ 的 通知 》 第二条 之 规定 ， 裁定 如下 ： 

张某某与李某某离婚纠纷案一审民事裁定书.txt	依照 《 中华人民共和国 民事 诉讼法 》 第 一百四十 五条 第一款 之 规定 ， 裁定 如下 ： 

张某某与程某某离婚纠纷案一审民事裁定书.txt	据此 ， 依照 《 中华人民共和国 民事 诉讼法 》 第 一百四十 五条 第一款 " 宣判 前 ， 原告 申请 撤诉 的 ， 是否 准许 ， 由 人民法院 裁定 。 " 的 规定 ， 裁定 如下 ： 

张某某与罗某离婚纠纷一审民事裁定书.txt	依照 《 中华人民共和国 民事 诉讼法 》 第 一百四十 三条 之 规定 ， 裁定 如下 ： 

张某某与苗某某离婚纠纷一审民事裁定书.txt	据此 ， 依照 《 中华人民共和国 民事 诉讼法 》 第 一百四十 五条 第一款 之 规定 ， 裁定 如下 ： 

张某某与范某某离婚纠纷一审民事裁定书.txt	依照 《 中华人民共和国 民事 诉讼法 》 第 一百四十 五条 之 规定 ， 裁定 如下 ： 

张某某与薛某某离婚纠纷一审民事裁定书.txt	依照 《 中华人民共和国 民事 诉讼法 》 第 一百四十 五条 之 规定 ， 裁定 如下 ： 

张某某与许某某离婚纠纷案一审民事裁定书.txt	依照 《 中华人民共和国 民事 诉讼法 》 第 一百四十 五条 之 规定 ， 裁定 如下 ： 

张某某与赵某某离婚纠纷一审民事裁定书.txt	依照 《 中华人民共和国 民事 诉讼法 》 第 一百一十 八条 第一款 、 最高人民法院 《 人民法院 诉讼 收费 办法 》 第二十二条 的 规定 ， 裁定 如下 ： 

张某某与陈某某离婚纠纷一审民事裁定书.txt	依照 《 中华人民共和国 民事 诉讼法 》 第 一百四十 五条 的 规定 ， 裁定 如下 ： 

张某某与陈某离婚纠纷一审民事裁定书.txt	依照 《 中华人民共和国 民事 诉讼法 》 第 一百四十 五条 之 规定 ， 裁定 如下 ： 

张某某与马某某离婚纠纷一审民事裁定书.txt	本院 在 审理 原告 张 某某 诉 被告 马 某某 离婚 纠纷 一案 中 ， 因 原告 张 某某 在 本院 通知 其 按规定 七日 内 预交 案件 受理费 后 ， 到期 既 不 预交 ， 也 未 提出 减 、 缓 、 免 申请 ， 依照 【 最高人民法院 关于 《 中华人民共和国 民事 诉讼法 》 的 解释 】 第 二百一十三 条 之 规定 ， 裁定 如下 ： 

张某某诉李某某离婚纠纷一审民事裁定书.txt	依照 《 中华人民共和国 民事 诉讼法 》 第 一百四十 五条 第一款 之 规定 ， 裁定 如下 ： 

张某某诉田某某离婚纠纷一案一审裁定书.txt	依照 《 中华人民共和国 民事 诉讼法 》 第 一百四十 五条 第一款 之 规定 ， 裁定 如下 ： 

张某某诉罗某离婚纠纷一审民事裁定书.txt	根据 《 中华人民共和国 民事 诉讼法 》 第 一百四十 五条 之 规定 ， 裁定 如下 ： 

张某某诉被告文某某离婚纠纷一审民事裁定书.txt	依照 《 中华人民共和国 民事 诉讼法 》 第 一百四十 五条 第一款 之 规定 ， 裁定 如下 ： 

张某某诉赵某某离婚纠纷一审民事裁定书.txt	依照 《 中华人民共和国 民事 诉讼法 》 第 一百四十 五条 第一款 之 规定 ， 裁定 如下 ： 

张某某诉邓某离婚纠纷案(2016)川1028民初1236号一审民事裁定书.txt	依照 《 中华人民共和国 民事 诉讼法 》 第 一百四十 五条 的 规定 ， 裁定 如下 ： 

张某某诉邹某某离婚纠纷案(2016)川1028民初1142号一审民事裁定书.txt	依照 《 中华人民共和国 民事 诉讼法 》 第 一百四十 五条 的 规定 ， 裁定 如下 ： 

张某甲与张某乙离婚纠纷一审民事裁定书.txt	依照 《 中华人民共和国 民事 诉讼法 》 第 一百四十 五条 之 规定 ， 裁定 如下 ： 

张某诉朱某某离婚纠纷一审民事裁定书.txt	依照 《 中华人民共和国 民事 诉讼法 》 第 一百四十 五条 " 宣判 前 ， 原告 申请 撤诉 的 ， 是否 准许 ， 由 人民法院 裁定 " 的 规定 ， 裁定 如下 ： 

张某诉李某某离婚纠纷案一审民事裁定书.txt	依照 《 中华人民共和国 民事 诉讼法 》 第 一百四十 五条 第一款 的 规定 ， 裁定 如下 ： 

张某诉黄某离婚纠纷一审民事裁定书.txt	依照 《 最高人民法院 关于 适用 ﹤ 中华人民共和国 民事 诉讼法 ﹥ 的 解释 》 第 二百一十三 条 " 原告 应当 预交 而 未 预交 案件 受理费 ， 人民法院 应当 通知 其 预交 ， 通知 后 仍 不 预交 或者 申请 减 、 缓 、 免 未获 批准 而 仍 不 预交 的 ， 裁定 按 撤诉 处理 。 " 之 规定 ， 裁定 如下 ： 

强某某与袁某某离婚纠纷一案一审民事裁定书.txt	依照 《 中华人民共和国 民事 诉讼法 》 第 一百四十 三条 " 原告 经 传票 传唤 ， 无 正当理由 拒 不 到庭 的 ， 或者 未经 法庭 许可 中途 退庭 的 ， 可以 按 撤诉 处理 ； 被告 反诉 的 ， 可以 缺席判决 " 之 规定 ， 裁定 如下 ： 

彭平旭诉王先伟离婚纠纷一审民事裁定书.txt	依照 《 中华人民共和国 民事 诉讼法 》 第 一百四十 五条 之 规定 ， 裁定 如下 ： 

彭某某与刘某某离婚纠纷案一审民事裁定书.txt	依照 《 中华人民共和国 民事 诉讼法 》 第 一百四十 五条 第一款 之 规定 ， 裁定 如下 ： 

彭某某与张某某离婚纠纷一审民事裁定书.txt	依照 《 中华人民共和国 民事 诉讼法 》 第 一百四十 五条 之 规定 ， 裁定 如下 ： 

彭某某与马某某离婚纠纷一审民事裁定书.txt	依照 《 中华人民共和国 民事 诉讼法 》 第 一百四十 五条 第一款 ： 宣判 前 ， 原告 申请 撤诉 的 ， 是否 准许 ， 由 人民法院 裁定 、 第一百五十四条 第一款 第 （ 五 ） 项 ： 裁定 适用 于 下列 范围 ： （ 五 ） 准许 或者 不 准许 撤诉 之 规定 ， 裁定 如下 ： 

彭某某诉赵某离婚纠纷一案一审民事裁定书.txt	依照 《 中华人民共和国 民事 诉讼法 》 第 一百四十 五条 第一款 之 规定 ， 裁定 如下 ： 

彭某诉被告付某某离婚纠纷一审民事裁定书.txt	依照 《 中华人民共和国 民事 诉讼法 》 第十三条 第二款 、 第 一百四十 五条 第一款 的 规定 ， 裁定 如下 ： 

徐某与赵某某离婚纠纷一审民事裁定书.txt	依照 《 中华人民共和国 民事 诉讼法 》 第十三条 第二款 " 当事人 有权 在 法律 规定 的 范围 内 处分 自己 的 民事权利 和 诉讼 权利 " 及第 一百四十 五条 第一款 " 宣判 前 ， 原告 申请 撤诉 的 ， 是否 准许 ， 由 人民法院 裁定 。 " 的 规定 ， 裁定 如下 ： 

徐某某与丁某某离婚纠纷一审民事裁定书.txt	据此 ， 依照 《 中华人民共和国 民事 诉讼法 》 第 一百四十 五条 第一款 之 规定 ， 裁定 如下 ： 

徐某某与刘某某离婚纠纷一审民事裁定书.txt	依照 《 最高人民法院 关于 适用 〈 中华人民共和国 民事 诉讼法 〉 的 解释 》 第 213 条 " 原告 应当 预交 而 未 预交 案件 受理费 ， 人民法院 应当 通知 其 预交 ， 通知 后 仍 不 预交 或者 申请 减 、 缓 、 免 未获 人民法院 批准 而 仍 不 预缴 的 ， 裁定 按 自动 撤诉 处理 。 " 之 规定 ， 裁定 如下 ： 

徐某某与刘某某离婚纠纷一案一审民事裁定书.txt	依据 《 中华人民共和国 民事 诉讼法 》 第 一百四十 五条 之 规定 ， 裁定 如下 ： 

徐某某与张某某离婚纠纷一审民事裁定书.txt	依照 《 中华人民共和国 民事 诉讼法 》 第 一百四十 五条 第一款 宣判 前 ， 原告 申请 撤诉 的 ， 是否 准许 ， 由 人民法院 裁定 。 、 第一百五十四条 第一款 第五项 裁定 适用 于 下列 范围 ： （ 五 ） 准许 或者 不 准许 撤诉 。 之 规定 ， 裁定 如下 ： 

徐某某与张某离婚纠纷一审民事裁定书.txt	依照 《 中华人民共和国 民事 诉讼法 》 第 一百四十 五条 第一款 之 规定 ， 裁定 如下 ： 

徐某某与王某某离婚纠纷一审民事裁定书.txt	依照 《 中华人民共和国 民事 诉讼法 》 第 一百四十 五条 的 规定 ， 裁定 如下 ： 

徐某某与高某某离婚纠纷案一审民事裁定书.txt	根据 《 中华人民共和国 民事 诉讼法 》 第 一百四十 五条 之 规定 ， 裁定 如下 ： 

徐某某诉张某某离婚纠纷一案一审民事裁定书.txt	依照 《 中华人民共和国 民事 诉讼法 》 第 一百四十 五条 的 规定 ， 裁定 如下 ： 

徐某诉吴某某离婚纠纷一案一审民事裁定书.txt	依照 《 中华人民共和国 民事 诉讼法 》 第 一百四十 五条 第一款 " 宣判 前 ， 原告 申请 撤诉 的 ， 是否 准许 ， 由 人民法院 裁定 。 " 之 规定 ， 裁定 如下 ： 

德某某与泽某某关于婚姻家庭纠纷一案撤诉裁定书.txt	依照 《 中华人民共和国 民事 诉讼法 》 第 一百四十 五条 的 规定 ， 裁定 如下 ： 

戢某某与申某某离婚纠纷一审民事裁定书.txt	依照 《 诉讼费用 交纳 办法 》 第二十条 第一款 、 第二十二条 第一款 、 《 最高人民法院 关于 适用 ﹤ 诉讼费用 交纳 办法 ﹥ 的 通知 》 第二条 之 规定 ， 裁定 如下 ： 

戴某国与陈某秀离婚纠纷民事裁定书.txt	依照 《 诉讼费 管理 办法 》 第二十二条 的 规定 ， 裁定 如下 ： 

文某与任某某离婚纠纷民事裁定书.txt	依照 《 中华人民共和国 民事 诉讼法 》 第 一百四十 五条 之 规定 ， 裁定 如下 ： 

文某与何某离婚纠纷一审民事裁定书.txt	依照 《 中华人民共和国 民事 诉讼法 》 第 一百四十 五条 第一款 之 规定 ， 裁定 如下 ： 

文某与赵某离婚纠纷一审民事裁定书.txt	根据 《 中华人民共和国 民事 诉讼法 》 第 一百四十 五条 之 规定 ， 裁定 如下 ： 

文某某与李某某离婚纠纷一审民事裁定书.txt	依照 《 中华人民共和国 民事 诉讼法 》 第 一百一十 八条 、 第一百五十四条 第一款 第 （ 十一 ） 项 、 最高人民法院 关于 适用 《 中华人民共和国 民事 诉讼法 》 的 解释 第 二百一十三 条 之 规定 ， 裁定 如下 ： 

文某某与林某离婚纠纷一审民事裁定书.txt	依照 《 中华人民共和国 民事 诉讼法 》 第 一百四十 五条 之 规定 ， 裁定 如下 ： 

文某某与陈某某离婚纠纷一审民事判决书.txt	据此 ， 依照 《 中华人民共和国 婚姻法 》 第三十二条 第二款 之 规定 判决 如下 ： 

方某某与王某某离婚纠纷一审民事裁定书.txt	依照 《 中华人民共和国 民事 诉讼法 》 第 一百四十 五条 第一款 的 规定 ， 裁定 如下 ： 

施某某与胡某某离婚纠纷一审民事裁定书.txt	依照 《 中华人民共和国 民事 诉讼法 》 第 一百四十 五条 的 规定 ， 裁定 如下 ： 

易某与华某离婚纠纷案一审民事裁定书.txt	依照 《 中华人民共和国 民事 诉讼法 》 第 一百四十 五条 第一款 的 规定 ， 裁定 如下 ： 

昝某某与罗某某离婚纠纷一审民事裁定书.txt	依照 《 中华人民共和国 民事 诉讼法 》 第 一百四十 五条 第一款 之 规定 ， 裁定 如下 ： 

曲木某某诉布滴某某离婚纠纷案一审民事裁定书.txt	依照 《 中华人民共和国 民事 诉讼法 》 第十三条 第二款 、 第 一百四十 五条 第一款 之 规定 ， 裁定 如下 ： 

曹某与熊某离婚纠纷一审民事裁定书.txt	依照 《 中华人民共和国 民事 诉讼法 》 第 一百四十 五条 之 规定 ， 裁定 如下 ： 

曹某某与李某某离婚纠纷案一审民事裁定书.txt	据此 ， 依照 《 中华人民共和国 民事 诉讼法 》 第 一百四十 五条 第一款 " 宣判 前 ， 原告 申请 撤诉 的 ， 是否 准许 ， 由 人民法院 裁定 。 " 的 规定 ， 裁定 如下 ： 

曹某某与杨某某离婚纠纷一审民事裁定书.txt	依照 《 中华人民共和国 民事 诉讼法 》 第 一百四十 五条 第一款 之 规定 ， 裁定 如下 ： 

曹某某与郑某离婚纠纷一案一审民事裁定书.txt	依照 《 中华人民共和国 民事 诉讼法 》 第一百 四十五 的 规定 ， 裁定 如下 ： 

曾某某与刘某某离婚纠纷案一审民事裁定书.txt	依照 《 中华人民共和国 民事 诉讼法 》 第 一百四十 五条 第一款 的 规定 ， 裁定 如下 ： 

曾某某与戚某某离婚纠纷一审民事裁定书.txt	依照 《 中华人民共和国 民事 诉讼法 》 第 一百四十 五条 第一款 之 规定 ， 裁定 如下 ： 

曾某某与旷某某离婚纠纷一审民事裁定书.txt	根据 《 中华人民共和国 民事 诉讼法 》 第 一百四十 五条 第一款 之 规定 ， 裁定 如下 ： 

曾某某与郭某某离婚纠纷一审民事裁定书.txt	依照 《 中华人民共和国 民事 诉讼法 》 第 一百四十 五条 第一款 ： 宣判 前 ， 原告 申请 撤诉 的 ， 是否 准许 ， 由 人民法院 裁定 、 第一百五十四条 第一款 第 （ 五 ） 项 ： 裁定 适用 于 下列 范围 ： hellip ; hellip ; （ 五 ） 准许 或者 不 准许 撤诉 ； hellip ; hellip ; 之 规定 ， 裁定 如下 ： 

曾某某诉刘某某离婚纠纷案（2016）川1028民初1501号民一审民事裁定书.txt	依照 《 中华人民共和国 民事 诉讼法 》 第 一百四十 五条 规定 ， 裁定 如下 ： 

曾某某诉王某某离婚纠纷民事裁定书.txt	依照 《 中华人民共和国 民事 诉讼法 》 第十三条 第二款 ， 第 一百四十 五条 第一款 ， 第一百五十四条 第一款 第 （ 五 ） 项 和 《 诉讼费用 交纳 办法 》 第十五条 的 规定 ， 裁定 如下 ： 

曾树娟与杨杰离婚纠纷一审民事裁定书.txt	依照 《 中华人民共和国 民事 诉讼法 》 第 一百四十 五条 第一款 之 规定 ， 裁定 如下 ： 

木某与陈某离婚纠纷一审民事裁定书.txt	依照 《 中华人民共和国 民事 诉讼法 》 第 一百四十 五条 的 规定 ， 裁定 如下 ： 

朱某与徐某某离婚纠纷一审民事裁定书.txt	依照 《 中华人民共和国 民事 诉讼法 》 第 一百一十 八条 、 最高人民法院 关于 适用 《 中华人民共和国 民事 诉讼法 》 若干 问题 的 意见 第 一百四十 三条 之 规定 ， 裁定 如下 ： 

朱某某与王某某离婚纠纷一审民事裁定书.txt	依照 《 中华人民共和国 民事 诉讼法 》 第 一百四十 五条 第一款 ： " 宣判 前 ， 原告 申请 撤诉 的 ， 是否 准许 ， 由 人民法院 裁定 " 的 规定 ， 裁定 如下 ： 

朱某某与许某离婚纠纷案一审民事裁定书.txt	依照 《 中华人民共和国 民事 诉讼法 》 第 一百四十 五条 之 规定 ， 裁定 如下 ： 

朱某某与赵某某离婚纠纷一审民事裁定书.txt	依照 《 中华人民共和国 民事 诉讼法 》 第 一百四十 五条 的 规定 ， 裁定 如下 ： 

朱某某与郑某某离婚纠纷一审民事裁定书.txt	根据 《 中华人民共和国 民事 诉讼法 》 第十三条 二款 、 第 一百四十 五条 之 规定 ， 裁定 如下 ： 

朱某某诉沈某某离婚纠纷一审民事裁定书.txt	依照 《 中华人民共和国 民事 诉讼法 》 第 一百四十 五条 第一款 之 规定 ， 裁定 如下 ： 

朱某诉王某离婚纠纷案一审民事裁定书.txt	依照 《 中华人民共和国 民事 诉讼法 》 第 一百四十 五条 、 一百五十 四条 第一款 第五项 的 规定 ， 裁定 如下 ： 

李全与蒲祥连离婚纠纷案一审民事裁定书.txt	依照 《 中华人民共和国 民事 诉讼法 》 第 一百四十 五条 第一款 宣判 前 ， 原告 申请 撤诉 的 ， 是否 准许 ， 由 人民法院 裁定 之 规定 ， 裁定 如下 ： 

李某与孙某离婚纠纷一审民事裁定书.txt	依照 《 中华人民共和国 民事 诉讼法 》 第 一百四十 五条 之 规定 ， 裁定 如下 ： 

李某与张某某离婚纠纷一审民事裁定书.txt	依照 《 中华人民共和国 民事 诉讼法 》 第 一百四十 三条 的 规定 ， 裁定 如下 ： 

李某与熊某离婚纠纷一审民事裁定书.txt	依照 《 中华人民共和国 民事 诉讼法 》 第 一百四十 五条 的 规定 ， 裁定 如下 ： 

李某与牟某某离婚纠纷一审民事裁定书.txt	依照 《 中华人民共和国 民事 诉讼法 》 第十三条 第二款 、 第 一百四十 五条 第一款 之 规定 ， 裁定 如下 ： 

李某与牟某离婚纠纷一审民事裁定书.txt	依照 《 中华人民共和国 民事 诉讼法 》 第 一百四十 五条 第一款 " 宣判 前 ， 原告 申请 撤诉 的 ， 是否 准许 ， 由 人民法院 裁定 " 之 规定 ， 裁定 如下 ： 

李某与白某离婚纠纷一审民事裁定书.txt	根据 《 中华人民共和国 民事 诉讼法 》 第 一百四十 五条 之 规定 ， 裁定 如下 ： 

李某与辛某离婚纠纷一审民事裁定书.txt	据此 ， 依照 《 中华人民共和国 民事 诉讼法 》 第 一百四十 五条 第一款 之 规定 ， 裁定 如下 ： 

李某与阿某某离婚纠纷一审民事裁定书.txt	据此 ， 依照 《 中华人民共和国 民事 诉讼法 》 第 一百四十 五条 第一款 之 规定 ， 裁定 如下 ： 

李某与黄某离婚纠纷一审民事裁定书.txt	据此 ， 依照 《 中华人民共和国 民事 诉讼法 》 第 一百四十 五条 第一款 之 规定 ， 裁定 如下 ： 

李某某与付某某离婚纠纷一审民事裁定书.txt	根据 《 中华人民共和国 民事 诉讼法 》 第 一百四十 五条 第一款 的 规定 ， 裁定 如下 ： 

李某某与何某某离婚纠纷一审民事裁定书.txt	依照 《 中华人民共和国 民事 诉讼法 》 第 一百四十 五条 第一款 " 宣判 前 ， 原告 申请 撤诉 的 ， 是否 准许 ， 由 人民法院 裁定 " 之 规定 ， 裁定 如下 ： 

李某某与冯某某离婚纠纷一审民事裁定书.txt	依照 《 中华人民共和国 民事 诉讼法 》 第 一百四十 五条 的 规定 ， 裁定 如下 ： 

李某某与刘某某离婚后财产纠纷一审民事裁定书.txt	依照 《 中华人民共和国 民事 诉讼法 》 第 一百四十 五条 第一款 ： 宣判 前 ， 原告 申请 撤诉 的 ， 是否 准许 ， 由 人民法院 裁定 、 第一百五十四条 第一款 第 （ 五 ） 项 ： 裁定 适用 于 下列 范围 ： （ 五 ） 准许 或者 不 准许 撤诉 之 规定 ， 裁定 如下 ： 

李某某与刘某某离婚纠纷一审民事裁定书.txt	根据 《 中华人民共和国 民事 诉讼法 》 第 一百四十 五条 之 规定 ， 裁定 如下 ： 

李某某与向某某离婚纠纷案一审民事裁定书.txt	依照 《 中华人民共和国 民事 诉讼法 》 第 一百四十 五条 第一款 的 规定 ， 裁定 如下 ： 

李某某与吴某某离婚纠纷一审民事裁定书.txt	依照 《 中华人民共和国 民事 诉讼法 》 第十三条 第二款 、 第 一百四十 五条 第一款 之 规定 ， 裁定 如下 ： 

李某某与周某某离婚纠纷一审民事裁定书.txt	依照 《 中华人民共和国 民事 诉讼法 》 第 一百四十 三条 之 规定 ， 裁定 如下 ： 

李某某与唐某离婚纠纷民事一审裁定书.txt	依照 《 中华人民共和国 民事 诉讼法 》 第 一百四十 五条 第一款 " 宣判 前 ， 原告 申请 撤诉 的 ， 是否 准许 ， 由 人民法院 裁定 " 之 规定 ， 裁定 如下 ： 

李某某与岳某某关于离婚纠纷一审民事裁定书.txt	本院认为 ， 原告 李 某某 的 申请 符合 《 中华人民共和国 民事 诉讼法 》 第 一百四十 五条 第一款 " 宣判 前 ， 原告 申请 撤诉 的 ， 是否 准许 ， 由 人民法院 裁定 。 " 之 规定 ， 裁定 如下 ： 

李某某与徐某某离婚纠纷一案一审民事裁定书.txt	依照 《 中华人民共和国 民事 诉讼法 》 第一百 四十五 的 规定 ， 裁定 如下 ： 

李某某与方某某离婚纠纷一审民事裁定书.txt	依照 《 中华人民共和国 共和国 民事 诉讼法 》 第 一百四十 五条 之 规定 ， 裁定 如下 ： 

李某某与曹某离婚纠纷一案一审民事裁定书.txt	依照 《 中华人民共和国 民事 诉讼法 》 第 一百四十 五条 的 规定 ， 裁定 如下 ： 

李某某与曾某某离婚纠纷二审民事裁定书.txt	依照 《 中华人民共和国 民事 诉讼法 》 第一百七十条 第一款 第 （ 二 ） 项 、 第 一百七十 一条 、 第一百七 十五条 和 《 最高人民法院 关于 适用 ﹤ 中华人民共和国 民事 诉讼法 ﹥ 的 解释 》 第三 百 三十二条 的 规定 ， 裁定 如下 ： 

李某某与李某甲离婚纠纷一审民事裁定书.txt	根据 《 中华人民共和国 民事 诉讼法 》 第 一百四十 五条 、 第一百五十四条 的 规定 ， 裁定 如下 ： 

李某某与杨某某离婚纠纷一审民事裁定书.txt	依照 《 中华人民共和国 民事 诉讼法 》 第 一百四十 五条 第一款 的 规定 ， 裁定 如下 ： 

李某某与林某某离婚纠纷一审民事裁定书.txt	根据 《 中华人民共和国 民事 诉讼法 》 第 一百四十 五条 第一款 之 规定 ， 现 裁定 如下 ： 

李某某与江某某离婚纠纷民事裁定书.txt	依照 《 中华人民共和国 民事 诉讼法 》 第 一百四十 五条 之 规定 ， 裁定 如下 ： 

李某某与王某某离婚纠纷一审民事裁定书.txt	根据 《 中华人民共和国 民事 诉讼法 》 第 一百四十 三条 之 规定 ， 裁定 如下 ： 

李某某与王某离婚纠纷一审民事裁定书.txt	据此 ， 依照 《 中华人民共和国 民事 诉讼法 》 第 一百四十 五条 第一款 " 宣判 前 ， 原告 申请 撤诉 的 ， 是否 准许 ， 由 人民法院 裁定 。 " 之 规定 ， 裁定 如下 ： 

李某某与聂某某离婚纠纷一审民事裁定书.txt	依照 《 中华人民共和国 民事 诉讼法 》 第 一百四十 五条 第一款 之 规定 ， 裁定 如下 ： 

李某某与范某某离婚纠纷一审民事裁定书.txt	根据 《 中华人民共和国 民事 诉讼法 》 第 一百四十 五条 第一款 之 规定 ， 裁定 如下 ： 

李某某与董某某离婚纠纷一审民事裁定书.txt	据此 ， 依照 《 中华人民共和国 民事 诉讼法 》 第 一百四十 五条 第一款 " 宣判 前 ， 原告 申请 撤诉 的 ， 是否 准许 ， 由 人民法院 裁定 。 " 之 规定 ， 裁定 如下 ： 

李某某与蔡某某离婚纠纷案一审民事裁定书.txt	依照 《 中华人民共和国 民事 诉讼法 》 第 一百一十 八条 第一 、 二款 及 《 最高人民法院 关于 适用 ﹤ 中华人民共和国 民事 诉讼法 ﹥ 的 解释 》 第 二百一十三 条 的 规定 ， 裁定 如下 ： 

李某某与袁某某离婚纠纷一审民事裁定书.txt	根据 《 中华人民共和国 民事 诉讼法 》 第 一百四十 五条 第一款 的 规定 ， 裁定 如下 ： 

李某某与詹某某离婚后财产纠纷一审民事裁定书.txt	依照 《 中华人民共和国 民事 诉讼法 》 第 一百四十 五条 之 规定 ， 裁定 如下 ： 

李某某与郎某某离婚纠纷一审民事裁定书.txt	依照 《 中华人民共和国 民事 诉讼法 》 第 一百四十 三条 之 规定 ， 裁定 如下 ： 

李某某与韩某某离婚纠纷一审民事裁定书.txt	依照 《 中华人民共和国 民事 诉讼法 》 第 一百四十 五条 第一款 、 第一百五十四条 第一款 （ 五项 ） 之 规定 ， 裁定 如下 ： 

李某某与黄某某离婚纠纷一审民事裁定书.txt	依照 《 中华人民共和国 民事 诉讼法 》 第 一百四十 五条 第一款 的 规定 ， 裁定 如下 ： 

李某某与黄某离婚纠纷一审民事裁定书.txt	依照 《 中华人民共和国 民事 诉讼法 》 第 一百四十 五条 " 宣判 前 ， 原告 申请 撤诉 的 ， 是否 准许 ， 由 人民法院 裁定 。 " 之 规定 ， 裁定 如下 ： 

李某某诉何某某离婚后财产纠纷民事一审裁定书.txt	据此 ， 依照 《 中华人民共和国 民事 诉讼法 》 第 一百四十 五条 第一款 之 规定 ， 裁定 如下 ： 

李某某诉刘某某离婚纠纷民事裁定书.txt	依照 《 中华人民共和国 民事 诉讼法 》 第十三条 第二款 ， 第 一百四十 五条 第一款 ， 第一百五十四条 第一款 第 （ 五 ） 项 和 《 诉讼费用 交纳 办法 》 第十五条 的 规定 ， 裁定 如下 ： 

李某某诉朱某某离婚纠纷一案一审民事裁定书.txt	依照 《 中华人民共和国 民事 诉讼法 》 第 一百四十 三条 的 规定 ， 裁定 如下 ： 

李某某诉王某某离婚纠纷案一审民事裁定书.txt	依照 《 中华人民共和国 民事 诉讼法 》 第十三条 第二款 、 第 一百四十 五条 第一款 之 规定 ， 裁定 如下 ： 

李某某诉黄某某离婚纠纷案一审民事裁定书.txt	依照 《 中华人民共和国 民事 诉讼法 》 第十三条 第二款 、 第 一百四十 五条 第一款 之 规定 ， 裁定 如下 ： 

李某甲与李某乙离婚纠纷一审民事裁定书.txt	根据 《 中华人民共和国 民事 诉讼法 》 第 一百四十 五条 之 规定 ， 裁定 如下 ： 

李某甲诉李某乙离婚纠纷一审民事裁定书.txt	依照 《 中华人民共和国 民事 诉讼法 》 第 一百四十 五条 第一款 的 规定 ， 裁定 如下 ： 

李某英与贺某鑫离婚纠纷一审民事裁定书.txt	依照 《 中华人民共和国 民事 诉讼法 》 第 一百四十 五条 的 规定 ， 裁定 如下 ： 

李某顺与陈某娟离婚纠纷一审民事裁定书.txt	依照 《 中华人民共和国 民事 诉讼法 》 第十三条 第二款 、 第 一百四十 五条 第一款 的 规定 ， 裁定 如下 ： 

李红诉王翔离婚纠纷一审民事裁定书.txt	依照 《 中华人民共和国 民事 诉讼法 》 第 一百四十 五条 第一款 " 宣判 前 ， 原告 申请 撤诉 的 ， 是否 准许 ， 由 人民法院 裁定 。 " 之 规定 ， 裁定 如下 ： 

杜某与王某某离婚纠纷一审民事裁定书.txt	依照 《 中华人民共和国 民事 诉讼法 》 第十三条 第二款 " 当事人 有权 在 法律 规定 的 范围 内 处分 自己 的 民事权利 和 诉讼 权利 " 、 第 一百四十 五条 第一款 " 宣判 前 ， 原告 申请 撤诉 的 ， 是否 准许 ， 由 人民法院 裁定 " 和 《 诉讼费 交纳 办法 》 第十五条 " 以 调解 方式 结案 或者 当事人 申请 撤诉 的 ， 减半 交纳 案件 受理费 " 之 规定 裁定 如下 ： 

杜某与邓某离婚纠纷一审民事裁定书.txt	依照 《 中华人民共和国 民事 诉讼法 》 第 一百四十 五条 第一款 的 规定 ， 裁定 如下 ： 

杜某某与古某某离婚后财产纠纷二审民事裁定书.txt	依照 《 中华人民共和国 民事 诉讼法 》 第一百七 十三条 的 规定 ， 裁定 如下 ： 

杜某某与彭某某离婚纠纷一审民事裁定书.txt	据此 、 根据 《 中华人民共和国 民事 诉讼法 》 第 一百四十 三条 之 规定 ， 裁定 如下 ： 

杜某某与李某某离婚纠纷一审民事裁定书.txt	依照 《 中华人民共和国 民事 诉讼法 》 第 一百四十 五条 之 规定 ， 裁定 如下 ： 

杜某某与许某离婚纠纷民事裁定书.txt	根据 《 中华人民共和国 诉讼法 》 第 一百四十 五条 之 规定 ， 裁定 如下 ： 

杜某某与陈某某离婚纠纷一审民事裁定书.txt	据此 ， 依照 《 中华人民共和国 民事 诉讼法 》 第 一百四十 五条 第一款 " 宣判 前 ， 原告 申请 撤诉 的 ， 是否 准许 ， 由 人民法院 裁定 。 " 之 规定 ， 裁定 如下 ： 

杜某某诉贾某某离婚纠纷一审民事裁定书.txt	根据 《 中华人民共和国 民事 诉讼法 》 第 一百四十 五条 之 规定 ， 裁定 如下 ： 

杞某某与袁某某离婚纠纷一审民事裁定书.txt	依照 《 中华人民共和国 民事 诉讼法 》 第 一百四十 五条 第一款 之 规定 ， 裁定 如下 ： 

杨婷婷与潘明亮离婚纠纷案民事裁定书.txt	依照 《 中华人民共和国 民事 诉讼法 》 第 一百四十 五条 之 规定 ， 裁定 如下 ： 

杨某、杨某英、周某珍与罗某雪、罗某凯、黄某琼婚约财产纠纷一审民事裁定书.txt	依照 《 中华人民共和国 民事 诉讼法 》 第十三条 第二款 、 第 一百四十 五条 第一款 的 规定 ， 裁定 如下 ： 

杨某与万某某离婚纠纷一审民事裁定书.txt	据此 ， 依照 《 中华人民共和国 民事 诉讼法 》 第 一百四十 五条 第一款 之 规定 ， 裁定 如下 ： 

杨某与冯某离婚纠纷一审民事裁定书.txt	依照 《 中华人民共和国 民事 诉讼法 》 第 一百四十 五条 之 规定 ， 裁定 如下 ： 

杨某与刘某离婚纠纷一审民事裁定书.txt	根据 《 中华人民共和国 民事 诉讼法 》 第 一百四十 五条 之 规定 ， 裁定 如下 ： 

杨某与廖某离婚纠纷一审民事裁定书.txt	根据 《 中华人民共和国 民事 诉讼法 》 第 一百四十 五条 之 规定 ， 裁定 如下 ： 

杨某与李某离婚纠纷一审民事裁定书.txt	根据 《 中华人民共和国 民事 诉讼法 》 第 一百四十 五条 之 规定 ， 裁定 如下 ： 

杨某与杜某离婚纠纷一审民事裁定书.txt	根据 《 中华人民共和国 民事 诉讼法 》 第 一百四十 五条 之 规定 ， 裁定 如下 ： 

杨某与温某离婚纠纷一审民事裁定书.txt	依照 《 中华人民共和国 民事 诉讼法 》 第 一百四十 三条 、 第一百五十四条 第一款 第十一 项 的 规定 ， 裁定 如下 ： 

杨某与王某某离婚纠纷一审民事裁定书.txt	依照 《 中华人民共和国 民事 诉讼法 》 第十三条 第二款 当事人 有权 在 法律 规定 的 范围 内 处分 自己 的 民事权利 和 诉讼 权利 及第 一百四十 五条 第一款 宣判 前 ， 原告 申请 撤诉 的 ， 是否 准许 ， 由 人民法院 裁定 。 的 规定 ， 裁定 如下 ： 

杨某与王某离婚纠纷一审民事裁定书.txt	依照 《 中华人民共和国 民事 诉讼法 》 第 一百四十 五条 的 规定 ， 裁定 如下 ： 

杨某与罗某甲离婚纠纷一审民事裁定书.txt	根据 《 中华人民共和国 民事 诉讼法 》 第 一百四十 五条 之 规定 ， 裁定 如下 ： 

杨某与罗某离婚纠纷一审民事裁定书.txt	依照 《 中华人民共和国 民事 诉讼法 》 第 一百四十 五条 之 规定 ， 裁定 如下 ： 

杨某与董某某离婚纠纷二审民事裁定书.txt	依照 《 中华人民共和国 民事 诉讼法 》 第一百七 十三条 的 规定 ， 裁定 如下 ： 

杨某与邓某某离婚纠纷一审民事判决书.txt	据此 ， 依照 《 中华人民共和国 婚姻法 》 第三十二条 三款 四项 之 规定 ， 判决 如下 ： 

杨某与韩某离婚纠纷一审民事裁定书.txt	根据 《 中华人民共和国 民事 诉讼法 》 第 一百四十 五条 之 规定 ， 裁定 如下 ： 

杨某与顾某某离婚纠纷一审民事裁定书.txt	依照 《 中华人民共和国 民事 诉讼法 》 第 一百四十 五条 第一款 之 规定 ， 裁定 如下 ： 

杨某与鲁某某离婚纠纷案一审民事裁定书.txt	依照 《 中华人民共和国 民事 诉讼法 》 第 一百四十 五条 第一款 的 规定 ， 裁定 如下 ： 

杨某与黄某某离婚纠纷一审民事裁定书.txt	根据 《 中华人民共和国 民事 诉讼法 》 第 一百四十 五条 第一款 之 规定 ， 裁定 如下 ： 

杨某某与关某某离婚纠纷一审民事裁定书.txt	依照 《 中华人民共和国 民事 诉讼法 》 第 一百四十 五条 的 规定 ， 裁定 如下 ： 

杨某某与司某某离婚纠纷一审民事裁定书.txt	依照 《 中华人民共和国 民事 诉讼法 》 第 一百四十 五条 的 规定 ， 裁定 如下 ： 

杨某某与告唐某某离婚纠纷一审民事裁定书.txt	依照 《 中华人民共和国 民事 诉讼法 》 第 一百四十 五条 第一款 之 规定 ， 当庭 裁定 如下 ： 

杨某某与康某某离婚纠纷一审民事裁定书.txt	依照 《 中华人民共和国 民事 诉讼法 》 第 一百四十 五条 第一款 之 规定 ， 裁定 如下 ： 

杨某某与张某某离婚纠纷一审民事裁定书.txt	依照 《 中华人民共和国 民事 诉讼法 》 第 一百四十 五条 第一款 的 规定 ， 裁定 如下 ： 

杨某某与张某离婚纠纷案一审民事裁定书.txt	依照 《 中华人民共和国 民事 诉讼法 》 第 一百四十 五条 第一款 之 规定 ， 裁定 如下 ： 

杨某某与彭某某离婚纠纷案一审民事裁定书.txt	依照 《 中华人民共和国 民事 诉讼法 》 第 一百四十 五条 之 规定 ， 裁定 如下 ： 

杨某某与曹某某离婚后财产纠纷一审民事裁定书.txt	依照 《 中华人民共和国 民事 诉讼法 》 第 一百四十 五条 第一款 之 规定 ， 裁定 如下 ： 

杨某某与曹某某离婚纠纷一审民事裁定书.txt	依照 《 中华人民共和国 民事 诉讼法 》 第一百 四十五 之 规定 ， 裁定 如下 ： 

杨某某与杜某某离婚纠纷一审民事裁定书.txt	依照 《 中华人民共和国 民事 诉讼法 》 第 一百四十 五条 的 规定 ， 裁定 如下 ： 

杨某某与林某某离婚纠纷一审民事裁定书.txt	依照 《 中华人民共和国 民事 诉讼法 》 第 一百四十 三条 之 规定 ， 裁定 如下 ： 

杨某某与沙某某离婚纠纷一审民事裁定书.txt	依照 《 中华人民共和国 民事 诉讼法 》 第 一百四十 五条 第一款 之 规定 ， 裁定 如下 ： 

杨某某与罗某某离婚纠纷一审民事裁定书.txt	依照 《 中华人民共和国 民事 诉讼法 》 第 一百四十 五条 第一款 的 规定 ， 裁定 如下 ： 

杨某某与费某某离婚纠纷一审民事裁定书.txt	依照 《 中华人民共和国 民事 诉讼法 》 第 一百四十 五条 的 规定 ， 裁定 如下 ： 

杨某某与高某某离婚纠纷案一审民事裁定书.txt	依照 《 中华人民共和国 民事 诉讼法 》 第 一百四十 五条 之 规定 ， 裁定 如下 ： 

杨某某与黄某某离婚纠纷一审民事裁定书.txt	根据 《 中华人民共和国 民事 诉讼法 》 第 一百四十 五条 之 规定 ， 裁定 如下 ： 

杨某某诉刘某某离婚纠纷一案一审民事裁定书.txt	依照 《 中华人民共和国 民事 诉讼法 》 第 一百四十 五条 的 规定 ， 裁定 如下 ： 

杨某某诉殷某某离婚纠纷一案一审民事裁定书.txt	依照 《 中华人民共和国 民事 诉讼法 》 第 一百四十 五条 的 规定 ， 裁定 如下 ： 

杨某某诉王某某离婚纠纷一审民事裁定书.txt	依照 《 中华人民共和国 民事 诉讼法 》 第 一百四十 五条 之 规定 ， 裁定 如下 ： 

杨某某诉邹某某离婚纠纷一审裁定书.txt	据此 ， 依照 《 中华人民共和国 民事 诉讼法 》 第 一百四十 五条 第一款 " 宣判 前 ， 原告 申请 撤诉 的 ， 是否 准许 ， 由 人民法院 裁定 " 之 规定 ， 裁定 如下 ： 

杨某某诉陈某离婚纠纷一案一审民事裁定书.txt	依照 《 中华人民共和国 民事 诉讼法 》 第 一百四十 五条 的 规定 ， 裁定 如下 ： 

杨某甲与佘某离婚纠纷一审民事裁定书.txt	根据 《 中华人民共和国 民事 诉讼法 》 第 一百四十 五条 之 规定 ， 裁定 如下 ： 

杨某甲与杨某乙离婚纠纷一审民事裁定书.txt	根据 《 中华人民共和国 民事 诉讼法 》 第 一百四十 五条 之 规定 ， 裁定 如下 ： 

杨某碧与佘某坤离婚纠纷一审民事裁定书.txt	依照 《 中华人民共和国 民事 诉讼法 》 第 一百四十 五条 规定 ， 裁定 如下 ： 

杨正维、张祥焕与张兴德婚约财产纠纷一案（再审审查）民事裁定书.txt	依照 《 中华人民共和国 民事 诉讼法 》 第二百 零 四条 第一款 之 规定 ， 裁定 如下 ： 

杨静与张中华离婚纠纷一审民事裁定书.txt	依照 《 中华人民共和国 民事 诉讼法 》 第 一百四十 五条 的 规定 ， 裁定 如下 ： 

林某某与周某某离婚纠纷一审民事裁定书.txt	依照 《 中华人民共和国 民事 诉讼法 》 第 一百四十 五条 第一款 之 规定 ， 裁定 如下 ： 

林某某与闫某某离婚纠纷一审民事裁定书.txt	依照 《 中华人民共和国 民事 诉讼法 》 第 一百四十 五条 第一款 的 规定 ， 裁定 如下 ： 

林某诉郑某某离婚纠纷一审民事裁定书.txt	依照 《 中华人民共和国 民事 诉讼法 》 第 一百三十 一条 之 规定 ， 裁定 如下 ： 

某诉曾某某离婚纠纷一审民事裁定书.txt	依照 《 中华人民共和国 民事 诉讼法 》 第十三条 第二款 、 第 一百四十 五条 之 规定 ， 裁定 如下 ： 

某诉谢某某离婚纠纷一审民事裁定书.txt	依照 《 中华人民共和国 民事 诉讼法 》 第十三条 第二款 、 第 一百四十 五条 之 规定 ， 裁定 如下 ： 

桂某与曾某某离婚纠纷一审民事裁定书.txt	依照 《 中华人民共和国 民事 诉讼法 》 第 一百四十 五条 第一款 、 第一百五十 四 第一款 第五项 的 规定 ， 裁定 如下 ： 

梁某与张某某离婚纠纷一审民事裁定书.txt	依照 《 中华人民共和国 民事 诉讼法 》 第 一百四十 五条 第一款 的 规定 ， 裁定 如下 ： 

梁某某与罗某离婚纠纷一审民事裁定书.txt	依照 《 中华人民共和国 民事 诉讼法 》 第 一百四十 三条 的 规定 ， 裁定 如下 ： 

梁某某诉李某某离婚纠纷一审民事裁定书.txt	依照 《 最高人民法院 关于 适用 ﹤ 中华人民共和国 民事 诉讼法 ﹥ 的 解释 》 第 二百一十三 条 " 原告 应当 预交 而 未 预交 案件 受理费 ， 人民法院 应当 通知 其 预交 ， 通知 后 仍 不 预交 或者 申请 减 、 缓 、 免 未获 批准 而 仍 不 预交 的 ， 裁定 按 撤诉 处理 。 " 之 规定 ， 裁定 如下 ： 

梁英与姚武明离婚纠纷一审民事裁定书.txt	依照 《 中华人民共和国 民事 诉讼法 》 第 一百四十 五条 第一款 之 规定 ， 裁定 如下 ： 

欧某与吴某某离婚纠纷一审民事裁定书.txt	据此 ， 依照 《 中华人民共和国 民事 诉讼法 》 第 一百四十 五条 第一款 " 宣判 前 ， 原告 申请 撤诉 的 ， 是否 准许 ， 由 人民法院 裁定 。 " 之 规定 ， 裁定 如下 ： 

欧某某与刘某离婚纠纷一审民事裁定书.txt	据此 ， 依照 《 中华人民共和国 民事 诉讼法 》 第 一百四十 五条 第一款 " 宣判 前 ， 原告 申请 撤诉 的 ， 是否 准许 ， 由 人民法院 裁定 。 " 之 规定 ， 裁定 如下 ： 

武某与王某离婚纠纷一审民事裁定书.txt	依照 《 中华人民共和国 民事 诉讼法 》 第 一百四十 五条 第一款 的 规定 ， 裁定 如下 ： 

段某某与户某某离婚纠纷一审民事裁定书.txt	依照 《 中华人民共和国 民事 诉讼法 》 第 一百四十 五条 第一款 " 宣判 前 ， 原告 申请 撤诉 的 ， 是否 准许 ， 由 人民法院 裁定 " 的 规定 ， 裁定 如下 ： 

段某某与肖某某离婚纠纷案一审民事裁定书.txt	依照 《 中华人民共和国 民事 诉讼法 》 第 一百四十 五条 之 规定 ， 裁定 如下 ： 

段某某与马某离婚纠纷一审民事裁定书.txt	依照 《 中华人民共和国 民事 诉讼法 》 第 一百四十 五条 第一款 " 宣判 前 ， 原告 申请 撤诉 的 ， 是否 准许 ， 由 人民法院 裁定 。 " 之 规定 ， 裁定 如下 ： 

殷某某与潘某某离婚纠纷一审民事裁定书.txt	依照 《 中华人民共和国 民事 诉讼法 》 第 一百四十 五条 第一款 的 规定 ， 裁定 如下 ： 

毛某某与吕某某离婚纠纷一审民事裁定书.txt	依照 《 中华人民共和国 民事 诉讼法 》 第 一百四十 五条 之 规定 ， 裁定 如下 ： 

毛某某与彭某某离婚纠纷一审裁定书.txt	依照 《 中华人民共和国 民事 诉讼法 》 第十三条 第二款 、 第 一百四十 五条 第一款 的 规定 ， 裁定 如下 ： 

毛某某与王某某离婚纠纷一审民事裁定书.txt	依照 《 中华人民共和国 民事 诉讼法 》 第 一百四十 五条 第一款 宣判 前 ， 原告 申请 撤诉 的 ， 是否 准许 ， 由 人民法院 裁定 、 第一百五十四条 第一款 第五项 裁定 适用 于 下列 范围 ： （ 五 ） 准许 或者 不 准许 撤诉 之 规定 ， 裁定 如下 ： 

江某某与刘某某离婚纠纷一案一审民事裁定书.txt	依照 《 中华人民共和国 民事 诉讼法 》 第十三条 第二款 、 第 一百四十 五条 第一款 之 规定 ， 裁定 如下 ： 

江某某与陈某某离婚纠纷一案民事裁定书.txt	本院 在 审理 原告 江 某某 与 被告 陈 某某 离婚 纠纷 一案 中 ， 因 原告 江 某某 于 2016 年 3 月 2 日 因病 死亡 。 依照 第一百五十 一条 第 （ 三 ） 款 的 规定 ， 裁定 如下 ： 

汪某福与张某英离婚纠纷民事裁定书.txt	根据 《 中华人民共和国 民事 诉讼法 》 第 一百一十 八条 、 《 诉讼费用 交纳 办法 》 第二十条 第一款 、 《 最高人民法院 关于 适用 ﹤ 诉讼费用 交纳 办法 ﹥ 的 通知 》 第 （ 二 ） 项之 规定 ， 裁定 如下 ： 

沈某某与龚某某离婚纠纷一审民事裁定书.txt	依据 《 中华人民共和国 民事 诉讼法 》 第 一百四十 五条 第一款 之 规定 ， 裁定 如下 ： 

泽某某与索某某离婚纠纷一审民事裁定书.txt	依照 《 中华人民共和国 民事 诉讼法 》 第 一百四十 五条 第一款 之 规定 ， 裁定 如下 ： 

涂某某与王某某离婚纠纷案一审民事裁定书.txt	依照 《 中华人民共和国 民事 诉讼法 》 第 一百四十 三条 之 规定 ， 裁定 如下 ： 

渠某某与黄某某离婚纠纷案一审民事裁定书.txt	依照 《 中华人民共和国 民事 诉讼法 》 第 一百四十 三条 的 规定 ， 裁定 如下 ： 

温某某与刘某某离婚纠纷一审民事裁定书.txt	根据 《 中华人民共和国 民事 诉讼法 》 第 一百四十 五条 第一款 之 规定 ， 裁定 如下 ： 

漆建英与文泽平离婚纠纷一审民事裁定书.txt	依照 《 中华人民共和国 民事 诉讼法 》 第 一百四十 五条 之 规定 ， 裁定 如下 ： 

漆某与周某离婚纠纷一审民事裁定书.txt	依照 《 中华人民共和国 民事 诉讼法 》 第十三条 、 第 一百四十 五条 的 规定 ， 裁定 如下 ： 

漆某某与李某某离婚纠纷一审民事裁定书.txt	依照 《 中华人民共和国 民事 诉讼法 》 第 一百四十 五条 、 第一百五十四条 第一款 第五项 之 规定 ， 裁定 如下 ： 

熊某与文某离婚纠纷一审民事裁定书.txt	依照 《 中华人民共和国 民事 诉讼法 》 第 一百四十 五条 第一款 之 规定 ， 裁定 如下 ： 

熊某某与周某某离婚纠纷一审民事裁定书.txt	依照 《 中华人民共和国 民事 诉讼法 》 第 一百四十 五条 第一款 之 规定 ， 裁定 如下 ： 

熊某某与杨某某离婚纠纷一审民事裁定书.txt	依照 《 中华人民共和国 民事 诉讼法 》 第 一百四十 五条 第一款 " 宣判 前 ， 原告 申请 撤诉 的 ， 是否 准许 ， 由 人民法院 裁定 " 的 规定 ， 裁定 如下 ： 

熊某某与被告王某某离婚纠纷一审民事裁定书.txt	依照 《 中华人民共和国 民事 诉讼法 》 第十三条 、 第 一百四十 五条 第一款 之 规定 ， 裁定 如下 ： 

熊某某与陈某离婚纠纷离婚纠纷一审民事判决书.txt	依照 《 中华人民共和国 民事 诉讼法 》 第 一百四十 五条 之 规定 ， 裁定 如下 ： 

熊某某诉吴某离婚纠纷一审民事裁定书.txt	依照 《 中华人民共和国 民事 诉讼法 》 第 一百四十 五条 的 规定 ， 裁定 如下 ： 

牛某某与任某某离婚纠纷一审民事裁定书.txt	依照 《 中华人民共和国 民事 诉讼法 》 第 145 条 的 规定 ， 裁定 如下 ： 

牟某与杨某离婚纠纷一审民事裁定书.txt	依照 《 中华人民共和国 民事 诉讼法 》 第 一百四十 五条 之 规定 ， 裁定 如下 

牟某某与肖某某离婚纠纷一案一审民事裁定书.txt	根据 《 中华人民共和国 民事 诉讼法 》 第 一百四十 五条 、 第一百五十四条 之 规定 ， 裁定 如下 ： 

王文珍与王万华离婚纠纷一审民事裁定书.txt	依照 《 中华人民共和国 民事 诉讼法 》 第 一百四十 三条 的 规定 ， 裁定 如下 ： 

王某与任某离婚纠纷一审民事裁定书.txt	依照 《 中华人民共和国 民事 诉讼法 》 第 一百四十 五条 之 规定 ， 裁定 如下 ： 

王某与刘某离婚纠纷一审民事裁定书.txt	据此 ， 依照 《 中华人民共和国 民事 诉讼法 》 第 一百四十 五条 第一款 之 规定 ， 裁定 如下 ： 

王某与宋某离婚纠纷一审民事裁定书.txt	根据 《 中华人民共和国 民事 诉讼法 》 第 一百四十 五条 第一款 的 规定 ， 裁定 如下 ： 

王某与张某离婚纠纷一审民事裁定书.txt	依照 《 中华人民共和国 民事 诉讼法 》 第 一百四十 五条 的 规定 ， 裁定 如下 ： 

王某与王某某离婚纠纷一审民事裁定书.txt	依照 《 中华人民共和国 民事 诉讼法 》 第 一百四十 五条 第一款 之 规定 ， 裁定 如下 ： 

王某与石某某离婚纠纷一审民事裁定书.txt	依照 《 中华人民共和国 民事 诉讼法 》 第 一百四十 五条 第一款 之 规定 ， 裁定 如下 ： 

王某与郑某离婚纠纷一审民事裁定书.txt	依照 《 中华人民共和国 民事 诉讼法 》 第 一百四十 五条 、 第一百五十四条 之 规定 ， 裁定 如下 ： 

王某某与代某某离婚纠纷一审民事裁定书.txt	据此 ， 依照 《 中华人民共和国 民事 诉讼法 》 第 一百四十 五条 第一款 之 规定 ， 裁定 如下 ： 

王某某与何某某离婚纠纷一审民事裁定书.txt	依照 《 中华人民共和国 民事 诉讼法 》 第 一百四十 五条 第一款 的 规定 ， 裁定 如下 ： 

王某某与冷某某离婚纠纷一审民事裁定书.txt	依照 《 中华人民共和国 民事 诉讼法 》 第十三条 第二款 、 第 一百四十 五条 第一款 之 规定 ， 裁定 如下 ： 

王某某与刘某某离婚纠纷一审民事判决书.txt	依照 《 中华人民共和国 民事 诉讼法 》 第 一百四十 三条 的 规定 ， 裁定 如下 ： 

王某某与古某某离婚纠纷一审民事裁定书.txt	根据 《 中华人民共和国 民事 诉讼法 》 第一百 四十五 第一款 的 规定 ， 裁定 如下 ： 

王某某与叶某某离婚纠纷一审民事裁定书.txt	依照 《 中华人民共和国 民事 诉讼法 》 第 一百四十 五条 第一款 之 规定 ， 裁定 如下 ： 

王某某与唐某某离婚纠纷一审民事裁定书.txt	依照 《 中华人民共和国 民事 诉讼法 》 第 一百四十 五条 第一款 之 规定 ， 裁定 如下 ： 

王某某与姚某某离婚纠纷一审民事裁定书.txt	依照 《 中华人民共和国 民事 诉讼法 》 第 一百四十 五条 第一款 之 规定 ， 裁定 如下 ： 

王某某与孙某某离婚纠纷民事裁定书.txt	依照 《 中华人民共和国 民事 诉讼法 》 第 一百四十 五条 之 规定 ， 裁定 如下 ： 

王某某与张某某离婚纠纷一审民事裁定书.txt	依据 《 中华人民共和国 民事 诉讼法 》 第 一百四十 五条 第一款 之 规定 ， 裁定 如下 ： 

王某某与强某某离婚纠纷一审民事裁定书.txt	依照 《 中华人民共和国 民事 诉讼法 》 第 一百四十 五条 第一款 的 规定 ， 裁定 如下 ： 

王某某与文某离婚纠纷一审民事裁定书.txt	依照 《 中华人民共和国 民事 诉讼法 》 第 一百四十 五条 第一款 " 宣判 前 ， 原告 申请 撤诉 的 ， 是否 准许 ， 由 人民法院 裁定 " 之 规定 ， 裁定 如下 ： 

王某某与普某某离婚纠纷一审民事裁定书.txt	依照 《 中华人民共和国 民事 诉讼法 》 第 一百四十 五条 第一款 之 规定 ， 裁定 如下 ： 

王某某与景某某离婚纠纷一审民事裁定书.txt	依照 《 中华人民共和国 民事 诉讼法 》 第 一百四十 三条 的 规定 ， 裁定 如下 ： 

王某某与朱某某离婚纠纷一审民事判决书.txt	根据 《 中华人民共和国 民事 诉讼法 》 第 一百四十 五条 之 规定 ， 裁定 如下 ： 

王某某与朱某某离婚纠纷一审民事裁定书.txt	据此 ， 依照 《 中华人民共和国 民事 诉讼法 》 第 一百四十 五条 第一款 之 规定 ， 裁定 如下 ： 

王某某与李某某离婚纠纷一审民事裁定书.txt	依照 《 中华人民共和国 民事 诉讼法 》 第 一百四十 五条 的 规定 ， 裁定 如下 ： 

王某某与李某离婚后财产纠纷一审民事裁定书.txt	依照 《 中华人民共和国 民事 诉讼法 》 第 一百四十 三条 的 规定 ， 裁定 如下 ： 

王某某与汪某某离婚纠纷一审民事裁定书.txt	依照 《 中华人民共和国 民事 诉讼法 》 第 一百四十 五条 的 规定 ， 裁定 如下 ： 

王某某与洪某某离婚纠纷民事一审裁定书.txt	依照 《 中华人民共和国 民事 诉讼法 》 第 一百四十 五条 的 规定 ， 裁定 如下 ： 

王某某与蔡某某离婚纠纷一审民事裁定书.txt	依照 《 中华人民共和国 民事 诉讼法 》 第 一百四十 五条 第一款 的 规定 ， 裁定 如下 ： 

王某某与被告汪某某离婚纠纷一审民事裁定书.txt	依照 《 中华人民共和国 民事 诉讼法 》 第 一百四十 五条 的 规定 ， 裁定 如下 ： 

王某某与邵某某离婚纠纷案一审民事裁定书.txt	依照 《 中华人民共和国 民事 诉讼法 》 第 一百四十 三条 、 第一百五十四条 之 规定 ， 裁定 如下 ： 

王某某与郑某某离婚纠纷一审民事裁定书.txt	依照 《 中华人民共和国 民事 诉讼法 》 第十三条 第二款 、 第 一百四十 五条 第一款 的 规定 ， 裁定 如下 ： 

王某某与陈某某离婚一审民事裁定书.txt	依照 《 中华人民共和国 民事 诉讼法 》 第 一百四十 五条 之 规定 ， 裁定 如下 ： 

王某某与陈某离婚纠纷一审民事裁定书.txt	依照 《 中华人民共和国 民事 诉讼法 》 第 一百四十 五条 第一款 宣判 前 ， 原告 申请 撤诉 的 ， 是否 准许 ， 由 人民法院 裁定 、 第一百五十四条 第一款 裁定 适用 于 下列 范围 ： hellip ; hellip ; （ 五 ） 准许 或者 不 准许 撤诉 的 规定 ， 裁定 如下 ： 

王某某与雷某某离婚纠纷一审民事裁定书.txt	依照 《 中华人民共和国 民事 诉讼法 》 第 一百四十 五条 第一款 " 宣判 前 ， 原告 申请 撤诉 的 ， 是否 准许 ， 由 人民法院 裁定 。 " 的 规定 ， 裁定 如下 ： 

王某某与马某某离婚纠纷一审民事裁定书.txt	依照 《 中华人民共和国 民事 诉讼法 》 第 一百四十 五条 第一款 " 宣判 前 ， 原告 申请 撤诉 的 ， 是否 准许 ， 由 人民法院 裁定 。 " 的 规定 ， 裁定 如下 ： 

王某某与高某某离婚纠纷案一审民事判决书.txt	依照 《 中华人民共和国 民法 婚姻法 》 第三十二条 、 第三十七条 、 第三十九条 的 规定 ， 判决 如下 ： 

王某某与魏某某离婚纠纷一审民事裁定书.txt	根据 《 中华人民共和国 民事 诉讼法 》 第 一百四十 五条 第一款 之 规定 ， 裁定 如下 ： 

王某某与鲜某某离婚纠纷案一审民事裁定书.txt	依照 《 中华人民共和国 民事 诉讼法 》 第 一百四十 五条 、 一百五十 四条 第一款 第五项 的 规定 ， 裁定 如下 ： 

王某某与黄某某离婚纠纷一审民事裁定书.txt	根据 《 中华人民共和国 民事 诉讼法 》 第 一百四十 五条 之 规定 ， 裁定 如下 ： 

王某某与黄某离婚纠纷一案民事裁定书.txt	依照 《 中华人民共和国 民事 诉讼法 》 第 一百四十 五条 第一款 之 规定 ， 裁定 如下 ： 

王某某诉严某某离婚纠纷一审民事裁定书.txt	依照 《 中华人民共和国 民事 诉讼法 》 第 一百四十 三条 的 规定 ， 裁定 如下 ： 

王某某诉伍某某离婚纠纷一审民事裁定书.txt	依照 《 中华人民共和国 民事 诉讼法 》 第十三条 第二款 " 当事人 有权 在 法律 规定 的 范围 内 处分 自己 的 民事权利 和 诉讼 权利 " 、 第 一百四十 五条 第一款 " 宣判 前 ， 原告 申请 撤诉 的 ， 是否 准许 ， 由 人民法院 裁定 " 的 规定 ， 裁定 如下 ： 

王某某诉勾某某离婚纠纷一审民事裁定书.txt	依照 《 中华人民共和国 民事 诉讼法 》 第 一百四十 五条 的 规定 ， 裁定 如下 ： 

王某某诉曹某某离婚纠纷一审民事裁定书.txt	依照 《 中华人民共和国 民事 诉讼法 》 第 一百四十 五条 第一款 的 规定 ， 裁定 如下 ： 

王某某诉朱某某离婚纠纷一案一审民事裁定书.txt	依照 《 中华人民共和国 民事 诉讼法 》 第 一百四十 五条 的 规定 ， 裁定 如下 ： 

王某某诉肖某某离婚纠纷诉前保全民事裁定书.txt	依照 《 中华人民共和国 民事 诉讼法 》 第一百 零 一条 、 第 一百零二 条 、 第 一百零三 条 、 第 一百零八 条 和 第一百五十四条 第一款 第四项 、 最高人民法院 关于 适用 《 中华人民共和国 民事 诉讼法 》 第一百五十 六条 、 第一百六十四条 、 第 四百八十 七条 的 规定 ， 裁定 如下 ： 

王某某诉肖某某离婚纠纷诉前财产保全民事裁定书.txt	依照 《 中华人民共和国 民事 诉讼法 》 第一百 零 一条 、 第 一百零二 条 、 第 一百零三 条 、 第 一百零八 条 和 第一百五十四条 第一款 第四项 、 最高人民法院 关于 适用 《 中华人民共和国 民事 诉讼法 》 第一百五十 六条 、 第一百六十四条 、 第 四百八十 七条 的 规定 ， 裁定 如下 ： 

王某某诉被告刘某某离婚纠纷案（2016）川1028民初1441号民一审民事裁定书.txt	依照 《 中华人民共和国 民事 诉讼法 》 第 一百四十 五条 、 第一百五十 四 规定 ， 裁定 如下 ： 

王某某诉被告吕某某离婚纠纷一审民事裁定书.txt	依照 《 中华人民共和国 民事 诉讼法 》 第 一百四十 五条 第一款 的 规定 ， 裁定 如下 ： 

王某某诉贾某某离婚纠纷一审民事裁定书.txt	依照 《 中华人民共和国 民事 诉讼法 》 第 一百四十 五条 第一款 之 规定 ， 裁定 如下 ： 

王某某诉龙某某离婚纠纷一审民事裁定书.txt	依照 《 中华人民共和国 民事 诉讼法 》 第一百 四十五 第一款 之 规定 ， 裁定 如下 ： 

王某诉宋某某离婚纠纷一案一审民事裁定书.txt	据此 ， 依照 《 中华人民共和国 民事 诉讼法 》 第 一百四十 五条 第一款 之 规定 ， 裁定 如下 ： 

王某诉朱某离婚纠纷一审民事裁定书.txt	依照 《 中华人民共和国 民事 诉讼法 》 第 一百四十 五条 第一款 之 规定 ， 裁定 如下 ： 

王某诉龙某离婚纠纷民事裁定书.txt	依照 《 中华人民共和国 民事 诉讼法 》 第一百 四十五 第一款 之 规定 ， 裁定 如下 ： 

王甲与王乙离婚纠纷一审民事裁定书.txt	据此 ， 依照 《 中华人民共和国 民事 诉讼法 》 第 一百四十 五条 第一款 " 宣判 前 ， 原告 申请 撤诉 的 ， 是否 准许 ， 由 人民法院 裁定 " 之 规定 ， 裁定 如下 ： 

王继菊与鲍和兵离婚纠纷一审民事裁定书.txt	依照 《 中华人民共和国 民事 诉讼法 》 第 一百四十 五条 第一款 之 规定 ， 裁定 如下 ： 

甘某某与马某某离婚纠纷一审民事裁定书.txt	依照 《 中华人民共和国 民事 诉讼法 》 第 一百四十 五条 的 规定 ， 裁定 如下 ： 

甘某某诉何某某离婚纠纷案(2016)川1028民初1189号一审民事裁定书.txt	依照 《 中华人民共和国 民事 诉讼法 》 第 一百四十 五条 的 规定 ， 裁定 如下 ： 

田军与郑某波离婚纠纷一审民事裁定书.txt	依照 《 中华人民共和国 民事 诉讼法 》 第十三条 第二款 、 第 一百四十 五条 第一款 的 规定 ， 裁定 如下 ： 

田某某诉吴某某离婚纠纷一审民事裁定书.txt	依照 《 中华人民共和国 民事 诉讼法 》 第 一百四十 五条 第一款 之 规定 ， 裁定 如下 ： 

申某与范某离婚纠纷一审民事裁定书.txt	根据 《 中华人民共和国 民事 诉讼法 》 第 一百四十 五条 之 规定 ， 裁定 如下 ： 

申某某与丰某某离婚纠纷一审民事裁定书.txt	根据 《 中华人民共和国 民事 诉讼法 》 第 一百四十 五条 第一款 之 规定 ， 裁定 如下 ： 

申某某与周某某离婚纠纷一审民事判决书.txt	依照 《 中华人民共和国 民事 诉讼法 》 第 一百四十 五条 之 规定 ， 裁定 如下 ： 

申某某诉祖某某离婚纠纷一审民事裁定书.txt	依照 《 中华人民共和国 民事 诉讼法 》 第 一百四十 五条 第一款 之 规定 ， 裁定 如下 ： 

白某与何某离婚纠纷一审民事裁定书.txt	根据 《 中华人民共和国 民事 诉讼法 》 第 一百四十 五条 之 规定 ， 裁定 如下 ： 

白某与蒋某离婚纠纷一审民事裁定书.txt	依照 《 中华人民共和国 民事 诉讼法 》 第 一百四十 五条 第一款 之 规定 ， 裁定 如下 ： 

白某与谢某某离婚纠纷一案一审民事裁定书.txt	依照 《 中华人民共和国 民事 诉讼法 》 第 一百四十 三条 " 原告 经 传票 传唤 ， 无 正当理由 拒 不 到庭 的 ， 或者 未经 法庭 许可 中途 退庭 的 ， 可以 按 撤诉 处理 ； 被告 反诉 的 ， 可以 缺席判决 " 之 规定 ， 裁定 如下 ： 

白某某与向某某离婚纠纷一审民事裁定书.txt	据此 ， 依照 《 中华人民共和国 民事 诉讼法 》 第 一百四十 五条 第一款 " 宣判 前 ， 原告 申请 撤诉 的 ， 是否 准许 ， 由 人民法院 裁定 。 " 之 规定 ， 裁定 如下 ： 

白某某与杨某某离婚纠纷一审民事裁定书.txt	据此 ， 依照 《 中华人民共和国 民事 诉讼法 》 第 一百四十 五条 第一款 之 规定 ， 裁定 如下 ： 

石某林与腾某花离婚纠纷一审民事裁定书.txt	依照 《 中华人民共和国 民事 诉讼法 》 第 一百四十 五条 的 规定 ， 裁定 如下 ： 

石某某与余某某离婚纠纷一审民事裁定书.txt	依照 《 中华人民共和国 民事 诉讼法 》 第 一百四十 五条 第一款 之 规定 ， 裁定 如下 ： 

石某某与韩某某离婚纠纷一审民事裁定书.txt	依照 《 中华人民共和国 民事 诉讼法 》 第 一百四十 五条 之 规定 ， 裁定 如下 ： 

磋某与周某某离婚纠纷一审民事裁定书.txt	依照 《 中华人民共和国 民事 诉讼法 》 第 一百四十 五条 第一款 之 规定 ， 裁定 如下 ： 

祖某某与李某某离婚纠纷一审民事裁定书.txt	依照 《 中华人民共和国 民事 诉讼法 》 第 一百四十 五条 之 规定 ， 裁定 如下 ： 

祝某某诉匡某某离婚纠纷一审民事裁定书.txt	依照 《 中华人民共和国 民事 诉讼法 》 第 一百四十 五条 第一款 的 规定 ， 裁定 如下 ： 

秦某与田某离婚纠纷一审民事裁定书.txt	据此 ， 依照 《 中华人民共和国 民事 诉讼法 》 第 一百四十 五条 第一款 之 规定 ， 裁定 如下 ： 

秦某某与程某某离婚纠纷案二审民事裁定书.txt	根据 《 中华人民共和国 民事 诉讼法 》 第十三条 第二款 、 第一百七 十三条 之 规定 ， 裁定 如下 ： 

程某与陈某离婚纠纷一审民事裁定书.txt	根据 《 中华人民共和国 民事 诉讼法 》 第 一百四十 五条 之 规定 ， 裁定 如下 ： 

穆某某与陈某某离婚纠纷一审民事裁定书.txt	根据 《 中华人民共和国 民事 诉讼法 》 第 一百四十 五条 之 规定 ， 裁定 如下 ： 

童某某诉王某某离婚纠纷一审民事裁定书.txt	依照 《 中华人民共和国 民事 诉讼法 》 第 一百四十 五条 第一款 的 规定 ， 裁定 如下 ： 

米某某诉冯某某离婚纠纷民事判决书.txt	依照 《 中华人民共和国 民事 诉讼法 》 第 一百四十 五条 之 规定 ， 裁定 如下 ： 

粟某与陈某离婚纠纷一审民事裁定书.txt	依照 《 中华人民共和国 民事 诉讼法 》 第 一百四十 五条 第一款 之 规定 ， 裁定 如下 ： 

绵阳市涪城区喜来婚礼策划中心与绵阳市翼丰餐饮管理有限责任公司服务合同纠纷一审民事裁定书.txt	依照 《 中华人民共和国 民事 诉讼法 》 第 一百四十 五条 第一款 的 规定 ， 裁定 如下 ： 

缪某某与宋某某离婚纠纷一审民事裁定书.txt	依照 《 中华人民共和国 民事 诉讼法 》 第 一百四十 五条 第一款 之 规定 ， 裁定 如下 ： 

缪某某诉胡安庆离婚纠纷一审民事裁定书.txt	依照 《 中华人民共和国 民事 诉讼法 》 第 一百四十 五条 第一款 宣判 前 ， 原告 申请 撤诉 的 ， 是否 准许 ， 由 人民法院 裁定 。 的 规定 ， 裁定 如下 ： 

缪某甲与李某某离婚纠纷一审民事裁定书.txt	依照 《 中华人民共和国 民事 诉讼法 》 第十三条 第二款 、 第 一百四十 五条 第一款 规定 ， 裁定 如下 ： 

罗大江与王春燕离婚纠纷二审民事裁定书.txt	依照 《 中华人民共和国 民事 诉讼法 》 第一百七 十三条 的 规定 ， 裁定 如下 ： 

罗某与唐某离婚纠纷案一审民事裁定书.txt	依照 《 中华人民共和国 民事 诉讼法 》 第 一百四十 五条 第一款 之 规定 ， 裁定 如下 ： 

罗某与马某离婚纠纷一审民事裁定书.txt	根据 《 中华人民共和国 民事 诉讼法 》 第 一百四十 五条 之 规定 ， 裁定 如下 ： 

罗某某与任某某离婚纠纷一审民事裁定书.txt	根据 《 中华人民共和国 民事 诉讼法 》 第 一百四十 五条 一款 之 规定 ， 裁定 如下 ： 

罗某某与王某离婚纠纷一审民事裁定书.txt	依照 《 中华人民共和国 民事 诉讼法 》 第 一百四十 五条 第一款 " 宣判 前 ， 原告 申请 撤诉 的 ， 是否 准许 ， 由 人民法院 裁定 。 " 、 第一百五十四条 第一款 第五项 " 裁定 适用 于 下列 范围 ： （ 五 ） 准许 或者 不 准许 撤诉 。 " 之 规定 ， 裁定 如下 ： 

罗某某与章某某离婚纠纷一审民事裁定书.txt	依照 《 中华人民共和国 民事 诉讼法 》 第 一百四十 五条 的 规定 ， 裁定 如下 ： 

罗某某与胡某某离婚纠纷一审民事裁定书.txt	依照 《 中华人民共和国 民事 诉讼法 》 第 一百四十 五条 的 规定 ， 裁定 如下 ： 

罗某某与蒋某离婚纠纷案一审民事裁定书.txt	依照 《 中华人民共和国 民事 诉讼法 》 第 一百四十 三条 、 第一百五十四条 之 规定 ， 裁定 如下 ： 

罗某某与钟某某离婚纠纷一审民事裁定书.txt	依照 《 中华人民共和国 民事 诉讼法 》 第 一百四十 三条 之 规定 ， 裁定 如下 ： 

罗某某与陈某某离婚纠纷一审民事裁定书.txt	依照 《 中华人民共和国 民事 诉讼法 》 第 一百四十 五条 之 规定 ， 裁定 如下 ： 

罗某某诉王某某离婚纠纷一审民事裁定书.txt	依照 《 中华人民共和国 民事 诉讼法 》 第 一百四十 五条 的 规定 ， 裁定 如下 ： 

罗某某诉赵某某离婚纠纷一审民事裁定书.txt	依照 《 中华人民共和国 民事 诉讼法 》 第 一百四十 五条 之 规定 ， 裁定 如下 ： 

罗某某诉黄某某离婚纠纷一审民事裁定书.txt	依照 《 中华人民共和国 民事 诉讼法 》 第十三条 第二款 " 当事人 有权 在 法律 规定 的 范围 内 处分 自己 的 民事权利 和 诉讼 权利 。 " 、 第 一百四十 五条 第一款 " 宣判 前 ， 原告 申请 撤诉 的 ， 是否 准许 ， 由 人民法院 裁定 。 " 及 第一百五十四条 第一款 " 裁定 适用 于 下列 范围 ： （ 五 ） 准许 或者 不 准许 撤诉 ； " 的 规定 ， 裁定 如下 ： 

罗某某诉黄某某离婚纠纷一案一审民事裁定书.txt	据此 ， 依照 《 中华 人们 共和国 民事 诉讼法 》 第 一百四十 五条 第一款 " 宣判 前 ， 原告 申请 撤诉 的 ， 是否 准许 ， 由 人民法院 裁定 。 " 之 规定 ， 裁定 如下 ： 

罗某清与邓某贞离婚纠纷一审民事裁定书.txt	依照 《 中华人民共和国 民事 诉讼法 》 第十三条 第二款 、 第 一百四十 五条 第一款 的 规定 ， 裁定 如下 ： 

羊某与徐某某离婚纠纷案一审民事裁定书.txt	依照 《 中华人民共和国 民事 诉讼法 》 第 一百四十 五条 之 规定 ， 裁定 如下 ： 

翁某某与李某某离婚纠纷案一审民事裁定书.txt	依照 《 中华人民共和国 民事 诉讼法 》 第 一百四十 五条 、 一百五十 四条 第一款 第五项 的 规定 ， 裁定 如下 ： 

聂某某与江某某离婚纠纷一案一审民事裁定书.txt	据此 ， 依照 国务院 《 诉讼费用 交纳 办法 》 第二十二条 第四款 、 最高人民法院 《 关于 适用 ﹤ 中华人民共和国 民事 诉讼法 ﹥ 若干 问题 的 意见 》 第 143 条 之 规定 ， 裁定 如下 ： 

肖某与袁某某离婚纠纷一审民事裁定书.txt	依照 《 中华人民共和国 民事 诉讼法 》 第 一百四十 五条 第一款 的 规定 ， 裁定 如下 ： 

肖某与陈某离婚纠纷案一审民事裁定书.txt	依照 《 中华人民共和国 民事 诉讼法 》 第 一百四十 五条 第一款 的 规定 ， 裁定 如下 ： 

肖某某与李某某离婚纠纷一审民事裁定书.txt	依照 《 中华人民共和国 民事 诉讼法 》 第 一百四十 三条 " 原告 经 传票 传唤 ， 无 正当理由 拒 不 到庭 的 ， 或者 未经 法庭 许可 中途 退庭 的 ， 可以 按 撤诉 处理 " 之 规定 ， 裁定 如下 ： 

肖某某与高某某离婚纠纷一审民事裁定书.txt	据此 ， 依照 《 中华人民共和国 民事 诉讼法 》 第 一百四十 五条 第一款 之 规定 ， 裁定 如下 ： 

胡某与姚某离婚纠纷一审民事裁定书.txt	依照 《 中华人民共和国 民事 诉讼法 》 第 一百四十 三条 之 规定 ， 裁定 如下 ： 

胡某与张某离婚纠纷一审民事裁定书.txt	依照 《 中华人民共和国 民事 诉讼法 》 第 一百四十 五条 第一款 的 规定 ， 裁定 如下 ： 

胡某与谷某某离婚纠纷一审民事裁定书.txt	依照 《 中华人民共和国 民事 诉讼法 》 第 一百四十 五条 （ 一 ） 项 的 规定 ， 裁定 如下 ： 

胡某某与姜某某离婚纠纷一审民事裁定书.txt	依照 《 中华人民共和国 民事 诉讼法 》 第 一百四十 五条 第一款 之 规定 ， 裁定 如下 ： 

胡某某与杨某某离婚纠纷一审民事裁定书.txt	依照 《 中华人民共和国 民事 诉讼法 》 第 一百四十 五条 第一款 之 规定 ， 裁定 如下 ： 

胡某某与游某某离婚纠纷一审民事裁定书.txt	依照 《 中华人民共和国 民事 诉讼法 》 第 一百四十 五条 第一款 " 宣判 前 ， 原告 申请 撤诉 的 ， 是否 准许 ， 由 人民法院 裁定 。 " 、 第一百五十四条 第一款 第五项 " 裁定 适用 于 下列 范围 ： （ 五 ） 准许 或者 不 准许 撤诉 。 " 之 规定 ， 裁定 如下 ： 

胡某某与祖某某离婚纠纷一审民事裁定书.txt	根据 《 中华人民共和国 民事 诉讼法 》 第 一百四十 五条 第一款 之 规定 ， 裁定 如下 ： 

胡某某与罗某某离婚纠纷一审民事裁定书.txt	依照 《 中华人民共和国 民事 诉讼法 》 第 一百四十 五条 的 规定 ， 裁定 如下 ： 

胡某某与蔡某离婚纠纷一案一审民事裁定书.txt	依照 《 中华人民共和国 民事 诉讼法 》 第一百 四十五 的 规定 ， 裁定 如下 ： 

胡某某与郭某某离婚纠纷一审民事裁定书.txt	根据 《 中华人民共和国 民事 诉讼法 》 第 一百四十 五条 之 规定 ， 裁定 如下 ： 

胡某某与马某某离婚纠纷一审民事裁定书.txt	依照 《 中华人民共和国 民事 诉讼法 》 第 一百四十 五条 第一款 的 规定 ， 裁定 如下 ： 

胡某某诉李某某离婚纠纷一审民事裁定书.txt	依照 《 中华人民共和国 民事 诉讼法 》 第六十二 条 、 第 一百四十 三条 、 第一百五十四条 第一款 （ 十一 ） 项之 规定 ， 裁定 如下 ： 

胡某某诉杜某某离婚纠纷一审民事裁定书.txt	根据 《 中华人民共和国 民事 诉讼法 》 第 一百四十 五条 之 规定 ， 裁定 如下 ： 

胡某某诉龚某某离婚纠纷案一审民事裁定书.txt	依照 《 中华人民共和国 民事 诉讼法 》 第 一百四十 五条 、 一百五十 四条 第一款 第五项 的 规定 ， 裁定 如下 ： 

胥某某与白某某离婚纠纷一案一审民事裁定书.txt	据此 ， 依照 国务院 《 诉讼费用 交纳 办法 》 第二十二条 第四款 、 最高人民法院 《 关于 适用 ﹤ 中华人民共和国 民事 诉讼法 ﹥ 若干 问题 的 意见 》 第 143 条 之 规定 ， 裁定 如下 ： 

舒某某与唐某某离婚纠纷一审民事裁定书.txt	依照 《 中华人民共和国 民事 诉讼法 》 第十三条 第二款 、 第 一百四十 五条 第一款 之 规定 ， 裁定 如下 ： 

舒某某诉张某某离婚纠纷民事一审民事裁定书.txt	依照 《 中华人民共和国 民事 诉讼法 》 第 一百四十 五条 、 第一百五十四条 的 相关 规定 ， 裁定 如下 ： 

苏某某与池某某离婚纠纷一审民事裁定书.txt	据此 ， 依照 《 中华人民共和国 民事 诉讼法 》 第 一百四十 五条 第一款 之 规定 ， 裁定 如下 ： 

苏某某与罗某某离婚纠纷一审民事裁定书.txt	依照 《 中华人民共和国 民事 诉讼法 》 第 一百四十 五条 的 规定 ， 裁定 如下 ： 

苗某某与叶某某离婚纠纷一审民事裁定书.txt	依照 《 中华人民共和国 民事 诉讼法 》 第 一百四十 五条 之 规定 ， 裁定 如下 ： 

苟某某与杨某某离婚纠纷一审民事裁定书.txt	根据 《 中华人民共和国 民事 诉讼法 》 第 一百四十 五条 之 规定 ， 裁定 如下 ： 

范某某与刘某某离婚纠纷案一审民事裁定书.txt	依照 《 中华人民共和国 民事 诉讼法 》 第 一百四十 五条 第一款 的 规定 ， 裁定 如下 ： 

范某某与牟某某离婚纠纷一审民事裁定书.txt	依照 《 中华人民共和国 民事 诉讼法 》 第 一百四十 五条 第一款 之 规定 ， 裁定 如下 ： 

范某某与赵某某离婚纠纷一审民事裁定书.txt	依照 《 中华人民共和国 民事 诉讼法 》 第 一百四十 五条 " 宣判 前 ， 原告 申请 撤诉 的 ， 是否 准许 ， 由 人民法院 裁定 。 " 之 规定 ， 裁定 如下 ： 

范某某与龚某某离婚纠纷一审民事裁定书.txt	依照 《 中华人民共和国 民事 诉讼法 》 第 一百四十 五条 第一款 的 规定 ， 裁定 如下 ： 

范某某诉梁某某离婚纠纷一审民事裁定书.txt	根据 《 中华人民共和国 民事 诉讼法 》 第 一百四十 五条 之 规定 ， 裁定 如下 ： 

范洪友与王燕离婚纠纷一案民事裁定书.txt	依照 《 中华人民共和国 民事 诉讼法 》 第 一百四十 五条 之 规定 ， 裁定 如下 ： 

莫某某与向某某离婚纠纷一审民事裁定书.txt	据此 ， 依照 《 中华人民共和国 民事 诉讼法 》 第 一百四十 五条 第一款 " 宣判 前 ， 原告 申请 撤诉 的 ， 是否 准许 ， 由 人民法院 裁定 " 之 规定 ， 裁定 如下 ： 

董某某与邓某某婚姻无效纠纷一审民事裁定书.txt	依照 《 中华人民共和国 民事 诉讼法 》 第十三条 第二款 " 当事人 有权 在 法律 规定 的 范围 内 处分 自己 的 民事权利 和 诉讼 权利 " 、 第 一百四十 五条 第一款 " 宣判 前 ， 原告 申请 撤诉 的 ， 是否 准许 ， 由 人民法院 裁定 " 和 《 诉讼费 交纳 办法 》 第十五条 " 以 调解 方式 结案 或者 当事人 申请 撤诉 的 ， 减半 交纳 案件 受理费 " 之 规定 裁定 如下 ： 

董某某与陈某某离婚纠纷一审民事裁定书.txt	依据 《 中华人民共和国 民事 诉讼法 》 第十三条 第二款 、 第 一百四十 五条 第一款 、 一百五十 四条 第一款 第五项 、 第三款 之 规定 ， 裁定 如下 ： 

董某某与陈某某离婚纠纷一案一审民事裁定书.txt	依照 《 中华人民共和国 民事 诉讼法 》 第 一百四十 三条 之 规定 ， 裁定 如下 ： 

蒋某与张某离婚纠纷一审民事裁定书.txt	依照 《 中华人民共和国 民事 诉讼法 》 第 一百四十 五条 之 规定 ， 裁定 如下 ： 

蒋某与李某离婚纠纷一审民事裁定书.txt	依照 《 中华人民共和国 民事 诉讼法 》 第十三条 第二款 " 当事人 有权 在 法律 规定 的 范围 内 处分 自己 的 民事权利 和 诉讼 权利 " 、 第 一百四十 五条 第一款 " 宣判 前 ， 原告 申请 撤诉 的 ， 是否 准许 ， 由 人民法院 裁定 " 的 规定 ， 裁定 如下 ： 

蒋某与黄某离婚纠纷一审民事裁定书.txt	依照 《 中华人民共和国 民事 诉讼法 》 第 一百四十 五条 的 规定 ， 裁定 如下 ： 

蒋某林与李某华离婚纠纷一审民事裁定书.txt	依照 《 中华人民共和国 民事 诉讼法 》 第十三条 、 第 一百四十 五条 第一款 之 规定 ， 裁定 如下 ： 

蒋某某与周某某离婚纠纷一审民事裁定书.txt	依照 《 中华人民共和国 民事 诉讼法 》 第 一百四十 五条 第一款 " 宣判 前 ， 原告 申请 撤诉 的 ， 是否 准许 ， 由 人民法院 裁定 。 " 、 第一百五十四条 第一款 第五项 " 裁定 适用 于 下列 范围 ： （ 五 ） 准许 或者 不 准许 撤诉 。 " 之 规定 ， 裁定 如下 ： 

蒋某某与梁某某离婚纠纷一审民事裁定书.txt	依据 《 中华人民共和国 民事 诉讼法 》 第 一百四十 五条 的 规定 ， 裁定 如下 ： 

蒋某某与贺某离婚纠纷一审民事裁定书.txt	依照 《 中华人民共和国 民事 诉讼法 》 第十三条 、 第 一百四十 五条 之 规定 ， 裁定 如下 ： 

蒋某某诉江某某离婚纠纷一审民事裁定书.txt	根据 《 中华人民共和国 民事 诉讼法 》 第 一百四十 五条 之 规定 ， 裁定 如下 ： 

蒋某某诉邓某某离婚纠纷民事裁定书.txt	依照 《 中华人民共和国 民事 诉讼法 》 第 一百四十 五条 第一款 之 规定 ， 裁定 如下 ： 

蒋某甲与蒋某乙、蒋某丙婚姻家庭纠纷申请再审民事裁定书.txt	依照 《 中华人民共和国 民事 诉讼法 》 第二百 零 四条 第一款 的 规定 ， 裁定 如下 ： 

蒲某某诉杨某某离婚纠纷一案一审民事裁定书.txt	依照 《 中华人民共和国 民事 诉讼法 》 第 一百四十 五条 第一款 的 规定 ， 裁定 如下 ： 

蓝某某诉李某某离婚纠纷一审民事裁定书.txt	依照 《 中华人民共和国 民事 诉讼法 》 第 一百四十 五条 、 第一百五十四条 的 相关 规定 ， 裁定 如下 ： 

蔡某与李某离婚纠纷一审民事裁定书.txt	据此 ， 依照 《 中华人民共和国 民事 诉讼法 》 第 一百四十 五条 第一款 之 规定 ， 裁定 如下 ： 

蔡某某与黄某某离婚纠纷一审民事裁定书.txt	依照 《 中华人民共和国 民事 诉讼法 》 第 一百四十 五条 " 宣判 前 ， 原告 申请 撤诉 的 ， 是否 准许 ， 由 人民法院 裁定 。 " 之 规定 ， 裁定 如下 ： 

蔺某某与李某某离婚纠纷一审民事裁定书.txt	依照 《 中华人民共和国 民事 诉讼法 》 第 一百四十 五条 第一款 之 规定 ， 裁定 如下 ： 

薛某与李某离婚纠纷一审民事裁定书.txt	根据 《 中华人民共和国 民事 诉讼法 》 第 一百四十 五条 之 规定 ， 裁定 如下 ： 

袁某与刘某离婚纠纷一审民事判决书.txt	依照 《 中华人民共和国 婚姻法 》 第三十二条 之 规定 ， 判决 如下 ： 

袁某某与代某某离婚纠纷一审民事裁定书.txt	依照 《 中华人民共和国 民事 诉讼法 》 第 一百四十 五条 的 规定 ， 裁定 如下 ： 

袁某某与杨某某离婚纠纷一审民事裁定书.txt	依照 《 中华人民共和国 民事 诉讼法 》 第 一百四十 五条 的 规定 ， 裁定 如下 ： 

袁某某与杨某离婚纠纷一审民事裁定书.txt	根据 《 中华人民共和国 民事 诉讼法 》 第 一百四十 五条 之 规定 ， 裁定 如下 ： 

袁某某与梅某某离婚纠纷一审民事裁定书.txt	依照 《 中华人民共和国 民事 诉讼法 》 第 一百四十 五条 第一款 宣判 前 ， 原告 申请 撤诉 的 ， 是否 准许 ， 由 人民法院 裁定 、 第一百五十四条 第一款 裁定 适用 于 下列 范围 ： hellip ; hellip ; （ 五 ） 准许 或者 不 准许 撤诉 的 规定 ， 裁定 如下 ： 

袁某某与韦某甲离婚纠纷一审民事裁定书.txt	依照 《 中华人民共和国 民事 诉讼法 》 第十三条 第二款 " 当事人 有权 在 法律 规定 的 范围 内 处分 自己 的 民事权利 和 诉讼 权利 " ， 第 一百四十 五条 第一款 " 宣判 前 ， 原告 申请 撤诉 的 ， 是否 准许 ， 由 人民法院 裁定 " 之 规定 ， 裁定 如下 ： 

袁梅诉被告邹银华离婚纠纷一审民事裁定书.txt	根据 《 中华人民共和国 民事 诉讼法 》 第 一百四十四 条 之 规定 ， 裁定 如下 ： 

詹某与蒋某某离婚纠纷一审民事裁定书.txt	依照 《 中华人民共和国 民事 诉讼法 》 第 一百四十 五条 第一款 之 规定 ， 裁定 如下 ： 

詹某某与陈某某离婚纠纷一审民事裁定书.txt	依照 《 中华人民共和国 民事 诉讼法 》 第 一百四十 五条 的 规定 ， 裁定 如下 ： 

许某某与任某某离婚纠纷一审民事裁定书.txt	根据 《 中华人民共和国 民事 诉讼法 》 第 一百四十 五条 之 规定 ， 裁定 如下 ： 

许某某诉陈某某离婚纠纷案一审民事裁定书.txt	依照 《 中华人民共和国 民事 诉讼法 》 第十三条 第二款 、 第 一百四十 五条 第一款 之 规定 ， 裁定 如下 ： 

谌某、杨某甲与杨某乙离婚后财产纠纷一审民事裁定书.txt	根据 《 中华人民共和国 民事 诉讼法 》 第 一百四十 五条 第一款 ： " 宣判 前 ， 原告 申请 撤诉 的 ， 是否 准许 ， 由 人民法院 裁定 。 " 之 规定 ， 裁定 如下 ： 

谌某诉杨某甲、第三人杨某乙离婚后财产纠纷一审民事裁定书.txt	根据 《 中华人民共和国 民事 诉讼法 》 第 一百四十 五条 第一款 ： " 宣判 前 ， 原告 申请 撤诉 的 ， 是否 准许 ， 由 人民法院 裁定 。 " 之 规定 ， 裁定 如下 ： 

谢某与封某离婚纠纷一审民事裁定书.txt	依照 《 中华人民共和国 民事 诉讼法 》 第 一百四十 五条 之 规定 ， 裁定 如下 ： 

谢某与李某离婚纠纷一审民事裁定书.txt	依照 《 中华人民共和国 民事 诉讼法 》 第 一百四十 五条 第一款 之 规定 ， 裁定 如下 ： 

谢某与梁某离婚纠纷一审民事裁定书.txt	根据 《 中华人民共和国 民事 诉讼法 》 第 一百四十 五条 之 规定 ， 裁定 如下 ： 

谢某与许某离婚纠纷一审民事裁定书.txt	依照 《 中华人民共和国 民事 诉讼法 》 第 一百四十 五条 第一款 " 宣判 前 ， 原告 申请 撤诉 的 ， 是否 准许 ， 由 人民法院 裁定 " 之 规定 ， 裁定 如下 ： 

谢某与陈某离婚纠纷一审民事裁定书.txt	根据 《 中华人民共和国 民事 诉讼法 》 第 一百四十 五条 之 规定 ， 裁定 如下 ： 

谢某某与刘某某离婚纠纷一审民事裁定书.txt	依照 《 中华人民共和国 民事 诉讼法 》 第十三条 第二款 " 当事人 有权 在 法律 规定 的 范围 内 处分 自己 的 民事权利 和 诉讼 权利 " 、 第 一百四十 五条 第一款 " 宣判 前 ， 原告 申请 撤诉 的 ， 是否 准许 ， 由 人民法院 裁定 " 和 《 诉讼费 交纳 办法 》 第十五条 " 以 调解 方式 结案 或者 当事人 申请 撤诉 的 ， 减半 交纳 案件 受理费 " 之 规定 ， 裁定 如下 ： 

谢某某与唐某离婚纠纷一审民事裁定书.txt	依照 《 中华人民共和国 民事 诉讼法 》 第 一百四十 五条 之 规定 ， 裁定 如下 ： 

谢某某与宋某某离婚纠纷一审民事裁定书.txt	依照 《 中华人民共和国 民事 诉讼法 》 第 一百四十 五条 第一款 的 规定 ， 裁定 如下 ： 

谢某某与康某某离婚纠纷一审民事裁定书.txt	根据 《 中华人民共和国 民事 诉讼法 》 第 一百四十 五条 第一款 宣判 前 ， 原告 申请 撤诉 的 ， 是否 准许 ， 由 人民法院 裁定 。 第一百五十四条 第一款 第五项 裁定 适用 于 下列 范围 ： hellip ; hellip ; 准许 或者 不 准许 撤诉 hellip ; hellip ; 的 规定 ， 裁定 如下 ： 

谢某某与张某某离婚纠纷一审民事裁定书.txt	依照 《 中华人民共和国 民事 诉讼法 》 第 一百四十 五条 " 宣判 前 ， 原告 申请 撤诉 的 ， 是否 准许 ， 由 人民法院 裁定 。 " 之 规定 ， 裁定 如下 ： 

谢某某与李某离婚纠纷一审民事裁定书.txt	依照 《 中华人民共和国 民事 诉讼法 》 第 一百四十 五条 第一款 的 规定 ， 裁定 如下 ： 

谢某某与赵某甲离婚纠纷一审民事裁定书.txt	依照 《 中华人民共和国 民事 诉讼法 》 第 一百四十 五条 之 规定 ， 裁定 如下 ： 

谢某某与辛某离婚纠纷一审民事裁定书.txt	据此 ， 依照 《 中华人民共和国 民事 诉讼法 》 第 一百四十 五条 第一款 之 规定 ， 裁定 如下 ： 

谢某某与邹某某离婚纠纷一审民事裁定书.txt	依照 《 中华人民共和国 民事 诉讼法 》 第 一百四十 五条 的 规定 ， 裁定 如下 ： 

谢某某与黄某某离婚纠纷一审民事裁定书.txt	依照 《 中华人民共和国 民事 诉讼法 》 第 一百四十 五条 第一款 宣判 前 ， 原告 申请 撤诉 的 ， 是否 准许 ， 由 人民法院 裁定 、 第一百五十四条 第一款 第 （ 五 ） 项 裁定 适用 于 下列 范围 ： （ 五 ） 准许 或者 不 准许 撤诉 之 规定 ， 裁定 如下 ： 

谢某某诉被告梁某某离婚纠纷一审民事裁定书.txt	依照 《 中华人民共和国 民事 诉讼法 》 第十三条 第二款 " 当事人 有权 在 法律 规定 的 范围 内 处分 自己 的 民事权利 和 诉讼 权利 " 、 第 一百四十 五条 第一款 " 宣判 前 ， 原告 申请 撤诉 的 ， 是否 准许 ， 由 人民法院 裁定 " 之 规定 ， 裁定 如下 ： 

谢某诉张某某离婚纠纷一审民事裁定书.txt	依照 《 中华人民共和国 民事 诉讼法 》 第 一百四十 三条 之 规定 ， 裁定 如下 ： 

谭某与郑某某离婚纠纷一审民事裁定书.txt	据此 ， 依照 《 中华人民共和国 民事 诉讼法 》 第 一百四十 五条 第一款 " 宣判 前 ， 原告 申请 撤诉 的 ， 是否 准许 ， 由 人民法院 裁定 " 之 规定 ， 裁定 如下 ： 

谭某某与金某某离婚纠纷一审民事裁定书.txt	据此 ， 依照 《 中华人民共和国 民事 诉讼法 》 第 一百四十 五条 第一款 " 宣判 前 ， 原告 申请 撤诉 的 ， 是否 准许 ， 由 人民法院 裁定 。 " 之 规定 ， 裁定 如下 ： 

谭某某诉被告李某某离婚纠纷一审民事裁定书.txt	依照 《 中华人民共和国 民事 诉讼法 》 第十三条 第二款 、 第 一百四十 五条 第一款 的 规定 ， 裁定 如下 ： 

谷某诉兰某离婚纠纷一审民事裁定书.txt	依照 《 中华人民共和国 民事 诉讼法 》 第 一百四十 五条 第一款 之 规定 ， 裁定 如下 ： 

贺某某与姚某某离婚纠纷一审民事裁定书.txt	依照 《 中华人民共和国 民事 诉讼法 》 第 一百四十 三条 之 规定 ， 裁定 如下 ： 

贾某与赵某离婚纠纷一审民事裁定书.txt	依照 《 中华人民共和国 民事 诉讼法 》 第 一百四十 五条 和 第一百五十四条 的 规定 ， 裁定 如下 ： 

贾某某与严某某离婚纠纷一案一审民事裁定书.txt	依照 《 中华人民共和国 民事 诉讼法 》 第 一百四十 五条 的 规定 ， 裁定 如下 ： 

贾某某诉陈某某离婚纠纷一案一审民事判决书.txt	依照 《 中华人民共和国 婚姻法 》 第三十二条 第二款 人民法院 审理 离婚 案件 ， 应当 进行 调解 ； 如 感情 确 已 破裂 ， 调解 无效 ， 应 准予 离婚 和 最高人民法院 《 关于 民事诉讼 证据 的 若干 规定 》 第二条 当事人 对 自己 提出 的 诉讼请求 所 依据 的 事实 或者 反驳 对方 诉讼请求 所 依据 的 事实 有 责任 提供 证据 加以 证明 。 没有 证据 或者 证据 不足以 证明 当事人 的 事实 主张 的 ， 由 负有 举证责任 的 当事人 承担 不利 后果 之 规定 ， 判决 如下 ： 

赖某某与张某某离婚纠纷一审民事裁定书.txt	依照 《 中华人民共和国 民事 诉讼法 》 第 一百四十 五条 第一款 ： 宣判 前 ， 原告 申请 撤诉 的 ， 是否 准许 ， 由 人民法院 裁定 、 第一百五十四条 第一款 第 （ 五 ） 项 ： 裁定 适用 于 下列 范围 ： hellip ; hellip ; （ 五 ） 准许 或者 不 准许 撤诉 ； hellip ; hellip ; 之 规定 ， 裁定 如下 ： 

赵某与张某某离婚纠纷一审民事裁定书.txt	依照 《 中华人民共和国 民事 诉讼法 》 第二十一条 和 《 最高人民法院 关于 适用 ﹤ 中华人民共和国 民事 诉讼法 ﹥ 的 解释 》 第三条 、 第四条 之 规定 ， 本案 现有 的 证据 证明 被告 的 住所地 为 江苏省 如东县 ， 且 原告 提供 的 证据 不足以 证明 被告 的 经常 居住地 为 四川省 绵阳市 涪城区 ， 故 本院 对 本案 无 管辖权 ， 被告 提出 的 管辖权 异议 成立 ， 本案 应 由 被告 住所地 人民法院 即 江苏省 如东县 人民法院 管辖 ， 依照 《 中华人民共和国 民事 诉讼法 》 第 一百二十七 条 第 之 规定 ， 裁定 如下 ： 

赵某与张某离婚纠纷一审民事裁定书.txt	依照 《 中华人民共和国 民事 诉讼法 》 第 一百四十 五条 之 规定 ， 裁定 如下 ： 

赵某与樊某离婚纠纷一审民事裁定书.txt	根据 《 中华人民共和国 民事 诉讼法 》 第 一百四十 五条 之 规定 ， 裁定 如下 ： 

赵某与邹某离婚纠纷一审民事裁定书.txt	根据 《 中华人民共和国 民事 诉讼法 》 第 一百四十 五条 之 规定 ， 裁定 如下 ： 

赵某某与刘某离婚纠纷一审民事裁定书.txt	依照 《 中华人民共和国 民事 诉讼法 》 第 一百四十 五条 之 规定 ， 裁定 如下 ： 

赵某某与向某离婚纠纷一审民事裁定书.txt	据此 ， 依照 《 中华人民共和国 民事 诉讼法 》 第 一百四十 五条 第一款 " 宣判 前 ， 原告 申请 撤诉 的 ， 是否 准许 ， 由 人民法院 裁定 。 " 之 规定 ， 裁定 如下 ： 

赵某某与周某某离婚纠纷一审民事裁定书.txt	依照 《 中华人民共和国 民事 诉讼法 》 第 一百四十 五条 第一款 之 规定 ， 裁定 如下 ： 

赵某某与张某离婚纠纷一审民事裁定书.txt	依照 《 中华人民共和国 民事 诉讼法 》 第 一百四十 五条 第一款 的 规定 ， 裁定 如下 ： 

赵某某与李某某离婚纠纷一审民事裁定书.txt	依照 《 中华人民共和国 民事 诉讼法 》 第 一百四十 三条 之 规定 ， 裁定 如下 ： 

赵某某与杜某某离婚纠纷一审民事裁定书.txt	依照 《 中华人民共和国 民事 诉讼法 》 第 一百四十 五条 第一款 之 规定 ， 裁定 如下 ： 

赵某某与黎某某离婚纠纷一审民事裁定书.txt	依照 《 中华人民共和国 民事 诉讼法 》 第 一百四十 五条 的 规定 ， 裁定 如下 ： 

赵某某诉王某某离婚纠纷一审民事裁定书.txt	依照 《 中华人民共和国 民事 诉讼法 》 第 一百四十 五条 第一款 的 规定 ， 裁定 如下 ： 

赵某某诉蒲某某离婚纠纷一审民事裁定书.txt	依照 《 中华人民共和国 民事 诉讼法 》 第 一百四十 五条 之 规定 ， 裁定 如下 ： 

赵某诉陈某某离婚纠纷一审民事裁定书.txt	依照 《 中华人民共和国 民事 诉讼法 》 第 一百四十 五条 第一款 之 规定 ， 裁定 如下 ： 

赵正凤与靳福全离婚纠纷一审民事裁定书.txt	依照 《 中华人民共和国 民事 诉讼法 》 第 一百四十 五条 第一款 的 规定 ， 裁定 如下 ： 

车某兰与肖某林离婚纠纷一审民事裁定书.txt	依据 《 中华人民共和国 民事 诉讼法 》 第 一百四十 五条 之 规定 ， 裁定 如下 ： 

边某与王某某离婚纠纷一审民事裁定书.txt	据此 ， 依照 《 中华人民共和国 民事 诉讼法 》 第 一百四十 五条 第一款 之 规定 ， 裁定 如下 ： 

邓某与唐某离婚纠纷一审民事裁定书.txt	依照 《 中华人民共和国 民事 诉讼法 》 第 一百四十 五条 第一款 之 规定 ， 裁定 如下 ： 

邓某与王某某离婚纠纷案一审民事裁定书.txt	依照 《 中华人民共和国 民事 诉讼法 》 第 一百四十 五条 之 规定 ， 裁定 如下 ： 

邓某某与张某某婚纠纷一审民事判决书.txt	依照 《 中华人民共和国 民事 诉讼法 》 第 一百四十 三条 之 规定 ， 裁定 如下 ： 

邓某某与张某某离婚纠纷一审民事裁定书.txt	依照 《 中华人民共和国 民事 诉讼法 》 第 一百四十 五条 第一款 宣判 前 ， 原告 申请 撤诉 的 ， 是否 准许 ， 由 人民法院 裁定 、 第一百五十四条 第一款 第五项 裁定 适用 于 下列 范围 ： （ 五 ） 准许 或者 不 准许 撤诉 之 规定 ， 裁定 如下 ： 

邓某某与杨某某离婚纠纷一审民事裁定书.txt	据此 ， 依照 《 中华人民共和国 民事 诉讼法 》 笫 一百四十 五条 第一款 之 规定 ， 裁定 如下 ： 

邓某某与王某某离婚纠纷一审民事裁定书.txt	依照 《 中华人民共和国 民事 诉讼法 》 第 一百一十 八条 、 第一百五十四条 第一款 第 （ 十一 ） 项 、 《 最高人民法院 关于 适用 〈 诉讼费用 交纳 办法 〉 的 通知 》 第二条 的 规定 ， 裁定 如下 ： 

邓某某与裴某某离婚纠纷案一审民事裁定书.txt	依照 《 中华人民共和国 民事 诉讼法 》 第 一百一十 八条 、 《 诉讼费用 交纳 办法 》 第二十二条 之 规定 ， 裁定 如下 ： 

邓某某与谢某某离婚纠纷一审民事裁定书.txt	依照 《 中华人民共和国 民事 诉讼法 》 第 一百四十 五条 之 规定 ， 裁定 如下 ： 

邓某某与鲁某某离婚纠纷一审民事裁定书.txt	依照 《 中华人民共和国 民事 诉讼法 》 第 一百四十 五条 第一款 的 规定 ， 裁定 如下 ： 

邓某某与黎某某离婚纠纷一审民事裁定书.txt	依照 《 中华人民共和国 民事 诉讼法 》 第 一百四十 三条 、 第一百五十四条 第一款 第 （ 十一 ） 项 的 规定 ， 裁定 如下 ： 

邓海燕诉郑椿离婚纠纷一审民事裁定书.txt	依照 《 中华人民共和国 民事 诉讼法 》 第 一百四十 五条 的 规定 ， 裁定 如下 ： 

邱某与张某离婚纠纷一审民事裁定书.txt	依照 《 中华人民共和国 民事 诉讼法 》 第 一百四十 五条 第一款 的 规定 ， 裁定 如下 ： 

邱某某与袁某某离婚纠纷一案一审民事裁定书.txt	依照 《 中华人民共和国 民事 诉讼法 》 第 一百四十 五条 第一款 之 规定 ， 裁定 如下 ： 

邹某某与李某某离婚纠纷一审民事裁定书.txt	依照 《 中华人民共和国 民事 诉讼法 》 第 一百四十 五条 第一款 之 规定 ， 裁定 如下 ： 

邹某某与王某某离婚纠纷一审民事裁定书.txt	依照 《 中华人民共和国 民事 诉讼法 》 第 一百四十 五条 第一款 的 规定 ， 裁定 如下 ： 

邹某某与苟某某离婚纠纷一审民事裁定书.txt	根据 《 中华人民共和国 民事 诉讼法 》 第 一百四十 五条 之 规定 ， 裁定 如下 ： 

郁某与宋某离婚纠纷一审民事裁定书.txt	依照 《 中华人民共和国 民事 诉讼法 》 第 一百四十 五条 之 规定 ， 裁定 如下 ： 

郑某与张某离婚纠纷案一审民事裁定书.txt	依照 《 中华人民共和国 民事 诉讼法 》 第 一百四十 三条 、 第一百五十四条 之 规定 ， 裁定 如下 ： 

郑某某与冯某某离婚纠纷一审民事裁定书.txt	依照 《 中华人民共和国 民事 诉讼法 》 第 一百四十 五条 第一款 的 规定 ， 裁定 如下 ： 

郑某某与王某某离婚纠纷一审民事裁定书.txt	依照 《 中华人民共和国 民事 诉讼法 》 第十三条 第二款 " 当事人 有权 在 法律 规定 的 范围 内 处分 自己 的 民事权利 和 诉讼 权利 " 、 第 一百四十 五条 第一款 " 宣判 前 ， 原告 申请 撤诉 的 ， 是否 准许 ， 由 人民法院 裁定 " 的 规定 ， 裁定 如下 ： 

郑某某与范某某离婚纠纷二审民事裁定书.txt	依照 《 中华人民共和国 民事 诉讼法 》 第一百七 十三条 之 规定 ， 裁定 如下 ： 

郑某某与陈某某离婚纠纷一审民事裁定书.txt	依照 《 中华人民共和国 民事 诉讼法 》 第 一百四十 三条 之 规定 ， 裁定 如下 ： 

郑某某诉刘某某离婚纠纷一审民事裁定书.txt	依照 《 中华人民共和国 民事 诉讼法 》 第十三条 第二款 、 第 一百四十 五条 之 规定 ， 裁定 如下 ： 

郝某某与蒋某离婚纠纷一审民事裁定书.txt	依照 《 中华人民共和国 民事 诉讼法 》 第 一百四十 五条 一款 之 规定 ， 裁定 如下 ： 

郭某与徐某某离婚纠纷一审民事裁定书.txt	依照 《 中华人民共和国 民事 诉讼法 》 第一百 四十五 的 规定 ， 裁定 如下 ： 

郭某与龚某离婚纠纷一审民事裁定书.txt	依照 《 中华人民共和国 民事 诉讼法 》 第 一百四十 五条 一款 之 规定 ， 裁定 如下 ： 

郭某某与刘某某离婚纠纷一审民事裁定书.txt	据此 ， 依照 《 中华人民共和国 民事 诉讼法 》 第 一百四十 五条 第一款 " 宣判 前 ， 原告 申请 撤诉 的 ， 是否 准许 ， 由 人民法院 裁定 。 " 之 规定 ， 裁定 如下 ： 

郭某某与姜某某离婚纠纷一审民事裁定书.txt	依照 《 中华人民共和国 民事 诉讼法 》 第 一百四十 五条 第一款 宣判 前 ， 原告 申请 撤诉 的 ， 是否 准许 ， 由 人民法院 裁定 、 第一百五十四条 第一款 第五项 裁定 适用 于 下列 范围 ： （ 五 ） 准许 或者 不 准许 撤诉 之 规定 ， 裁定 如下 ： 

郭某某与舒某某离婚纠纷一审民事裁定书.txt	依照 《 中华人民共和国 民事 诉讼法 》 第 一百四十 五条 的 规定 ， 裁定 如下 ： 

鄢某某与张某某离婚纠纷一审民事裁定书.txt	依照 《 中华人民共和国 民事 诉讼法 》 第 一百四十 五条 的 规定 ， 裁定 如下 ： 

金某某与许某某离婚纠纷一审民事裁定书.txt	依照 《 中华人民共和国 民事 诉讼法 》 第 一百四十 五条 第一款 " 宣判 前 ， 原告 申请 撤诉 的 ， 是否 准许 ， 由 人民法院 裁定 " 的 规定 ， 裁定 如下 ： 

钟某某诉冯某某离婚纠纷一审民事裁定书.txt	依照 《 中华人民共和国 民事 诉讼法 》 第 一百四十 五条 第一款 之 规定 ， 裁定 如下 ： 

铁某某与李某离婚纠纷一审民事裁定书.txt	据此 ， 依照 《 中华人民共和国 民事 诉讼法 》 第 一百四十 五条 第一款 之 规定 ， 裁定 如下 ： 

阳某某与李某某离婚纠纷一审民事裁定书.txt	依照 《 中华人民共和国 民事 诉讼法 》 第 一百四十 五条 " 宣判 前 ， 原告 申请 撤诉 的 ， 是否 准许 ， 由 人民法院 裁定 " 和 《 中华人民共和国 民事 诉讼法 》 第一百五十四条 第一款 第五项 " 准许 或者 不 准许 撤诉 " 的 规定 ， 裁定 如下 ： 

阿某某诉卡某某离婚纠纷一案民事裁定书.txt	依照 《 最高人民法院 关于 适用 ﹤ 中华人民共和国 民事 诉讼法 ﹥ 若干 问题 的 意见 》 第 一百四十 三条 ， 《 诉讼费用 交纳 办法 》 第二十二条 的 规定 ， 裁定 如下 ： 

阿牛某某与王某离婚纠纷一审民事裁定书.txt	据此 ， 依照 《 中华人民共和国 民事 诉讼法 》 第 一百四十 五条 第一款 之 规定 ， 裁定 如下 ： 

陀某某诉黄某某离婚纠纷一审民事裁定书.txt	依照 《 中华人民共和国 民事 诉讼法 》 第 一百四十 五条 " 宣判 前 ， 原告 申请 撤诉 的 ， 是否 准许 ， 由 人民法院 裁定 " 的 规定 ， 裁定 如下 ： 

陈小娇与汤海山离婚纠纷再审审查民事裁定书.txt	依照 《 中华人民共和国 民事 诉讼法 》 第 198 条 的 规定 ， 经 本院 审判 委员会 决定 ， 裁定 如下 ： 

陈某与卢某某离婚纠纷一审民事裁定书.txt	根据 《 中华人民共和国 民事 诉讼法 》 第 一百四十 五条 第一款 之 规定 ， 裁定 如下 ： 

陈某与叶某某离婚纠纷一审民事裁定书.txt	依照 《 中华人民共和国 民事 诉讼法 》 第 一百四十 五条 第一款 之 规定 ， 裁定 如下 ： 

陈某与宋某离婚纠纷一审民事裁定书.txt	根据 《 中华人民共和国 民事 诉讼法 》 第 一百四十 五条 之 规定 ， 裁定 如下 ： 

陈某与李某离婚纠纷一审民事判决书.txt	依照 《 中华人民共和国 婚姻法 》 第三十二条 之 规定 ， 判决 如下 ： 

陈某与李某离婚纠纷一审民事裁定书.txt	依照 《 中华人民共和国 民事 诉讼法 》 第 一百四十 五条 第一款 之 规定 ， 裁定 如下 ： 

陈某与王某离婚纠纷一审民事裁定书.txt	依照 《 中华人民共和国 民事 诉讼法 》 第 一百四十 五条 一款 之 规定 ， 裁定 如下 ： 

陈某与瞿某某离婚纠纷一审民事裁定书.txt	据此 ， 依照 《 中华人民共和国 民事 诉讼法 》 第 一百四十 五条 第一款 之 规定 ， 裁定 如下 ： 

陈某与罗某离婚纠纷一审民事裁定书.txt	根据 《 中华人民共和国 民事 诉讼法 》 第 一百四十 五条 之 规定 ， 裁定 如下 ： 

陈某与谭某某离婚纠纷民事裁定书.txt	依照 《 中华人民共和国 民事 诉讼法 》 第 一百四十 五条 第一款 之 规定 ， 裁定 如下 ： 

陈某与赵某离婚纠纷一审民事裁定书.txt	依照 《 中华人民共和国 民事 诉讼法 》 第 一百四十 五条 之 规定 ， 裁定 如下 ： 

陈某与邱某离婚纠纷一审民事裁定书.txt	依照 《 中华人民共和国 民事 诉讼法 》 第一百五十四条 之 规定 ， 裁定 如下 ： 

陈某与陶某离婚纠纷一审民事裁定书.txt	根据 《 中华人民共和国 民事 诉讼法 》 第 一百四十 五条 之 规定 ， 裁定 如下 ： 

陈某与鲁某离婚纠纷一审民事裁定书.txt	依照 《 中华人民共和国 民事 诉讼法 》 第 一百四十 五条 第一款 之 规定 ， 裁定 如下 ： 

陈某与黄某离婚纠纷一审民事裁定书.txt	根据 《 中华人民共和国 民事 诉讼法 》 第 一百四十 五条 之 规定 ， 裁定 如下 ： 

陈某某与任某某离婚纠纷二审民事裁定书.txt	依照 《 中华人民共和国 民事 诉讼法 》 第 一百一十 八条 第一款 、 《 诉讼费用 交纳 办法 》 第二十条 第一款 、 第二十二条 第四款 的 规定 ， 裁定 如下 ： 

陈某某与何某某离婚纠纷一审民事裁定书.txt	依照 《 中华人民共和国 民事 诉讼法 》 第 一百四十 五条 第一款 宣判 前 ， 原告 申请 撤诉 的 ， 是否 准许 ， 由 人民法院 裁定 、 第一百五十四条 第一款 第五项 裁定 适用 于 下列 范围 ： （ 五 ） 准许 或者 不 准许 撤诉 之 规定 ， 裁定 如下 ： 

陈某某与刘某某离婚纠纷一审民事裁定书.txt	据此 ， 依照 《 中华人民共和国 民事 诉讼法 》 第 一百四十 五条 第一款 之 规定 ， 裁定 如下 ： 

陈某某与向某某离婚纠纷一审民事裁定书.txt	依照 《 中华人民共和国 民事 诉讼法 》 第 一百一十 九条 第二款 ， 《 最高人民法院 关于 适用 简易程序 审理 民事案件 的 若干 规定 》 第八条 第二款 之 规定 ， 裁定 如下 ： 

陈某某与周某某离婚纠纷一审民事裁定书.txt	依照 《 中华人民共和国 民事 诉讼法 》 第 一百四十 五条 的 规定 ， 裁定 如下 ： 

陈某某与夏某某）离婚纠纷一审民事裁定书.txt	依照 《 中华人民共和国 民事 诉讼法 》 第十三条 第二款 、 第 一百四十 五条 第一款 之 规定 ， 裁定 如下 ： 

陈某某与官某某婚姻家庭纠纷一审民事裁定书.txt	依照 《 中华人民共和国 民事 诉讼法 》 第十三条 第二款 、 第 一百四十 五条 第一款 之 规定 ， 裁定 如下 ： 

陈某某与崔某某离婚纠纷一审民事裁定书.txt	依照 《 中华人民共和国 民事 诉讼法 》 第 一百四十 五条 之 规定 ， 裁定 如下 ： 

陈某某与张某某离婚纠纷一审民事裁定书.txt	依照 《 中华人民共和国 民事 诉讼法 》 第 一百四十 五条 第一款 ： 宣判 前 ， 原告 申请 撤诉 的 ， 是否 准许 ， 由 人民法院 裁定 、 第一百五十四条 第一款 第 （ 五 ） 项 ： 裁定 适用 于 下列 范围 ： hellip ; hellip ; （ 五 ） 准许 或者 不 准许 撤诉 ； hellip ; hellip ; 之 规定 ， 裁定 如下 ： 

陈某某与李某某离婚纠纷一审民事裁定书.txt	依照 《 中华人民共和国 民事 诉讼法 》 第 一百四十 五条 第一款 之 规定 ， 裁定 如下 ： 

陈某某与杜某某离婚纠纷一审民事裁定书.txt	依照 《 中华人民共和国 民事 诉讼法 》 第 一百四十 五条 之 规定 ， 裁定 如下 ： 

陈某某与江某某离婚纠纷一审民事裁定书.txt	依照 《 中华人民共和国 民事 诉讼法 》 第 一百四十 五条 的 规定 ， 裁定 如下 ： 

陈某某与汤某某离婚纠纷一审民事裁定书.txt	依照 《 中华人民共和国 民事 诉讼法 》 第 一百四十 五条 之 规定 ， 裁定 如下 ： 

陈某某与汪某某离婚纠纷一审民事裁定书.txt	依照 《 中华人民共和国 民事 诉讼法 》 第一百 二十九条 之 规定 ， 裁定 如下 ： 

陈某某与洪某某离婚纠纷一审民事裁定书.txt	依照 《 中华人民共和国 民事 诉讼法 》 第十三条 第二款 、 第 一百四十 五条 第一款 之 规定 ， 裁定 如下 ： 

陈某某与王某某离婚后财产纠纷一审民事裁定书.txt	依照 《 中华人民共和国 民事 诉讼法 》 第 一百四十 五条 第一款 、 第一百五十四条 第一款 第五项 之 规定 ， 裁定 如下 ： 

陈某某与王某离婚纠纷一审民事裁定书.txt	据此 ， 依照 《 中华人民共和国 民事 诉讼法 》 第 一百四十 五条 第一款 之 规定 ， 裁定 如下 ： 

陈某某与索某某离婚纠纷一审民事裁定书.txt	依照 《 中华人民共和国 民事 诉讼法 》 第 一百四十 五条 的 规定 ， 裁定 如下 ： 

陈某某与马某某离婚纠纷一审民事裁定书.txt	依照 《 中华人民共和国 民事 诉讼法 》 第 一百四十 五条 第一款 之 规定 ， 裁定 如下 ： 

陈某某诉孙某某离婚纠纷一案一审民事裁定书.txt	依照 《 中华人民共和国 民事 诉讼法 》 第 一百四十 五条 之 规定 ， 裁定 如下 ： 

陈某某诉李某某婚姻无效纠纷一审民事裁定书.txt	依照 《 中华人民共和国 民事 诉讼法 》 第 一百四十 五条 第一款 之 规定 ， 裁定 如下 ： 

陈某某诉江某某离婚纠纷一审民事裁定书.txt	依照 《 中华人民共和国 民事 诉讼法 》 第 一百四十 五条 第一款 的 规定 ， 裁定 如下 ： 

陈某某诉陈某离婚纠纷一审民事裁定书.txt	依照 《 中华人民共和国 民事 诉讼法 》 第 一百四十 五条 之 规定 ， 裁定 如下 ： 

陈某诉杜某离婚纠纷一审民事裁定书.txt	依照 《 中华人民共和国 民事 诉讼法 》 第 一百四十 五条 第一款 " 宣判 前 ， 原告 申请 撤诉 的 ， 是否 准许 ， 由 人民法院 裁定 " 的 规定 ， 裁定 如下 ： 

陶某与李某离婚纠纷一审民事裁定书.txt	依照 《 中华人民共和国 民事 诉讼法 》 第 一百四十 五条 之 规定 ， 裁定 如下 ： 

陶某某与熊某离婚纠纷一审民事裁定书.txt	依照 《 中华人民共和国 民事 诉讼法 》 第 一百四十 五条 第一款 之 规定 ， 裁定 如下 ： 

陶某某与贯某某离婚纠纷一审民事裁定书.txt	依照 《 中华人民共和国 民事 诉讼法 》 第 一百四十 五条 之 规定 ， 裁定 如下 ： 

雷某诉肖某某离婚纠纷一案一审民事裁定书.txt	据此 ， 依照 《 中华人民共和国 民事 诉讼法 》 第 一百四十 五条 第一款 之 规定 ， 裁定 如下 ： 

靳某与王某某离婚纠纷一审民事裁定书.txt	依照 《 中华人民共和国 民事 诉讼法 》 第十三条 " 当事人 有权 在 法律 规定 的 范围 内 处分 自己 的 民事权利 和 诉讼 权利 " 及第 一百四十 五条 第一款 " 宣判 前 ， 原告 申请 撤诉 的 ， 是否 准许 ， 由 人民法院 裁定 " 的 规定 ， 裁定 如下 ： 

韦某某与杨某某离婚纠纷一审民事裁定书.txt	依照 《 中华人民共和国 民事 诉讼法 》 第 一百四十 五条 、 第一百五十四条 第一款 第五项 之 规定 ， 裁定 如下 ： 

韦某某与赵某某离婚纠纷一审民事裁定书.txt	依照 《 中华人民共和国 民事 诉讼法 》 第 一百四十 五条 第一款 宣判 前 ， 原告 申请 撤诉 的 ， 是否 准许 ， 由 人民法院 裁定 、 第一百五十四条 第一款 裁定 适用 于 下列 范围 ： hellip ; hellip ; （ 五 ） 准许 或者 不 准许 撤诉 的 规定 ， 裁定 如下 ： 

韩某与刘某离婚纠纷一审民事判决书.txt	依照 《 中华人民共和国 民事 诉讼法 》 第 一百四十四 条 及 《 中华人民共和国 婚姻法 》 第三十二条 的 规定 ， 判决 如下 ： 

韩某与罗某离婚纠纷一审民事裁定书.txt	依照 《 中华人民共和国 民事 诉讼法 》 第 一百四十 五条 之 规定 ， 裁定 如下 ： 

韩某与黄某离婚纠纷一审民事裁定书.txt	根据 《 中华人民共和国 民事 诉讼法 》 第 一百四十 五条 之 规定 ， 裁定 如下 ： 

韩某某与代某某离婚纠纷一审民事裁定书.txt	据此 ， 依照 《 中华人民共和国 民事 诉讼法 》 第 一百四十 五条 第一款 之 规定 ， 裁定 如下 ： 

须某某与来某某离婚纠纷一审民事裁定书.txt	依照 《 中华人民共和国 民事 诉讼法 》 第 一百四十 五条 第一款 之 规定 ， 裁定 如下 ： 

须郭某某与阳某某离婚纠纷一审民事裁定书.txt	依照 《 中华人民共和国 民事 诉讼法 》 第 一百四十 五条 第一款 之 规定 ， 裁定 如下 ： 

颜某某与曹某离婚纠纷一审民事裁定书.txt	原告 颜 某某 与 被告 曹某 离婚 纠纷 一案 ， 本院 受理 后 ， 原告 颜 某某 在 收到 本院 交纳 诉讼费用 通知 后 ， 既 不 预交 诉讼费 ， 又 未 申请 司法 救助 。 依照 国务院 《 诉讼费用 交纳 办法 》 第二十二 第一 、 四款 及 最高人民法院 《 关于 适用 ﹤ 中华人民共和国 民事 诉讼法 ﹥ 若干 问题 的 意见 》 第 一百四十 三之 规定 ， 裁定 如下 ： 

颜某某与陈某某离婚纠纷一审民事裁定书.txt	依照 《 中华人民共和国 民事 诉讼法 》 第 一百四十 五条 的 规定 ， 裁定 如下 ： 

颜某某申请执行曾某某离婚纠纷一案执行裁定书.txt	依照 《 中华人民共和国 民事 诉讼法 》 第 二百五十 七条 的 规定 ， 裁定 如下 ： 

马某与张某离婚纠纷一审民事裁定书.txt	根据 《 中华人民共和国 民事 诉讼法 》 第 一百四十 五条 之 规定 ， 裁定 如下 ： 

马某与王某离婚纠纷一审民事裁定书.txt	根据 《 中华人民共和国 民事 诉讼法 》 第 一百四十 五条 之 规定 ， 裁定 如下 ： 

马某与龙某离婚纠纷一审民事裁定书.txt	根据 《 中华人民共和国 民事 诉讼法 》 第 一百四十 五条 " 宣判 前 ， 原告 申请 撤诉 的 ， 是否 准许 ， 由 人民法院 裁定 。 " 之 规定 ， 裁定 如下 ： 

马某某与唐某某离婚纠纷一审民事裁定书.txt	依照 《 中华人民共和国 民事 诉讼法 》 第 一百四十 五条 的 规定 ， 裁定 如下 ： 

马某某与赵某某离婚纠纷一审民事裁定书.txt	据此 ， 依照 《 中华人民共和国 民事 诉讼法 》 第 一百四十 五条 第一款 " 宣判 前 ， 原告 申请 撤诉 的 ， 是否 准许 ， 由 人民法院 裁定 。 " 之 规定 ， 裁定 如下 ： 

马某某与马某甲离婚纠纷一审民事裁定书.txt	依照 《 中华人民共和国 民事 诉讼法 》 第 一百四十 五条 第一款 之 规定 ， 裁定 如下 ： 

马某某申请执行孙某某离婚纠纷一案执行裁定书.txt	依照 《 中华人民共和国 民事 诉讼法 》 第 二百五十 七条 的 规定 ， 裁定 如下 ： 

马某甲诉马某乙离婚纠纷一审民事裁定书.txt	依照 《 中华人民共和国 民事 诉讼法 》 第 一百四十 五条 的 规定 ， 裁定 如下 ： 

马某诉庞某离婚纠纷一审民事裁定书.txt	依照 《 中华人民共和国 民事 诉讼法 》 第 一百四十 三条 之 规定 ， 裁定 如下 ： 

骆某某与彭某某离婚纠纷一审民事裁定书.txt	依照 《 中华人民共和国 民事 诉讼法 》 第 一百四十 五条 第一款 之 规定 ， 裁定 如下 ： 

骆某某与王某某离婚纠纷一审民事裁定书.txt	依照 《 中华人民共和国 民事 诉讼法 》 第 一百四十 五条 第一款 的 规定 ， 裁定 如下 ： 

骆某某与祝某某离婚纠纷案一审民事裁定书.txt	据此 ， 依照 《 中华人民共和国 民事 诉讼法 》 第 一百四十 五条 的 规定 ， 裁定 如下 ： 

骆某某与陈某离婚纠纷一审民事裁定书.txt	依照 《 中华人民共和国 民事 诉讼法 》 第十三条 第二款 、 第 一百四十 五条 第一款 之 规定 ， 裁定 如下 ： 

高某与王某离婚纠纷案一审民事裁定书.txt	依照 《 中华人民共和国 民事 诉讼法 》 第 一百四十 五条 第一款 的 规定 ， 裁定 如下 ： 

高某某与严某某离婚纠纷一审民事判决书.txt	根据 《 中华人民共和国 民事 诉讼法 》 第 一百四十 五条 之 规定 ， 裁定 如下 ： 

高某某与何某某离婚纠纷一审民事裁定书.txt	根据 《 中华人民共和国 民事 诉讼法 》 第 一百四十 五条 之 规定 ， 裁定 如下 ： 

高某某与胡某某离婚纠纷一审民事裁定书.txt	据此 ， 依照 《 中华人民共和国 民事 诉讼法 》 第 一百四十 五条 第一款 " 宣判 前 ， 原告 申请 撤诉 的 ， 是否 准许 ， 由 人民法院 裁定 。 " 之 规定 ， 裁定 如下 ： 

高某某与袁某某离婚纠纷一审民事裁定书.txt	依照 《 中华人民共和国 民事 诉讼法 》 第 一百四十 五条 的 规定 ， 裁定 如下 ： 

魏某某与母某某离婚纠纷一审民事裁定书.txt	据此 ， 依照 《 中华人民共和国 民事 诉讼法 》 第 一百四十 三条 之 规定 ， 裁定 如下 ： 

魏某某与谭某某离婚纠纷一审裁定书.txt	依照 《 中华人民共和国 民事 诉讼法 》 第十三条 第二款 和 第 一百四十 五条 第一款 的 规定 ， 裁定 如下 ： 

鲜某某与何某离婚纠纷一审民事裁定书.txt	依照 《 中华人民共和国 民事 诉讼法 》 第 一百四十 五条 之 规定 ， 裁定 如下 ： 

鲜某诉秦某离婚纠纷一审民事裁定书.txt	依照 《 中华人民共和国 民事 诉讼法 》 第十三条 和 第 一百四十 五条 第一款 的 规定 ， 裁定 如下 ： 

黄某与何某离婚纠纷一审民事裁定书.txt	依照 《 诉讼费用 缴纳 办法 》 第二十二条 第一款 、 第四款 的 规定 ， 裁定 如下 ： 

黄某与谭某离婚纠纷案一审民事裁定书.txt	依照 《 中华人民共和国 民事 诉讼法 》 第 一百四十 五条 第一款 的 规定 ， 裁定 如下 ： 

黄某某与刘某某离婚纠纷一审民事裁定书.txt	依照 《 中华人民共和国 民事 诉讼法 》 第 一百四十 五条 的 规定 ， 裁定 如下 ： 

黄某某与戚某某离婚纠纷一审民事裁定书.txt	依照 《 中华人民共和国 民事 诉讼法 》 第 一百四十 五条 第一款 ： " 宣判 前 ， 原告 申请 撤诉 的 ， 是否 准许 ， 由 人民法院 裁定 " 的 规定 ， 裁定 如下 ： 

黄某某与沈某某离婚纠纷一审民事裁定书.txt	依照 《 中华人民共和国 民事 诉讼法 》 第十三条 第二款 、 第 一百四十 五条 第一款 之 规定 ， 裁定 如下 ： 

黄某某与王某某离婚纠纷案一审民事裁定书.txt	依照 《 中华人民共和国 民事 诉讼法 》 第 一百四十 五条 之 规定 ， 裁定 如下 ： 

黄某某与雷某某离婚纠纷一审民事裁定书.txt	依照 《 中华人民共和国 民事 诉讼法 》 第十三条 第二款 、 第 一百四十 五条 第一款 的 规定 ， 裁定 如下 ： 

黄某某诉刘某某离婚纠纷一审民事裁定书.txt	依照 《 中华人民共和国 民事 诉讼法 》 第 一百四十 五条 第一款 之 规定 ， 裁定 如下 ： 

黄某某诉范某某离婚纠纷一审民事裁定书.txt	根据 《 中华人民共和国 民事 诉讼法 》 第 一百四十 五条 之 规定 ， 裁定 如下 ： 

黄某某诉许某某离婚纠纷一审民事裁定书.txt	依照 《 中华人民共和国 民事 诉讼法 》 第 一百四十 五条 、 第一百五十四条 的 相关 规定 ， 裁定 如下 ： 

黄某甲诉熊某甲离婚纠纷一案民事一审判决书.txt	依照 《 中华人民共和国 民事 诉讼法 》 第 一百四十 五条 、 第一百五十四条 之 规定 ， 裁定 如下 ： 

黄茂乐与徐仁茂离婚纠纷二审民事裁定书.txt	依照 《 中华人民共和国 民事 诉讼法 》 第十三条 第二款 、 第一百七 十三条 、 第一百七 十五条 之 规定 ， 裁定 如下 ： 

黄辉建与郑贵才离婚纠纷一案民事裁定书.txt	依照 《 中华人民共和国 民事 诉讼法 》 第 一百四十 五条 之 规定 ， 裁定 如下 ： 

黎某某与许某某离婚纠纷一审民事裁定书.txt	依照 《 中华人民共和国 民事 诉讼法 》 第 一百四十 五条 第一款 之 规定 ， 裁定 如下 ： 

龙某某诉张某某离婚纠纷裁定书.txt	依照 《 中华人民共和国 民事 诉讼法 》 第 一百四十 五条 之 规定 ， 裁定 如下 ： 

龙某某诉杨某某离婚纠纷一案一审民事裁定书.txt	依照 《 中华人民共和国 民事 诉讼法 》 第 一百四十 五条 之 规定 ， 裁定 如下 ： 

龚某与王某某离婚纠纷一审民事裁定书.txt	据此 ， 依照 《 中华人民共和国 民事 诉讼法 》 第 一百四十 五条 第一款 之 规定 ， 裁定 如下 ： 

龚某某与冯某某离婚纠纷一审民事裁定书.txt	依照 《 中华人民共和国 民事 诉讼法 》 第十三条 、 第 一百四十 五条 之 规定 ， 裁定 如下 ： 

龚某某与刘某某离婚纠纷一审民事裁定书.txt	依照 《 中华人民共和国 民事 诉讼法 》 第 一百四十 五条 、 第一百五十四条 之 规定 ， 裁定 如下 ： 

龚某某与张某某离婚纠纷一审民事裁定书.txt	依照 《 中华人民共和国 民事 诉讼法 》 第 一百四十 五条 之 规定 ， 裁定 如下 ： 

龚某某与许某某离婚纠纷一审民事裁定书.txt	依照 《 中华人民共和国 民事 诉讼法 》 第 一百四十 五条 的 规定 ， 裁定 如下 ： 
