丁某某与杜某某离婚纠纷案一审民事判决书.txt	驳回 丁 某某 要求 与 杜 某某 离婚 的 诉讼请求 。 

万某与姜某甲离婚纠纷一审民事判决书.txt	驳回 原告 万某 的 诉讼请求 。 

严某与李某某离婚纠纷一审民事判决书.txt	驳回 原告 严某 要求 与 被告 李 某某 离婚 的 诉讼请求 。 

严某某与杨某甲离婚纠纷一审民事判决书.txt	驳回 原告 严 某某 的 离婚 诉讼请求 。 

付某某与许某甲离婚纠纷一审民事判决书.txt	驳回 原告 付 某某 的 诉讼请求 。 

代某甲与邓某甲离婚纠纷一审民事判决书.txt	驳回 原告 代某 甲 的 离婚 诉讼请求 。 

任某某诉王某某离婚纠纷一审民事判决书.txt	驳回 原告 任 某某 要求 与 被告 王 某某 离婚 的 诉讼请求 。 

伍某与李某甲离婚纠纷一审民事判决书.txt	驳回 原告 伍某 的 诉讼请求 。 

伏某甲与伏某乙离婚纠纷一审民事判决书.txt	驳回 原告 伏某 甲 的 诉讼请求 。 

何建东与钟碧珍离婚纠纷一审民事判决书.txt	驳回 原告 何 某某 的 离婚 诉讼请求 。 

何某某与徐某离婚纠纷一审民事判决书.txt	驳回 原告 何 某某 的 诉讼请求 。 

何某某与李某某离婚纠纷一审民事判决书.txt	驳回 原告 何 某某 要求 与 被告 李 某某 离婚 的 诉讼请求 。 

何某某与梁某某离婚纠纷案一审民事判决书.txt	驳回 原告 何 某某 要求 与 被告 梁 某某 离婚 的 诉讼请求 。 

何某某与谭某某离婚纠纷一审民事判决书.txt	驳回 原告 何 某某 要求 与 被告 谭 某某 离婚 的 诉讼请求 。 

何某某与邓某某离婚纠纷案一审民事判决书.txt	驳回 原告 何 某某 要求 与 被告 邓 某某 离婚 的 诉讼请求 。 

何某某与魏某离婚纠纷案一审民事判决书.txt	驳回 何 某某 要求 与 魏某 离婚 的 诉讼请求 。 

何某某诉杨某某离婚纠纷一审民事判决书.txt	驳回 原告 何 某某 的 诉讼请求 。 

何某甲与杨某离婚纠纷一审民事判决书.txt	驳回 原告 何某 甲 的 诉讼请求 。 

余某与罗某甲离婚纠纷一审民事判决书.txt	驳回 原告 余某 的 诉讼请求 。 

余某某与何某某离婚纠纷一审民事判决书.txt	驳回 原告 余 某某 的 诉讼请求 。 

倪某某与肖某离婚纠纷一审民事判决书.txt	驳回 原告 倪 某某 的 离婚 诉讼请求 。 

傅某与汪某甲离婚纠纷一审民事判决书.txt	驳回 原告 傅某 的 诉讼请求 。 

冯某某与何某某离婚纠纷案一审民事判决书.txt	驳回 原告 冯 某某 要求 与 被告 何 某某 离婚 的 诉讼请求 。 

冯某某与李某某离婚纠纷一审民事判决书.txt	驳回 原告 冯 某某 的 离婚 诉讼请求 。 

冯某某与王某某离婚纠纷一审民事判决书.txt	驳回 原告 冯 某某 的 诉讼请求 。 

冯某某诉张甲离婚纠纷一审民事判决书.txt	驳回 原告 冯 某某 的 诉讼请求 。 

凌某某与凌某甲离婚纠纷一案一审民事判决书.txt	驳回 原告 凌 某某 的 离婚 请求 。 

刘某与吴某某离婚纠纷案一审民事判决书.txt	驳回 原告 刘某 要求 与 被告 吴 某某 离婚 的 诉讼请求 。 

刘某某与代某某离婚纠纷一审民事判决书.txt	驳回 原告 刘 某某 的 诉讼请求 。 

刘某某与候某某离婚纠纷案一审民事判决书.txt	驳回 刘 某某 要求 与 候 某某 离婚 的 诉讼请求 。 

刘某某与刘某离婚纠纷一案民事判决书.txt	驳回 原告 刘 某某 的 离婚 诉讼请求 。 

刘某某与张某某离婚纠纷一审民事判决书.txt	驳回 原告 刘 某某 的 诉讼请求 。 

刘某某与白某某离婚纠纷案一审民事判决书.txt	驳回 原告 刘 某某 要求 与 被告 白 某某 离婚 的 诉讼请求 。 

刘某某与陈某甲离婚纠纷一案民事判决书.txt	驳回 原告 刘 某某 的 离婚 诉讼请求 。 

刘某某与黄某某离婚纠纷一审民事判决书.txt	驳回 原告 刘 某某 的 离婚 请求 ； 

刘某某与黄某某离婚纠纷案一审民事判决书.txt	驳回 原告 刘 某某 要求 与 被告 黄 某某 离婚 的 诉讼请求 。 

刘某某诉商某某离婚纠纷一审民事判决书.txt	驳回 原告 刘 某某 的 诉讼请求 。 

刘某某诉赵某某离婚纠纷一案民事判决书.txt	驳回 原告 刘 某某 的 离婚 诉讼请求 。 

刘某诉王某离婚纠纷一审民事判决书.txt	驳回 原告 刘某 的 诉讼请求 。 

刘某诉贾某某离婚纠纷一审民事判决书.txt	驳回 原告 刘某 的 诉讼请求 。 

勾某某与何某某离婚纠纷案一审民事判决书.txt	驳回 原告 勾 某某 要求 与 被告 何 某某 离婚 的 诉讼请求 。 

卢某某诉雷某某离婚纠纷一审民事判决书.txt	驳回 原告 卢 某某 的 离婚 诉讼请求 。 

原告何某某与被告何某甲离婚纠纷一案一审民事判决书.txt	驳回 原告 何 某某 的 诉讼请求 。 

原告何某某与被告敬某甲离婚纠纷一案一审民事判决书.txt	驳回 原告 何 某某 的 离婚 诉讼请求 。 

原告何某某诉被告向某某离婚纠纷一案民事判决书.txt	驳回 原告 何 某某 的 诉讼请求 。 

原告何某某诉被告吴某甲离婚纠纷一审民事判决书.txt	驳回 原告 何 某某 的 诉讼请求 。 

原告何某某诉被告李某某离婚纠纷一案民事判决书.txt	驳回 原告 何 某某 的 诉讼请求 。 

原告何某某诉被告邓某某离婚纠纷一案民事判决书.txt	驳回 原告 何 某某 的 诉讼请求 。 

原告何某甲与被告钟某离婚纠纷一案一审民事判决书.txt	驳回 原告 何某 甲 的 诉讼请求 。 

原告何某诉被告赵某离婚纠纷一审民事判决书.txt	驳回 原告 何某 的 离婚 诉讼请求 。 

原告何某诉被告邓某离婚纠纷一案民事判决书.txt	驳回 原告 何某 的 诉讼请求 。 

原告侯某甲诉被告邵某甲离婚纠纷一案一审民事判决书.txt	驳回 原告 侯某 甲 的 诉讼请求 。 

原告冯某某与被告敬某某离婚纠纷一案一审民事判决书.txt	驳回 原告 冯 某某 的 诉讼请求 。 

原告刘某某与被告邓某甲离婚纠纷一案一审民事判决书.txt	驳回 原告 刘 某某 的 离婚 诉讼请求 。 

原告刘某某诉被告郑某某离婚纠纷一案一审民事判决书.txt	驳回 原告 刘 某某 的 诉讼请求 。 

原告刘某甲与被告刘某乙离婚纠纷一案一审民事判决书.txt	驳回 原告 刘某 甲 的 诉讼请求 。 

原告刘某诉被告朱某某离婚纠纷一案一审民事判决书.txt	驳回 原告 刘某 要求 与 被告 朱 某某 离婚 的 诉讼请求 。 

原告刘某诉被告李某甲离婚纠纷一案民事一审判决书.txt	驳回 原告 刘某 的 诉讼请求 。 

原告刘某诉被告肖某离婚纠纷一案一审民事判决书.txt	驳回 原告 刘某 要求 与 被告 肖某 离婚 的 诉讼请求 。 

原告华某某诉被告雷某离婚纠纷一案民事判决书.txt	驳回 原告 华 某某 的 诉讼请求 。 

原告吴某某与被告吴某甲离婚纠纷一案一审民事判决书.txt	驳回 原告 吴 某某 的 诉讼请求 。 

原告吴某某诉被告刘某甲离婚纠纷一审民事判决书.txt	驳回 原告 吴 某某 离婚 的 诉讼请求 。 

原告吴某某诉被告张某某离婚纠纷一审民事判决书.txt	驳回 原告 吴 某某 的 离婚 诉讼请求 。 

原告吴某诉被告罗某某离婚纠纷一案民事判决书.txt	驳回 原告 吴某 的 诉讼请求 。 

原告周某某诉被告罗某某离婚纠纷案一审民事判决书.txt	驳回 原告 周 某某 要求 与 被告 罗 某某 离婚 的 诉讼请求 。 

原告周某某诉被告闫某离婚纠纷一案一审民事判决书.txt	驳回 原告 周 某某 要求 与 被告 闫某 离婚 的 诉讼请求 。 

原告唐某诉被告陈某某离婚纠纷一案一审民事判决书.txt	驳回 原告 唐某 的 诉讼请求 。 

原告夏某某与被告蒋某某离婚纠纷一案一审民事判决书.txt	驳回 原告 夏 某某 要求 与 被告 蒋 某某 离婚 的 诉讼请求 。 

原告岳晨与被告周勇离婚纠纷一案民事判决书.txt	驳回 原告 岳某 的 诉讼请求 。 

原告廖某某诉被告唐某离婚纠纷一案一审民事判决书.txt	驳回 原告 廖 某某 的 诉讼请求 。 

原告张XX诉被告邓XX离婚纠纷一案一审民事判决书.txt	驳回 原告 张  要求 与 被告 邓  离婚 的 诉讼请求 。 

原告张某某与被告彭某某离婚纠纷一案一审民事判决书.txt	驳回 原告 张 某某 的 诉讼请求 。 

原告张某某诉被告侯某某离婚纠纷一案民事判决书.txt	驳回 原告 张 某某 的 诉讼请求 。 

原告彭小兰与被告冯玉平离婚纠纷一案一审判决书.txt	驳回 原告 彭某 甲 的 诉讼请求 。 

原告徐某某诉被告韩某某离婚纠纷一案一审民事判决书.txt	驳回 原告 徐某 甲 的 诉讼请求 。 

原告文某诉被告舒某甲离婚纠纷一案一审民事判决书.txt	驳回 原告 文某 的 诉讼请求 。 

原告晏某某诉被告李某某离婚纠纷一审民事判决书.txt	驳回 原告 晏 某某 的 离婚 诉讼请求 。 

原告曹某某诉被告李某某离婚纠纷一案民事判决书.txt	驳回 原告 曹 某某 的 诉讼请求 。 

原告曹某诉被告刘某离婚纠纷一案一审民事判决书.txt	驳回 原告 曹某 的 诉讼请求 。 

原告曾某某诉被告陈某甲离婚纠纷一审民事判决书.txt	驳回 原告 曾 某某 的 诉讼请求 。 

原告朱某诉被告张某离婚纠纷一案一审民事判决书.txt	驳回 原告 朱某 要求 与 被告 张某 离婚 的 诉讼请求 。 

原告李XX诉被告洪XX离婚纠纷一案一审民事判决书.txt	驳回 原告 李  要求 与 被告 洪  离婚 的 诉讼请求 。 

原告李某某与被告唐某某离婚纠纷一案一审民事判决书.txt	驳回 原告 李 某某 的 诉讼请求 。 

原告李某某与被告李某甲离婚纠纷一案一审民事判决书.txt	驳回 原告 李 某某 的 诉讼请求 。 

原告李某某诉被告张某某离婚纠纷一审民事判决书.txt	驳回 原告 李 某某 的 诉讼请求 。 

原告李某某诉被告张某甲离婚纠纷一案一审民事判决书.txt	驳回 原告 李 某某 的 诉讼请求 。 

原告李某甲与被告廖某某离婚纠纷一案一审民事判决书.txt	驳回 原告 李某 甲 的 离婚 诉讼请求 。 

原告李某诉被告赵某某离婚纠纷一案一审民事判决书.txt	驳回 原告 李某 的 诉讼请求 。 

原告杨XX诉被告唐XX离婚纠纷一案一审民事判决书.txt	驳回 原告 杨  要求 与 被告 唐  离婚 的 诉讼请求 。 

原告杨利诉被告吴井勇离婚纠纷一审民事判决书.txt	驳回 原告 杨某 的 诉讼请求 。 

原告杨某与被告文某甲离婚纠纷一审民事判决书.txt	驳回 原告 杨某 的 离婚 请求 。 

原告杨某某与被告李某某离婚纠纷一案一审民事判决书.txt	驳回 原告 杨 某某 的 诉讼请求 。 

原告杨某某与被告陈某某离婚纠纷一案一审民事判决书.txt	驳回 原告 杨 某某 的 诉讼请求 。 

原告杨某某诉被告夏某某离婚纠纷一案一审民事判决书.txt	驳回 原告 杨 某某 要求 与 被告 夏 某某 离婚 的 诉讼请求 。 

原告江某某与被告杨某某离婚纠纷一案一审民事判决书.txt	驳回 原告 江 某某 的 诉讼请求 。 

原告涂某某与被告邓某某离婚纠纷一案一审民事判决书.txt	驳回 原告 涂 某某 的 诉讼请求 。 

原告王婷与被告何毅离婚纠纷一案民事判决书.txt	驳回 原告 王某 要求 与 被告 何某 离婚 的 诉讼请求 。 

原告王某与被告马某甲离婚纠纷一案一审民事判决书.txt	驳回 原告 王某 的 诉讼请求 。 

原告王某某与被告张某某离婚纠纷一案一审民事判决书.txt	驳回 原告 王 某某 的 诉讼请求 。 

原告王某某与被告敬某某离婚纠纷一案一审民事判决书.txt	驳回 原告 王 某某 的 诉讼请求 。 

原告王某某与被告李某某离婚纠纷一案一审民事判决书.txt	驳回 原告 王 某某 的 离婚 诉讼请求 。 

原告王某某与被告赵某某离婚纠纷一案一审民事判决书.txt	驳回 原告 王 某某 要求 与 被告 赵 某某 离婚 的 诉讼请求 。 

原告王某某诉被告胡某某离婚纠纷一案民事判决书.txt	驳回 原告 王 某某 的 诉讼请求 。 

原告王某某诉被告许某离婚纠纷一审民事判决书.txt	驳回 原告 王 某某 的 离婚 诉讼请求 。 

原告王某甲诉被告滕某某离婚纠纷一案一审民事判决书.txt	驳回 原告 王某 甲 的 诉讼请求 。 

原告王某诉被告欧某某离婚纠纷一案一审民事判决书.txt	驳回 原告 王某 要求 与 被告 欧阳 泉 离婚 的 诉讼请求 。 

原告罗某诉被告徐某某离婚纠纷一案一审民事判决书.txt	驳回 原告 罗某 的 诉讼请求 。 

原告肖某某与被告伍某某离婚纠纷一案一审民事判决书.txt	驳回 原告 肖 某某 要求 与 被告 伍 某某 离婚 的 诉讼请求 。 

原告胡某与被告孙某离婚纠纷一案一审民事判决书.txt	驳回 原告 胡某 要求 与 被告 孙某 离婚 的 诉讼请求 。 

原告胡永红诉被告张建平离婚纠纷一案一审民事判决书.txt	驳回 原告 胡 某某 的 诉讼请求 。 

原告荣XX诉被告邹XX离婚纠纷一案一审民事判决书.txt	驳回 原告 荣  要求 与 被告 邹  离婚 的 诉讼请求 。 

原告袁某某与被告陈某甲离婚纠纷一案一审民事判决书.txt	驳回 原告 袁 某某 的 诉讼请求 。 

原告覃XX诉被告蒋XX离婚纠纷一案一审民事判决书.txt	驳回 原告 覃  要求 与 被告 蒋  离婚 的 诉讼请求 。 

原告覃某某诉被告胡某某离婚纠纷一案民事判决书.txt	驳回 原告 覃 某某 的 诉讼请求 。 

原告谢某某诉被告刘某某离婚纠纷一案一审民事判决书.txt	驳回 原告 谢 某某 要求 与 被告 刘 某某 离婚 的 诉讼请求 。 

原告谢某某诉被告卢某某离婚纠纷一案一审民事判决书.txt	驳回 原告 谢 某某 要求 与 被告 卢 某某 离婚 的 诉讼请求 。 

原告谭某某诉被告刘某某离婚纠纷一案民事判决书.txt	驳回 原告 谭 某某 的 诉讼请求 。 

原告谭某甲诉被告冉某某离婚纠纷一案一审民事判决书.txt	驳回 原告 谭某 甲 的 诉讼请求 。 

原告谭某甲诉被告张某某离婚纠纷一案一审民事判决书.txt	驳回 原告 谭某 甲 的 诉讼请求 。 

原告谷某某诉被告王某甲离婚纠纷一案一审民事判决书.txt	驳回 原告 谷 某某 的 诉讼请求 。 

原告赵XX诉被告蒙XX离婚纠纷一案一审民事判决书.txt	驳回 原告 赵  要求 与 被告 蒙  离婚 的 诉讼请求 。 

原告赵某与被告孙某离婚纠纷一案一审民事判决书.txt	驳回 原告 赵某 的 诉讼请求 。 

原告赵某某与被告张某某离婚纠纷一案一审民事判决书.txt	驳回 原告 赵 某某 的 诉讼请求 。 

原告赵某某与被告柳某甲离婚纠纷一案一审民事判决书.txt	驳回 原告 的 诉讼请求 。 

原告赵某某与被告田某离婚纠纷一案一审民事判决书.txt	驳回 原告 赵 某某 的 诉讼请求 。 

原告赵某某与被告蒲某甲离婚纠纷一案一审民事判决书.txt	驳回 原告 赵 某某 的 诉讼请求 。 

原告赵某某与被告黄某某离婚纠纷一案一审民事判决书.txt	驳回 原告 赵 某某 的 诉讼请求 。 

原告赵某甲与被告母某离婚纠纷一案一审民事判决书.txt	驳回 原告 赵某 甲 的 诉讼请求 。 

原告邓某某诉被告周某某离婚纠纷一案一审民事判决书.txt	驳回 原告 邓 某某 的 诉讼请求 。 

原告邓某某诉被告宋某某离婚纠纷一案一审民事判决书.txt	驳回 原告 邓 某某 要求 与 被告 宋 某某 离婚 的 诉讼请求 。 

原告邱某某诉被告于某甲离婚纠纷一审民事判决书.txt	驳回 原告 邱 某某 的 诉讼请求 。 

原告郑某某与被告张某甲离婚纠纷一案一审民事判决书.txt	驳回 原告 郑某 甲 的 诉讼请求 。 

原告钱某诉被告秦某离婚纠纷一案民事判决书.txt	驳回 原告 钱某 的 诉讼请求 。 

原告闫某某诉被告谢某某离婚纠纷一案一审民事判决书.txt	驳回 原告 闫 某某 要求 与 被告 谢 某某 离婚 的 诉讼请求 。 

原告阳某某与被告马某某离婚纠纷一案一审民事判决书.txt	驳回 原告 阳 某某 的 诉讼请求 。 

原告陈某某与被告张某某离婚纠纷一案一审民事判决书.txt	驳回 原告 陈 某某 的 诉讼请求 。 

原告陈某某诉被告李某某离婚纠纷一案一审民事判决书.txt	驳回 原告 陈 某某 要求 与 被告 李 某某 离婚 的 诉讼请求 。 

原告陈某某诉被告江某某离婚后财产纠纷案一审民事判决书.txt	驳回 原告 陈 某某 的 诉讼请求 。 

原告陈某诉被告姜某甲离婚纠纷一案一审民事判决书.txt	驳回 原告 陈某 的 诉讼请求 。 

原告陈某诉被告龙某甲离婚纠纷一案一审民事判决书.txt	驳回 原告 陈某 的 诉讼请求 。 

原告雍某某与被告汪某某离婚纠纷一案一审民事判决书.txt	驳回 原告 雍 某某 的 诉讼请求 。 

原告韩某甲诉被告刘某某离婚纠纷一审民事判决书.txt	驳回 原告 韩某 甲 的 诉讼请求 。 

原告马某某与被告伏某某离婚纠纷一案一审民事判决书.txt	驳回 原告 马 某某 的 诉讼请求 。 

原告马某某与被告杨某某离婚纠纷一案一审民事判决书.txt	驳回 原告 马 某某 的 诉讼请求 。 

原告黄某某与被告邱某某离婚纠纷一案一审民事判决书.txt	驳回 原告 黄 某某 的 诉讼请求 。 

原告黄某某诉被告何某甲离婚纠纷一案一审民事判决书.txt	驳回 原告 黄 某某 的 诉讼请求 。 

叶某某与廖某某离婚纠纷案一审民事判决书.txt	驳回 原告 叶 某某 要求 与 被告 廖 某某 离婚 的 诉讼请求 。 

向某与陈某离婚纠纷一审民事判决书.txt	驳回 原告 向 某 的 诉讼请求 。 

向某某与杨某某离婚纠纷一审民事判决书.txt	驳回 原告 向 某某 的 诉讼请求 。 

吕某与刘某甲离婚纠纷一审民事判决书.txt	驳回 原告 吕某 的 诉讼请求 。 

吕某某与刘某某离婚纠纷一审民事判决书.txt	驳回 原告 吕 某某 的 离婚 诉讼请求 ， 不准 离婚 。 

吴某与朱某甲离婚纠纷一审民事判决书.txt	驳回 原告 吴某 的 诉讼请求 。 

周小慧与胡勇军离婚纠纷一审民事判决书.txt	驳回 原告 周 某某 的 离婚 诉讼请求 。 

周某与唐某甲离婚纠纷一审民事判决书.txt	驳回 原告 周某 的 诉讼请求 。 

周某与曾某离婚纠纷一审民事判决书.txt	驳回 原告 周某 的 诉讼请求 。 

周某与胡某华离婚纠纷一审民事判决书.txt	驳回 原告 周某 的 诉讼请求 。 

周某某与张某某离婚纠纷一审民事判决书.txt	驳回 原告 周 某某 的 离婚 诉讼请求 。 

周某某诉张某甲离婚纠纷一案一审民事判决书.txt	驳回 原告 周 某某 的 诉讼请求 。 

周某某诉彭甲离婚纠纷一案一审民事判决书.txt	驳回 原告 周 某某 的 诉讼请求 。 

唐妹秀与韦小平离婚纠纷一审民事判决书.txt	驳回 原告 唐 某某 对 被告 韦 某某 的 离婚 诉讼请求 。 

唐某与被告杨某离婚纠纷一审民事判决书.txt	驳回 原告 唐某 要求 与 被告 杨某 离婚 的 诉讼请求 。 

唐某某与何某某离婚纠纷一审民事判决书.txt	驳回 原告 唐 某某 的 诉讼请求 。 

唐某某与卿某某离婚纠纷案一审民事判决书.txt	驳回 唐 某某 要求 与 卿 某某 离婚 的 诉讼请求 。 

唐某某与周某甲离婚纠纷一审民事判决书.txt	驳回 原告 唐 某某 要求 与 被告 周某 甲 离婚 的 诉讼请求 。 

唐某某与安某某离婚纠纷案一审民事判决书.txt	驳回 原告 唐 某某 与 被告 安 某某 离婚 的 诉讼请求 。 

唐某某与张某某离婚纠纷案一审民事判决书.txt	驳回 原告 唐 某某 要求 与 被告 张 某某 离婚 的 诉讼请求 。 

唐某某与张某离婚纠纷案一审民事判决书.txt	驳回 唐 某某 要求 与 张某 离婚 的 诉讼请求 。 

唐某某与邓某甲离婚纠纷一审民事判决书.txt	驳回 原告 唐 某某 要求 与 被告 邓某 甲 离婚 的 诉讼请求 。 

唐某甲诉赵某某离婚纠纷一审民事判决书.txt	驳回 原告 唐某 甲 的 诉讼请求 。 

唐某诉欧某某离婚纠纷一审民事判决书.txt	驳回 原告 唐某 要求 与 被告 欧 某某 离婚 的 诉讼请求 。 

喻某某与杨某某离婚纠纷一审民事判决书.txt	驳回 原告 喻 某某 要求 与 被告 杨 某某 离婚 的 诉讼请求 。 

夏某某与刘某甲离婚纠纷一审民事判决书.txt	驳回 原告 夏 某某 的 诉讼请求 。 

奂某某与杨某某离婚纠纷一审民事判决书.txt	驳回 原告 奂 某某 的 诉讼请求 。 

孙利君与胡光军离婚一审民事判决书.txt	驳回 原告 孙 某某 对 被告 利胡 某某 的 离婚 诉讼请求 。 

宁某某与王某离婚纠纷案一审民事判决书.txt	驳回 宁 某某 要求 与 王某 离婚 的 诉讼请求 。 

宋某与李某甲离婚纠纷一审民事判决书.txt	驳回 原告 宋某 要求 与 被告 李某 甲 离婚 的 诉讼请求 。 

尧某与张某离婚纠纷一审民事判决书.txt	驳回 原告 尧 某 的 离婚 诉讼请求 。 

尹某与唐某甲离婚纠纷一审民事判决书.txt	驳回 原告 尹某 的 诉讼请求 。 

尹某与陈某离婚纠纷一审民事判决书.txt	驳回 原告 尹某 的 诉讼请求 。 

左某某与王某某离婚纠纷一审民事判决书.txt	驳回 原告 左 某某 的 诉讼请求 。 

巫映彩与蔡汶江离婚纠纷一审民事判决书.txt	一 、 驳回 原告 巫某 甲 要求 与 被告 蔡 某某 离婚 的 诉讼请求 ； 二 、 驳回 原告 的 其它 诉讼请求 。 

席某某与陈某某离婚纠纷一审民事判决书.txt	驳回 原告席 某某 的 离婚 诉讼请求 。 

庞某某诉于某某离婚纠纷一审民事判决书.txt	驳回 原告 庞 某某 的 诉讼请求 。 

廖某与李某离婚纠纷一审民事判决书.txt	驳回 原告 廖某 的 诉讼请求 。 

廖某某与胡某某离婚纠纷一审民事判决书.txt	驳回 原告 廖 某某 的 诉讼请求 。 

廖某某与陈某某离婚纠纷案一审民事判决书.txt	驳回 原告 廖 某某 要求 与 被告 陈 某某 离婚 的 诉讼请求 。 

张某与唐某某离婚纠纷案一审民事判决书.txt	驳回 原告 张某 要求 与 被告 就 唐 某某 离婚 的 诉讼请求 。 

张某与李某离婚纠纷一审民事判决书.txt	驳回 原告 张某 的 诉讼请求 。 

张某与陈某离婚纠纷一审民事判决书.txt	驳回 原告 张某 要求 与 被告 陈某 离婚 的 诉讼请求 。 

张某与黄某某离婚纠纷案一审民事判决书.txt	驳回 张某 要求 与 黄 某某 离婚 的 诉讼请求 。 

张某某与周某某离婚纠纷案一审民事判决书.txt	驳回 原告 张 某某 与 被告 周 某某 离婚 的 诉讼请求 。 

张某某与唐某某离婚纠纷一审民事判决书.txt	驳回 原告 张 某某 要求 与 被告 唐 某某 离婚 的 诉讼请求 。 

张某某与张某甲离婚纠纷一审民事判决书.txt	驳回 原告 张 某某 的 离婚 请求 。 

张某某与王某甲离婚纠纷一审民事判决书.txt	驳回 原告 张 某某 的 离婚 诉讼请求 。 

张某某与罗某某离婚纠纷一审民事判决书.txt	驳回 原告 张 某某 的 诉讼请求 。 

张某某与郭某某离婚纠纷一审民事判决书.txt	驳回 原告 诉讼请求 。 

张某某与颜某某离婚纠纷一审民事判决书.txt	驳回 原告 张 某某 的 离婚 请求 。 

张某某与黄某甲离婚纠纷一审民事判决书.txt	驳回 原告 张 某某 的 诉讼请求 。 

张某某诉吕某某离婚纠纷一审民事判决书.txt	驳回 原告 张 某某 的 诉讼请求 。 

张某某诉程某某离婚纠纷一审民事判决书.txt	驳回 原告 张 某某 的 诉讼请求 。 

张某某诉颜某某离婚纠纷一审民事判决书.txt	驳回 原告 张 某某 的 诉讼请求 。 

张某某诉龚某某离婚纠纷一审民事判决书.txt	驳回 原告 张 某某 的 诉讼请求 。 

张某甲与周某某离婚纠纷一审民事判决书.txt	驳回 原告 张某 甲 离婚 的 诉讼请求 。 

张某甲与江某某离婚纠纷一审民事判决书.txt	驳回 原告 张某 甲 的 离婚 诉讼请求 。 

张某甲与罗某某离婚纠纷一审民事判决书.txt	驳回 原告 张某 甲 的 诉讼请求 。 

张某甲与葛某甲离婚纠纷一审民事判决书.txt	驳回 原告 张某 甲 的 诉讼请求 。 

张某诉任某某离婚纠纷一审民事判决书.txt	驳回 原告 张某 的 诉讼请求 。 

张某诉杨某甲离婚纠纷一案一审民事判决书.txt	驳回 原告 张某 的 离婚 诉讼请求 。 

张英诉李志刚离婚纠纷一案一审民事判决书.txt	驳回 原告 张某 的 离婚 请求 。 

张莉与车晓辉离婚纠纷一审民事判决书.txt	驳回 原告 张某 的 诉讼请求 ； 

彭某某与赖某某离婚纠纷案一审民事判决书.txt	驳回 原告 彭 某某 要求 与 被告 赖 某某 离婚 的 诉讼请求 。 

徐某与马某离婚纠纷一审民事判决书.txt	驳回 原告 徐某 的 诉讼请求 。 

徐某某与刘某某离婚纠纷一审民事判决书.txt	驳回 原告 徐 某某 的 离婚 及其 他 诉讼请求 。 

徐某某与郝某某离婚纠纷一审民事判决书.txt	驳回 原告 徐 某某 的 离婚 诉讼请求 。 

戴某某与赖某某离婚纠纷案一审民事判决书.txt	驳回 戴 某某 要求 与 赖 某某 离婚 的 诉讼请求 。 

文某某与廖某某离婚纠纷案一审民事判决书.txt	驳回 原告 文 某某 要求 与 被告 廖 某某 离婚 的 诉讼请求 。 

文某某诉陈某离婚纠纷一审民事判决书.txt	驳回 原告 文 某某 要求 与 被告 陈某 离婚 的 诉讼请求 。 

文某甲与张某某离婚纠纷一审民事判决书.txt	驳回 原告 文某 甲 的 离婚 诉讼请求 。 

文某甲与滕某某离婚纠纷一审民事判决书.txt	驳回 原告 文某 甲 要求 与 被告 滕 某某 离婚 的 诉讼请求 。 

施某诉李某离婚纠纷一审民事判决书.txt	驳回 原告 施 某某 的 诉讼请求 。 

易某与廖某某离婚纠纷案一审民事判决书.txt	驳回 易某 要求 与 廖 某某 离婚 的 诉讼请求 。 

晏某星与李某川关于离婚纠纷一审民事判决书.txt	驳回 原告 晏某星 要求 与 被告 李某川 离婚 的 诉讼请求 。 

曹某某与陈某某离婚纠纷一审民事判决书.txt	驳回 原告 曹 某某 要求 与 被告 陈 某某 离婚 的 诉讼请求 。 

曾某与袁某离婚纠纷一审民事判决书.txt	驳回 原告 曾某 要求 与 被告 袁某 甲 离婚 的 诉讼请求 。 

曾某某与徐某某离婚纠纷一审民事书.txt	驳回 原告 曾 某某 要求 与 被告 徐 某某 离婚 的 诉讼请求 。 

朱某与刘某离婚纠纷一审民事判决书.txt	驳回 原告 朱某 的 诉讼请求 。 

朱某某与余某某离婚纠纷一审民事判决书.txt	驳回 原告 朱 某某 的 诉讼请求 。 

朱某某与黄某某离婚纠纷一审民事判决书.txt	驳回 原告 朱 某某 的 诉讼请求 。 

朱某某诉张某某离婚纠纷一审判决书.txt	驳回 原告 朱 某某 的 诉讼请求 。 

李某与刘某关于离婚纠纷一审民事判决书.txt	驳回 原告 李某 要求 与 被告 刘某 离婚 的 诉讼请求 。 

李某与安某离婚纠纷案一审民事判决书.txt	驳回 原告 李某 要求 与 被告 安某 离婚 的 诉讼请求 。 

李某与曾某甲离婚纠纷一审民事判决书.txt	驳回 原告 李某 的 诉讼请求 。 

李某与杨某离婚纠纷一审民事判决书.txt	驳回 原告 李某 要求 与 被告 杨某 离婚 的 诉讼请求 。 

李某某与严某某离婚纠纷案一审民事判决书.txt	驳回 原告 李 某某 要求 与 被告 严 某某 离婚 的 诉讼请求 。 

李某某与彭某某离婚纠纷一审民事判决书.txt	驳回 原告 李 某某 的 离婚 诉讼请求 。 

李某某与杨某甲离婚纠纷一审民事判决书.txt	驳回 原告 李某 甲 的 诉讼请求 。 

李某某与杨某离婚纠纷案一审民事判决书.txt	驳回 李 某某 要求 与 杨某 离婚 的 诉讼请求 。 

李某某与林某甲离婚纠纷一审民事判决书.txt	驳回 原告 李 某某 离婚 的 诉讼请求 。 

李某某与潘某某离婚纠纷一审民事判决书.txt	驳回 原告 李 某某 的 离婚 诉讼请求 。 

李某某与祝某某离婚纠纷一审民事判决书.txt	驳回 原告 李 某某 的 诉讼请求 。 

李某某与贺某甲离婚纠纷一审民事判决书.txt	驳回 原告 李 某某 要求 与 被告 贺某 甲 离婚 的 诉讼请求 。 

李某某与陈某某离婚纠纷一审民事判决书.txt	驳回 原告 李 某某 的 全部 诉讼请求 。 

李某某诉刘某某离婚纠纷一审民事判决书.txt	驳回 原告 李 某某 的 诉讼请求 。 

李某某诉吉某某离婚纠纷一审民事判决书.txt	驳回 原告 李 某某 的 诉讼请求 。 

李某某诉张某某离婚纠纷一审民事判决书.txt	驳回 原告 李 某某 的 诉讼请求 。 

李某某诉王某甲离婚纠纷一审民事判决书.txt	驳回 原告 李 某某 的 诉讼请求 。 

李某甲与梁某某离婚纠纷一审民事判决书.txt	驳回 原告 李某 甲 要求 与 被告 梁 某某 离婚 的 诉讼请求 。 

杜某某与李某某离婚纠纷案一审民事判决书.txt	原告 杜 某某 与 被告 李 某某 离婚 。 驳回 原告 杜 某某 的 其他 诉讼请求 。 

杜某某与龚某某离婚纠纷案一审民事判决书.txt	驳回 原告 杜 某某 要求 与 被告 龚 某某 离婚 的 诉讼请求 。 

杜某诉蒋某离婚纠纷一审民事判决书.txt	驳回 原告 杜某 要求 与 被告 蒋某 离婚 的 诉讼请求 。 

杨某与卓某甲离婚纠纷一审民事判决书.txt	驳回 原告 杨某 的 诉讼请求 。 

杨某与唐某离婚纠纷一审民事判决书.txt	驳回 原告 杨某 的 诉讼请求 。 

杨某与程某甲离婚纠纷一审民事判决书.txt	驳回 原告 杨某 的 诉讼请求 。 

杨某与罗某甲离婚纠纷一审民事判决书.txt	驳回 原告 杨某 的 诉讼请求 。 

杨某某与何某某离婚纠纷案一审民事判决书.txt	驳回 原告 杨 某某 要求 与 被告 何 某某 离婚 的 诉讼请求 。 

杨某某与吕某离婚纠纷案一审民事判决书.txt	驳回 原告 杨 某某 要求 与 被告 吕某 离婚 的 诉讼请求 。 

杨某某与吴某某离婚纠纷一审民事判决书.txt	驳回 原告 杨 某某 的 诉讼请求 。 

杨某某与唐某某离婚纠纷一审民事判决书.txt	准予 原告 杨 某某 与 被告 唐 某某 离婚 。 驳回 原告 杨 某某 的 其他 诉讼请求 。 

杨某某与张某乙离婚纠纷一审民事判决书.txt	驳回 原告 杨 某某 要求 与 被告 张 某某 离婚 的 诉讼请求 。 

杨某某与张某离婚纠纷案一审民事判决书.txt	驳回 杨 某某 要求 与 张某 离婚 的 诉讼请求 。 

杨某某与王某某离婚纠纷案一审民事判决书.txt	驳回 杨 某某 要求 与 王 某某 离婚 的 诉讼请求 。 

杨某某与谢某某离婚纠纷一审民事判决书.txt	驳回 原告 杨 某某 的 离婚 诉讼请求 。 

杨某某与银某某离婚纠纷案一审民事判决书.txt	驳回 原告 杨 某某 与 被告 银 某某 离婚 的 诉讼请求 。 

杨某某诉熊某某离婚纠纷一审民事判决书.txt	驳回 原告 杨 某某 要求 与 被告 熊 某某 离婚 的 诉讼请求 。 

杨某某诉胡某某离婚纠纷一审民事判决书.txt	驳回 原告 杨 某某 的 诉讼请求 。 

杨某诉肖甲离婚纠纷一案一审民事判决书.txt	驳回 原告 杨某 的 诉讼请求 。 

林某某与王某甲离婚纠纷一审民事判决书.txt	驳回 原告 林 某某 的 离婚 诉讼请求 。 

林某某与陈某甲离婚纠纷一审民事判决书.txt	驳回 原告 林 某某 的 诉讼请求 。 

柏某甲与胡某甲离婚纠纷一审民事判决书.txt	驳回 原告 柏某 甲 的 诉讼请求 。 

柳某某诉贺某某离婚纠纷一审民事判决书.txt	驳回 原告 柳 某某 要求 与 被告 贺 某某 离婚 的 诉讼请求 。 

梁某某与张某某离婚纠纷一审民事判决书.txt	驳回 原告 梁 某某 的 诉讼请求 。 

梁某某与罗某某离婚纠纷一审民事判决书.txt	驳回 原告 梁 某某 的 诉讼请求 。 

欧中凯诉祝枝玉离婚纠纷一审民事判决书.txt	驳回 原告 欧 某某 的 离婚 请求 。 

欧某某与李某某离婚纠纷案一审民事判决书.txt	驳回 原告 欧 某某 与 被告 李 某某 离婚 的 诉讼请求 。 

欧某某与杨某某离婚纠纷一审民事判决书.txt	驳回 原告 欧 某某 要求 与 被告 杨 某某 离婚 的 诉讼请求 。 

欧某甲与刘某某离婚纠纷一审民事判决书.txt	驳回 原告 欧某 甲 的 诉讼请求 。 

武某甲与卢某某离婚纠纷一审民事判决书.txt	驳回 原告 武某 甲 的 诉讼请求 。 

段某某诉刘某甲离婚纠纷一案一审民事判决书.txt	驳回 原告 段 某某 的 诉讼请求 。 

汪某与李某甲离婚纠纷一审民事判决书.txt	驳回 原告 汪某 的 诉讼请求 。 

沈某某诉黄某甲离婚纠纷一审民事判决书.txt	驳回 原告 沈 某某 的 诉讼请求 。 

涂某某诉曹某某离婚纠纷一审民事判决书.txt	驳回 原告 涂 某某 的 诉讼请求 。 

熊某与何某甲离婚纠纷一审民事判决书.txt	驳回 原告 熊某 的 诉讼请求 。 

熊某某与杨某某离婚纠纷案一审民事判决书.txt	驳回 原告 熊 某某 要求 与 被告 杨 某某 离婚 的 诉讼请求 。 

王勇与何花离婚纠纷一案民事判决书.txt	驳回 原告 王勇 要求 与 被告 何花 离婚 的 诉讼请求 。 

王小芹与罗举康离婚纠纷一审民事判决书.txt	驳回 原告 王 某某 的 离婚 诉讼请求 。 

王某与何某离婚纠纷一审民事判决书.txt	驳回 原告 王某 的 诉讼请求 。 

王某与张某某离婚纠纷一案民事判决书.txt	驳回 原告 王某 的 离婚 诉讼请求 。 

王某与彭某甲离婚纠纷一审民事判决书.txt	驳回 原告 王某 的 诉讼请求 。 

王某与杨某离婚纠纷一审民事判决书.txt	驳回 原告 王某 的 诉讼请求 。 

王某与罗某甲离婚纠纷一审民事判决书.txt	驳回 原告 王某 的 诉讼请求 。 

王某某与杨某甲离婚纠纷一审民事判决书.txt	驳回 原告 王 某某 的 诉讼请求 。 

王某某与胡某甲离婚纠纷一审民事判决书.txt	驳回 原告 王 某某 的 离婚 诉讼请求 。 

王某某与谢某某离婚纠纷案一审民事判决书.txt	驳回 原告 王 某某 与 被告 谢 某某 离婚 的 诉讼请求 。 

王某某与陈某某离婚纠纷一审民事判决书.txt	驳回 原告 王 某某 的 离婚 诉请 。 

王某某与陈某某离婚纠纷案一审民事判决书.txt	驳回 原告 王 某某 要求 与 被告 陈 某某 离婚 的 诉讼请求 。 

王某某诉谭某甲离婚纠纷一审民事判决书.txt	驳回 原告 王 某某 的 诉讼请求 。 

王某某诉魏某甲离婚纠纷一审民事判决书.txt	驳回 原告 王 某某 的 诉讼请求 。 

王某甲与被告王某乙离婚纠纷一审民事判决书.txt	驳回 原告 王某 甲 的 诉讼请求 。 

王某甲诉刘某甲离婚纠纷一审民事判决书.txt	驳回 原告 王某 甲 的 诉讼请求 。 

王某诉杜某离婚纠纷一审民事判决书.txt	驳回 原告 王某 的 诉讼请求 。 

王美诉何波离婚纠纷一审民事判决书.txt	驳回 原告 王某 的 诉讼请求 。 

田某某与彭某离婚纠纷一审民事判决书.txt	驳回 原告 田 某某 的 诉讼请求 。 

申某与许某甲离婚纠纷一审民事判决书.txt	驳回 原告 申某 的 诉讼请求 。 

白某某与周某某离婚纠纷一审民事判决书.txt	驳回 原告 白 某某 的 诉讼请求 。 

石某与刘某甲离婚纠纷一审民事判决书.txt	驳回 原告 石某 的 诉讼请求 。 

程某某与杨某甲离婚纠纷一审民事判决书.txt	驳回 原告 程 某某 的 诉讼请求 。 

罗俭英与张文友离婚纠纷一审民事判决书.txt	驳回 原告 罗 某某 对 被告 张 某某 的 离婚 诉讼请求 。 

罗某与刘某甲离婚纠纷一审民事判决书.txt	驳回 原告 罗某 的 诉讼请求 。 

罗某与杨某某离婚纠纷一案一审民事判决书.txt	驳回 原告 罗某 的 离婚 请求 。 

罗某某诉曹某某离婚纠纷一审民事判决书.txt	驳回 原告 罗 某某 的 诉讼请求 。 

翟某某与刘某某离婚纠纷一审民事判决书.txt	驳回 原告 翟 某某 的 诉讼请求 。 

耿某某诉赵某某离婚纠纷一审民事判决书.txt	驳回 原告 耿 某某 的 诉讼请求 。 

肖某与刘某甲离婚纠纷一审民事判决书.txt	驳回 原告 肖某 诉讼请求 。 

肖某与尹某甲离婚纠纷一审民事判决书.txt	驳回 原告 肖某 的 诉讼请求 。 

肖某与朱某甲离婚纠纷一审民事判决书.txt	驳回 原告 肖某 诉讼请求 。 

肖某某与敬某某离婚纠纷一案一审民事判决书.txt	驳回 原告 肖 某某 的 离婚 请求 。 

肖某甲诉文某甲离婚纠纷一案民事一审判决书.txt	驳回 原告 肖某 甲 的 诉讼请求 。 

胡某与唐某某离婚纠纷一审民事判决书.txt	驳回 原告 胡某 要求 与 被告 唐 某某 离婚 的 诉讼请求 。 

胡某与辛某甲离婚纠纷一审民事判决书.txt	驳回 原告 胡某 的 诉讼请求 。 

胡某某与唐某某离婚纠纷一审民事判决书.txt	驳回 原告 胡 某某 的 诉讼请求 。 

胡某某与潘某离婚纠纷一审民事判决书.txt	驳回 原告 胡 某某 要求 与 被告 潘某 离婚 的 诉讼请求 。 

胡某某与袁某某离婚纠纷一审民事判决书.txt	驳回 原告 胡 某某 的 诉讼请求 。 

胡某某与陈某某离婚纠纷一审民事判决书.txt	驳回 原告 胡某 甲 的 诉讼请求 。 

胡某某与陈某某离婚纠纷案一审民事判决书.txt	驳回 胡 某某 要求 与 陈 某某 离婚 的 诉讼请求 。 

胥某某诉李某某离婚纠纷一审民事判决书.txt	驳回 原告 胥 某某 的 诉讼请求 。 

胥某某诉杜某某离婚纠纷一审民事判决书.txt	驳回 原告 胥 某某 的 诉讼请求 。 

舒某与尹某离婚纠纷一审民事判决书.txt	驳回 原告 舒某 的 诉讼请求 。 

苏某与江某甲离婚纠纷一审民事判决书.txt	驳回 原告 苏某 诉讼请求 。 

苟某某诉李某某离婚纠纷一案民事判决书.txt	驳回 原告 苟 某某 的 离婚 诉讼请求 。 

董某某与彭某甲离婚纠纷一审民事判决书.txt	驳回 原告 董 某某 的 诉讼请求 。 

董某某与陆某某离婚纠纷一审民事判决书.txt	驳回 原告 董 某某 的 诉讼请求 。 

蒋某与王某离婚纠纷一审民事判决书.txt	驳回 原告 蒋某 的 诉讼请求 。 

蒋某某与修某某离婚纠纷一审民事判决书.txt	驳回 原告 蒋 某某 的 离婚 诉讼请求 。 

蒋某某与刘某离婚纠纷一审民事判决书.txt	驳回 原告 蒋某 甲 要求 与 被告 刘某 离婚 的 诉讼请求 。 

蒋某某与汪某某离婚纠纷案一审民事判决书.txt	驳回 蒋 某某 要求 与 汪 某某 离婚 的 诉讼请求 。 

蒋某某与黄某某离婚纠纷一审民事判决书.txt	驳回 原告 蒋 某某 要求 与 被告 黄 某某 离婚 的 诉讼请求 。 

蒙某某诉李某离婚纠纷一审民事判决书.txt	驳回 原告 蒙 某某 的 诉讼请求 ； 

蓝某某与张某甲离婚纠纷一审民事判决书.txt	驳回 原告 蓝 某某 的 诉讼请求 。 

蔡某甲与查某离婚纠纷一审民事判决书.txt	驳回 原告 蔡某 甲 的 诉讼请求 。 

袁某与肖某离婚纠纷一审民事判决书.txt	驳回 原告 袁某 的 诉讼请求 。 

袁某诉胥某某离婚纠纷一审民事判决书.txt	驳回 原告 袁某 的 诉讼请求 。 

裴某某与周某某离婚纠纷案一审民事判决书.txt	驳回 原告 裴 某某 要求 与 周 某某 离婚 的 诉讼请求 。 

谢某某与刘某某离婚纠纷案一审民事判决书.txt	驳回 原告 谢 某某 要求 与 被告 刘 某某 离婚 的 诉讼请求 。 

谢某某与姜某某离婚纠纷一审民事判决书.txt	驳回 原告 谢 某某 的 诉讼请求 。 

谢某某与张某甲离婚纠纷一审民事判决书.txt	驳回 原告 谢 某某 的 诉讼请求 。 

谢某某与聂某离婚纠纷一审民事判决书.txt	驳回 原告 谢 某某 的 诉讼请求 。 

贵金存与曹晋元离婚纠纷一审民事判决书.txt	一 、 驳回 原告 贵 某某 要求 与 被告 曹 某某 离婚 的 诉讼请求 ； 二 、 驳回 原告 的 其它 诉讼请求 。 

贾某诉李某离婚纠纷一审民事判决书.txt	驳回 原告 贾某 的 诉讼请求 。 

赵某甲与被告赵某乙离婚纠纷一审民事判决书.txt	驳回 原告 赵某 甲 的 诉讼请求 。 

路某某与吴某某离婚纠纷案一审民事判决书.txt	驳回 原告 路 某某 与 被告 吴 某某 离婚 的 诉讼请求 。 

邓某与张某甲离婚纠纷一审民事判决书.txt	驳回 原告 邓某 诉讼请求 。 

邓某与李某离婚纠纷一审民事判决书.txt	驳回 原告 邓某 的 诉讼请求 。 

邓某某与黄某甲离婚纠纷一审民事判决书.txt	驳回 原告 邓 某某 的 诉讼请求 。 

邓某甲与许某甲离婚纠纷一审民事判决书.txt	驳回 原告 邓某 甲 要求 与 被告 许某 甲 离婚 的 诉讼请求 。 

邓某甲与马某某离婚纠纷一审民事判决书.txt	驳回 原告 邓某 甲 要求 与 被告 马 某某 离婚 的 诉讼请求 。 

郭某某与李某某离婚纠纷案一审民事判决书.txt	驳回 原告 郭 某某 要求 与 被告 李 某某 离婚 的 诉讼请求 。 

郭某某与罗某某离婚纠纷一案民事判决书.txt	驳回 原告 郭 某某 的 诉讼请求 。 

郭某某与黄某某离婚纠纷一审民事判决书.txt	驳回 原告 陈 某某 的 诉讼请求 。 

郭某甲与刘某某离婚纠纷一案一审民事判决书.txt	驳回 原告 郭某 甲 要求 与 被告 刘 某某 离婚 的 诉讼请求 。 

郭某甲与林某某离婚纠纷一审民事判决书.txt	驳回 原告 郭某 甲 的 诉讼请求 。 

金某某与代某甲离婚纠纷一审民事判决书.txt	驳回 原告 金 某某 的 诉讼请求 。 

陈某与曾某某离婚纠纷案一审民事判决书.txt	驳回 陈某 要求 与 曾 某某 离婚 的 诉讼请求 。 

陈某与朱某甲离婚纠纷一审民事判决书.txt	驳回 原告 陈某 的 诉讼请求 。 

陈某与王某离婚纠纷一审民事判决书.txt	驳回 原告 陈某 的 诉讼请求 ； 

陈某某与冯某某离婚纠纷一审民事判决书.txt	驳回 原告 陈 某某 要求 与 被告 冯 某某 离婚 的 诉讼请求 。 

陈某某与岳某某离婚纠纷案一审民事判决书.txt	驳回 原告 陈 某某 要求 与 被告 岳 某某 离婚 的 诉讼请求 。 

陈某某与康某某离婚纠纷一审民事判决书.txt	驳回 陈 某某 的 诉讼请求 。 

陈某某与杨某甲离婚纠纷案一审民事判决书.txt	驳回 原告 陈 某某 与 被告 杨某 甲 离婚 的 诉讼请求 。 

陈某某与秦某某离婚纠纷案一审民事判决书.txt	驳回 原告 陈 某某 要求 与 被告 秦 某某 离婚 的 诉讼请求 。 

陈某某与蒲某某离婚纠纷案一审民事判决书.txt	驳回 原告 陈 某某 要求 与 被告 蒲 某某 离婚 的 诉讼请求 。 

陈某某与郝某某离婚纠纷一审民事判决书.txt	驳回 原告 陈 某某 的 诉讼请求 。 

陈某甲与刘某甲离婚纠纷一审民事判决书.txt	驳回 原告 陈某 甲 的 诉讼请求 。 

陈某甲与周某某离婚纠纷一审民事判决书.txt	驳回 原告 陈某 甲 离婚 的 诉讼请求 。 

陈某甲与陈某离婚纠纷一审民事判决书.txt	驳回 原告 陈某 甲 的 诉讼请求 。 

陈某诉张某某离婚纠纷一案一审民事判决书.txt	驳回 原告 陈某 的 诉讼请求 。 

陈某诉梁某某离婚纠纷一审民事判决书.txt	驳回 原告 陈某 的 诉讼请求 。 

陶传琼与王良光离婚纠纷一审民事判决书.txt	驳回 原告 陶 某某 的 离婚 诉讼请求 。 

雍某与何某离婚纠纷一审民事判决书.txt	驳回 原告 雍某 要求 与 被告 何某 离婚 的 诉讼请求 。 

靳某某与闫某某离婚纠纷一审民事判决书.txt	驳回 原告 靳 某某 的 诉讼请求 。 

韩某某诉李某某离婚纠纷一审民事判决书.txt	驳回 原告 韩 某某 要求 与 被告 李 某某 离婚 的 诉讼请求 。 

马某某与刘某某离婚纠纷一审民事判决书.txt	驳回 原告 马 某某 的 离婚 请求 。 

马某某与周某离婚纠纷一案民事判决书.txt	驳回 原告 马 某某 的 诉讼请求 。 

马某某与汤某某离婚纠纷一审民事判决书.txt	驳回 原告 马 某某 的 诉讼请求 。 

魏某诉林某某离婚纠纷民事判决书.txt	驳回 原告 魏某 的 离婚 诉讼请求 。 

鲁某某诉邱某某离婚一审民事判决书.txt	驳回 原告 鲁 某某 的 诉讼请求 。 

鲜群碧与兰建元离婚纠纷一审民事判决书.txt	驳回 原告 鲜 某某 的 离婚 诉讼请求 。 

黄某与陈某离婚纠纷一审民事判决书.txt	驳回 原告 黄某 的 诉讼请求 。 

黄某某与曾某某离婚纠纷案一审民事判决书.txt	驳回 原告 黄 某某 要求 与 被告 就 曾 某某 离婚 的 诉讼请求 。 

黄某某与李某某离婚纠纷案一审民事判决书.txt	驳回 黄 某某 要求 与 李 某某 离婚 的 诉讼请求 。 

黄某甲与徐某某离婚纠纷一审民事判决书.txt	驳回 原告 黄某 甲 要求 与 被告 徐 某某 离婚 的 诉讼请求 。 

黄某甲与曾某离婚纠纷一审民事判决书.txt	驳回 原告 黄某 甲 的 诉讼请求 。 

黄某甲诉赵某某离婚纠纷一审民事判决书.txt	驳回 原告 黄某 甲 的 诉讼请求 。 

龚某某与孙某某离婚纠纷一审民事判决书.txt	驳回 原告 龚 某某 的 离婚 请求 ； 
