万某某与陈某某离婚纠纷一审民事裁定书.txt	据此 ， 依照 《 中华人民共和国 民事 诉讼法 》 第十三条 第二款 、 第 一百四十 五条 第一款 、 第一百五十四条 第一款 （ 五 ） 项之 规定 ， 裁定 如下 ： 

严某某与郭某某离婚纠纷一审民事裁定书.txt	依照 《 中华人民共和国 民事 诉讼法 》 第 一百四十 五条 第一款 、 第一百五十四条 第一款 第 （ 五 ） 项之 规定 ， 裁定 如下 ： 

严某某与韩某某离婚纠纷一审民事裁定书.txt	依照 《 中华人民共和国 民事 诉讼法 》 第 一百四十 五条 第一款 、 第一百五十四条 第一款 第 （ 五 ） 项 的 规定 ， 裁定 如下 ： 

于某与郭某离婚纠纷一审民事裁定书.txt	依照 《 中华人民共和国 民事 诉讼法 》 第 一百四十 五条 第一款 、 第一百五十四条 第一款 第 （ 五 ） 项之 规定 ， 裁定 如下 ： 

付某某与曾某某离婚纠纷一审民事裁定书.txt	据此 ， 依照 《 中华人民共和国 民事 诉讼法 》 第 一百四十 五条 第一款 、 第一百五十四条 第一款 （ 五 ） 项之 规定 ， 裁定 如下 ： 

代某某与朱某某离婚纠纷一审民事裁定书.txt	依照 《 中华人民共和国 民事 诉讼法 》 一百四十 五条 第一款 、 一百五十 四条 第一款 第 （ 五 ） 项之 规定 ， 裁定 如下 ： 

但某某与王某某离婚纠纷一审民事裁定书.txt	依照 《 中华人民共和国 民事 诉讼法 》 一百四十 五条 第一款 、 一百五十 四条 第一款 第 （ 五 ） 项之 规定 ， 裁定 如下 ： 

何某某与加某某离婚纠纷一审民事裁定书.txt	依照 《 中华人民共和国 民事 诉讼法 》 第 一百四十 五条 、 第一百五十四条 第一款 第 （ 五 ） 项之 规定 ， 裁定 如下 ： 

何某某与唐某某离婚纠纷一审民事裁定书.txt	依照 《 中华人民共和国 民事 诉讼法 》 第 一百四十 五条 、 第一百五十四条 第一款 第 （ 五 ） 项之 规定 ， 裁定 如下 ： 

何某某与张某某 离婚纠纷一审民事裁定书.txt	依照 《 中华人民共和国 民事 诉讼法 》 第 一百四十 五条 第一款 、 第一百五十四条 第一款 第 （ 五 ） 项 的 规定 ， 裁定 如下 ： 

何某某与张某某离婚纠纷一审民事裁定书.txt	依照 《 中华人民共和国 民事 诉讼法 》 第 一百四十 五条 第一款 、 第一百五十四条 第一款 第 （ 五 ） 项之 规定 ， 裁定 如下 ： 

何某某与王某某离婚纠纷一审民事裁定书.txt	依照 《 中华人民共和国 民事 诉讼法 》 第 一百四十 五条 、 第一百五十四条 第一款 （ 五 ） 项 的 规定 ， 裁定 如下 ： 

何某某与郭某某离婚纠纷案一审民事裁定书.txt	依照 《 中华人民共和国 民事 诉讼法 》 第 一百四十 五条 第一款 、 第一百五十四条 第一款 第 （ 五 ） 项之 规定 ， 裁定 如下 ： 

余万琼诉周付平离婚纠纷案一审民事裁定书.txt	依照 《 中华人民共和国 民事 诉讼法 》 第十三条 第二款 、 第 一百四十 五条 第一款 、 第一百五十四条 第 （ 五 ） 项之 规定 ， 裁定 如下 ： 

余某某与李某某离婚纠纷案一审民事裁定书.txt	依照 《 中华人民共和国 民事 诉讼法 》 第 一百四十 五条 、 第一百五十四条 第一款 （ 五 ） 项之 规定 ， 裁定 如下 ： 

余某某与潘某某离婚纠纷一审民事裁定书.txt	依照 《 中华人民共和国 民事 诉讼法 》 第 一百四十 五条 第一款 、 第一百五十四条 第一款 第 （ 五 ） 项之 规定 ， 裁定 如下 ： 

党某某与王某某离婚纠纷一审民事裁定书.txt	依照 《 中华人民共和国 民事 诉讼法 》 第 一百四十 五条 第一款 、 第一百五十四条 第一款 第 （ 五 ） 项之 规定 ， 裁定 如下 ： 

全某伟与邓某莉关于离婚纠纷一审民事裁定书.txt	依照 《 中华人民共和国 民事 诉讼法 》 第十三条 第二款 、 第 一百四十 五条 第一款 、 第一百五十四条 第 （ 五 ） 项之 规定 ， 裁定 如下 ： 

兰某某与刘某某离婚纠纷一审民事裁定书.txt	依照 《 中华人民共和国 民事 诉讼法 》 第 一百四十 五条 第一款 、 第一百五十四条 第一款 第 （ 五 ） 项 的 规定 ， 裁定 如下 ： 

冯某某与牟某某离婚纠纷一审民事裁定书.txt	依照 《 中华人民共和国 民事 诉讼法 》 第 一百四十 五条 第一款 、 第一百五十四条 第 （ 五 ） 项之 规定 ， 裁定 如下 ： 

冯某诉唐某某离婚纠纷一审民事裁定书.txt	依照 《 中华人民共和国 民事 诉讼法 》 第一百五十四条 第一款 （ 五 ） 项之 规定 ， 裁定 如下 ： 

刘宜福与被告刘发清离婚纠纷民事一审民事裁定书.txt	依照 《 中华人民共和国 民事 诉讼法 》 第十三条 第二款 、 第 一百四十 五条 、 第一百五十四条 第一款 第 （ 五 ） 项 的 规定 ， 裁定 如下 ： 

刘某与周某某离婚纠纷一审民事裁定书.txt	依照 《 中华人民共和国 民事 诉讼法 》 第 一百四十 五条 第一款 、 第一百五十四条 第一款 第 （ 五 ） 项之 规定 ， 裁定 如下 ： 

刘某与张某某离婚纠纷案一审民事裁定书.txt	依照 《 中华人民共和国 民事 诉讼法 》 第 一百四十 五条 、 第一百五十四条 的 规定 ， 裁定 如下 ： 

刘某与黄某某离婚纠纷一审民事裁定书.txt	依照 《 中华人民共和国 民事 诉讼法 》 第一百五十四条 第一款 第 （ 五 ） 项之 规定 ， 裁定 如下 ： 

刘某某与何某离婚纠纷一审民事裁定书.txt	依照 《 中华人民共和国 民事 诉讼法 》 第一百五十四条 第一款 第 （ 五 ） 项之 规定 ， 裁定 如下 ： 

刘某某与张某离婚纠纷案一审民事裁定书.txt	依照 《 中华人民共和国 民事 诉讼法 》 第 一百四十 五条 第一款 、 第一百五十四条 第一款 第 （ 五 ） 项之 规定 ， 裁定 如下 ： 

刘某某与曹某离婚纠纷一审民事裁定书.txt	依照 《 中华人民共和国 民事 诉讼法 》 第十三条 、 第一百五十四条 第 （ 五 ） 项之 规定 ， 裁定 如下 ： 

刘某某与李某某离婚纠纷一审民事裁定书.txt	依照 《 中华人民共和国 民事 诉讼法 》 第 一百四十 五条 第一款 、 第一百五十四条 第一款 第 （ 五 ） 项之 规定 ， 裁定 如下 ： 

刘某某与杨某某离婚纠纷一审民事裁定书.txt	依照 《 中华人民共和国 民事 诉讼法 》 第 一百四十 五条 第一款 、 第一百五十四条 第一款 第 （ 五 ） 项之 规定 ， 裁定 如下 ： 

刘某某何某离婚纠纷案一审民事裁定书.txt	依照 《 中华人民共和国 民事 诉讼法 》 第 一百四十 五条 、 第一百五十四条 （ 五 ） 项 的 规定 ， 裁定 如下 ： 

刘某某诉被告吕某某离婚纠纷案（2016）川1028民初290号民事裁定书.txt	依照 《 中华人民共和国 民事 诉讼法 》 第 一百四十 五条 第一款 和 第一百五十四条 第 （ 五 ） 的 规定 ， 裁定 如下 ： 

刘某某诉被告李某某离婚纠纷案（2016）川1028民初1280号民事裁定书.txt	依照 《 中华人民共和国 民事 诉讼法 》 第 一百四十 五条 第一款 和 第一百五十四条 第 （ 五 ） 的 规定 ， 裁定 如下 ： 

刘某某诉雷某离婚纠纷一审民事裁定书.txt	依照 《 中华人民共和国 民事 诉讼法 》 第 一百四十 五条 第一款 、 第一百五十四条 第一款 第 （ 五 ） 项 的 规定 ， 裁定 如下 ： 

刘茜与余文斌离婚纠纷一审民事裁定书.txt	依照 《 中华人民共和国 民事 诉讼法 》 第一百五十四条 第 （ 五 ） 项 的 规定 ， 裁定 如下 ： 

卓某某诉何某某离婚纠纷一审民事裁定书.txt	根据 《 中华人民共和国 民事 诉讼法 》 第 一百四十 五条 第一款 ， 第一百五十四条 第一款 第 （ 五 ） 项之 规定 ， 裁定 如下 ： 

卢某诉刘某某离婚纠纷一案（2016）川1028民初1720号一审民事裁定书.txt	依照 《 中华人民共和国 民事 诉讼法 》 第 一百四十 五条 第一款 和 第一百五十四条 第 （ 五 ） 项 的 规定 ， 裁定 如下 ： 

卯某某与吕某某离婚纠纷一审民事裁定书.txt	依照 《 中华人民共和国 民事 诉讼法 》 第 一百四十 五条 第一款 、 第一百五十四条 第一款 第 （ 五 ） 项之 规定 ， 裁定 如下 ： 

卿某某与余某某离婚纠纷一审民事裁定书.txt	依照 《 中华人民共和国 民事 诉讼法 》 第 一百四十 五条 第一款 、 第一百五十四条 第一款 第 （ 五 ） 项之 规定 ， 裁定 如下 ： 

原告严某某与被告杨某某离婚纠纷一案一审民事裁定书.txt	依照 《 中华人民共和国 民事 诉讼法 》 第 一百四十 五条 第一款 、 第一百五十四条 第一款 （ 五 ） 项之 规定 ， 裁定 如下 ： 

原告伍某某与被告夏某某离婚纠纷一审民事裁定书.txt	依照 《 中华人民共和国 民事 诉讼法 》 第 一百四十 五条 第一款 、 第一百五十四条 第一款 （ 五 ） 项之 规定 ， 裁定 如下 ： 

原告何某某与被告刘某“离婚纠纷”一案民事裁定书.txt	依照 《 中华人民共和国 民事 诉讼法 》 第 一百四十 五条 第一款 、 第一百五十四条 第一款 （ 五 ） 项 的 规定 ， 裁定 如下 ： 

原告何某某与被告曹某某离婚纠纷一审民事裁定书.txt	依照 《 中华人民共和国 民事 诉讼法 》 第 一百四十 五条 第一款 、 第一百五十四条 第一款 第 （ 五 ） 项之 规定 ， 裁定 如下 ： 

原告何某某诉被告邓某某离婚纠纷一审民事裁定书.txt	依照 《 中华人民共和国 民事 诉讼法 》 第 一百四十 五条 第一款 、 第一百五十四条 第一款 （ 五 ） 项 的 规定 ， 裁定 如下 ： 

原告何某某诉被告陈某某为离婚纠纷一案一审民事裁定书.txt	依照 《 中华人民共和国 民事 诉讼法 》 第 一百四十 五条 第一款 、 第一百五十四条 第一款 第 （ 五 ） 项 的 规定 ， 裁定 如下 ： 

原告何芙蓉诉被告王平方离婚纠纷一案民事裁定书.txt	依照 《 中华人民共和国 民事 诉讼法 》 第 一百四十 五条 第一款 、 第一百五十四条 第一款 （ 五 ） 项 ， 裁定 如下 ： 

原告余某某与被告鲁某某离婚纠纷一审民事裁定书.txt	依照 《 中华人民共和国 民事 诉讼法 》 第 一百四十 五条 第一款 、 第一百五十四条 第一款 第 （ 五 ） 项之 规定 ， 裁定 如下 ： 

原告冉某某诉被告吴某某离婚纠纷一审民事裁定书.txt	依照 《 中华人民共和国 民事 诉讼法 》 第十三条 第二款 ， 第 一百四十 五条 第一款 ， 第一百五十四条 第一款 （ 五 ） 项之 规定 ， 裁定 如下 ： 

原告冯某某与被告杨某离婚纠纷一案的民事裁定书.txt	依照 《 中华人民共和国 民事 诉讼法 》 第十三条 第二款 、 第 一百四十 五条 、 第一百五十四条 第一款 第 （ 五 ） 项之 规定 ， 裁定 如下 ： 

原告刘某某与被告徐某某离婚纠纷一审民事裁定书.txt	依照 《 中华人民共和国 民事 诉讼法 》 第 一百四十 五条 第一款 、 第一百五十四条 第一款 第 （ 五 ） 项之 规定 ， 裁定 如下 ： 

原告刘某某与被告王某某离婚纠纷一审民事裁定书.txt	依照 《 中华人民共和国 民事 诉讼法 》 第 一百四十 五条 第一款 、 第一百五十四条 第一款 第 （ 五 ） 项之 规定 ， 裁定 如下 ： 

原告刘某某诉被告张某某离婚纠纷一审民事裁定书.txt	依照 《 中华人民共和国 民事 诉讼法 》 第 一百四十 五条 第一款 、 第一百五十四条 第一款 （ 五 ） 项 的 规定 ， 裁定 如下 ： 

原告刘某某诉被告张某某离婚纠纷一案一审民事裁定书.txt	依照 《 中华人民共和国 民事 诉讼法 》 第 一百四十 五条 第一款 、 第一百五十四条 第一款 （ 五 ） 项 的 规定 ， 裁定 如下 ： 

原告刘某诉被告李某离婚纠纷一案一审民事裁定书.txt	依照 《 中华人民共和国 民事 诉讼法 》 第 一百四十 五条 、 第一百五十四条 的 规定 ， 裁定 如下 ： 

原告刘某诉被告罗某某离婚纠纷一案民事裁定书.txt	依照 《 中华人民共和国 民事 诉讼法 》 第十三条 第二款 、 第 一百四十 五条 第一款 、 第一百五十四条 第一款 第 （ 五 ） 项 和 《 诉讼费用 交纳 办法 》 第十五条 之 规定 ， 裁定 如下 ： 

原告刘某诉被告许某某离婚纠纷一案民事裁定书.txt	依照 《 中华人民共和国 民事 诉讼法 》 第十三条 ， 第 一百四十 五条 第 （ 一 ） 款 ， 第一百五十四条 第一款 第 （ 五 ） 项 及 《 诉讼费用 交纳 办法 》 第十五条 的 规定 ， 裁定 如下 ： 

原告刘某诉被告钟某某离婚纠纷一案民事裁定书.txt	依照 《 中华人民共和国 民事 诉讼法 》 第十三条 ， 第 一百四十 五条 第 （ 一 ） 款 ， 第一百五十四条 第一款 第 （ 五 ） 项 及 《 诉讼费用 交纳 办法 》 第十五条 的 规定 ， 裁定 如下 ： 

原告向某某诉被告陈某某离婚纠纷一案一审民事裁定书.txt	依照 《 中华人民共和国 民事 诉讼法 》 第十三条 、 第 一百四十 五条 第一款 、 第一百五十四条 第一款 （ 五 ） 项之 规定 ， 裁定 如下 ： 

原告吕某某与被告黄某某离婚纠纷一审民事裁定书.txt	依照 《 中华人民共和国 民事 诉讼法 》 第 一百四十 五条 第一款 、 第一百五十四条 第一款 第 （ 五 ） 项之 规定 ， 裁定 如下 ： 

原告吕某某诉被告谭某离婚纠纷一案民事裁定书.txt	依照 《 中华人民共和国 民事 诉讼法 》 第十三条 、 第 一百四十 五条 第 （ 一 ） 款 、 第一百五十四条 第一款 第 （ 五 ） 项 及 《 诉讼费用 交纳 办法 》 第十五条 的 规定 ， 裁定 如下 ： 

原告周天军诉被告易桂花离婚后财产纠纷一案一审民事裁定书.txt	依照 《 中华人民共和国 民事 诉讼法 》 第 一百四十 五条 第一款 、 第一百五十四条 第一款 第 （ 五 ） 项之 规定 ， 裁定 如下 ： 

原告周某某诉被告叶某某离婚纠纷一案民事裁定书.txt	依照 《 中华人民共和国 民事 诉讼法 》 第十三条 ， 第 一百四十 五条 第 （ 一 ） 款 ， 第一百五十四条 第一款 第 （ 五 ） 项 及 《 诉讼费用 交纳 办法 》 第十五条 的 规定 ， 裁定 如下 ： 

原告周某某诉被告宋某某离婚纠纷一案一审民事裁定书.txt	根据 《 中华人民共和国 民事 诉讼法 》 第 一百四十 五条 、 第一百五十四条 第一款 第 （ 五 ） 项之 规定 ， 裁定 如下 ： 

原告周某某诉被告陈某某离婚纠纷一案一审民事裁定书.txt	依照 《 中华人民共和国 民事 诉讼法 》 第 一百四十 五条 第一款 、 第一百五十四条 第一款 第 （ 五 ） 项之 规定 ， 裁定 如下 ： 

原告唐某某与被告毛某某离婚纠纷一案一审民事裁定书.txt	依照 《 中华人民共和国 民事 诉讼法 》 第 一百四十 五条 第一款 、 第一百五十四条 （ 五 ） 项 的 规定 ， 裁定 如下 ： 

原告唐某某诉被告田唐某某离婚纠纷一案一审民事裁定书.txt	依照 《 中华人民共和国 民事 诉讼法 》 第 一百四十 五条 第一款 、 第一百五十四条 （ 五 ） 项 的 规定 ， 裁定 如下 ： 

原告姜某某诉被告方某某离婚纠纷一审民事裁定书.txt	依照 《 中华人民共和国 民事 诉讼法 》 第十三条 第二款 ， 第 一百四十 五条 第一款 ， 第一百五十四条 第一款 （ 五 ） 项之 规定 ， 裁定 如下 ： 

原告孙某某与被告彭某某离婚纠纷一案的民事裁定书.txt	依照 《 中华人民共和国 民事 诉讼法 》 第十三条 、 第 一百四十 五条 、 第一百五十四条 第一款 第 （ 五 ） 项之 规定 ， 裁定 如下 ： 

原告张建军与被告徐田田离婚纠纷一案一审民事裁定书.txt	依照 《 中华人民共和国 民事 诉讼法 》 第 一百四十 五条 第一款 、 第一百五十四条 第一款 （ 五 ） 项之 规定 ， 裁定 如下 ： 

原告张某某与被告刘某某离婚纠纷一案民事裁定书.txt	依照 《 中华人民共和国 民事 诉讼法 》 第十三条 、 第 一百四十 五条 第 （ 一 ） 款 、 第一百五十四条 第一款 第 （ 五 ） 项 及 《 诉讼费用 交纳 办法 》 第十五条 的 规定 ， 裁定 如下 ： 

原告张某某与被告杨某某离婚纠纷一审民事裁定书.txt	依照 《 中华人民共和国 民事 诉讼法 》 第 一百四十 五条 第一款 、 第一百五十四条 第一款 第 （ 五 ） 项之 规定 ， 裁定 如下 ： 

原告张某某诉被告周某某离婚纠纷一案一审民事裁定书.txt	依照 《 中华人民共和国 民事 诉讼法 》 第 一百四十 五条 第一款 、 第一百五十四条 第一款 第 （ 五 ） 项之 规定 ， 裁定 如下 ： 

原告张某某诉被告杨某某离婚纠纷的一审民事裁定书.txt	根据 《 中华人民共和国 民事 诉讼法 》 第 一百四十 五条 、 第一百五十四条 第一款 第 （ 五 ） 项之 规定 ， 裁定 如下 ： 

原告张静诉被告罗红华离婚纠纷一案一审民事裁定书.txt	依照 《 中华人民共和国 民事 诉讼法 》 第 一百四十 五条 第一款 、 第一百五十四条 第一款 （ 五 ） 项 的 规定 ， 裁定 如下 ： 

原告彭某某诉被告朱某某离婚纠纷一审裁定书.txt	依照 《 中华人民共和国 民事 诉讼法 》 第五十一条 、 第 一百四十 五条 和 第一百五十四条 第一款 第 （ 五 ） 项 的 规定 ， 裁定 如下 ： 

原告徐某某与被告王某某离婚纠纷一审民事裁定书.txt	依照 《 中华人民共和国 民事 诉讼法 》 第 一百四十 五条 第一款 、 第一百五十四条 第一款 第 （ 五 ） 项之 规定 ， 裁定 如下 ： 

原告徐某某诉被告张某甲离婚纠纷民事裁定书.txt	据此 ， 依照 《 中华人民共和国 民事 诉讼法 》 第一百五十四条 第一款 第 （ 五 ） 项 的 规定 ， 裁定 如下 ： 

原告徐某某诉被告罗某某离婚纠纷一案一审民事裁定书.txt	依照 《 中华人民共和国 民事 诉讼法 》 第 一百四十 五条 第一款 、 第一百五十四条 第一款 第 （ 五 ） 项 的 规定 ， 裁定 如下 ： 

原告文某某诉被告杨某某离婚纠纷一审民事裁定书.txt	依照 《 中华人民共和国 民事 诉讼法 》 第十三条 第二款 ， 第 一百四十 五条 第一款 ， 第一百五十四条 第一款 （ 五 ） 项之 规定 ， 裁定 如下 ： 

原告方某某与被告王某某离婚纠纷一审民事裁定书.txt	依照 《 中华人民共和国 民事 诉讼法 》 第 一百四十 五条 第一款 、 第一百五十四条 第一款 第 （ 五 ） 项之 规定 ， 裁定 如下 ： 

原告方某某诉被告方某离婚纠纷一案一审民事裁定书.txt	依照 《 中华人民共和国 民事 诉讼法 》 第 一百四十 五条 第一款 、 第一百五十四条 第一款 第 （ 五 ） 项之 规定 ， 裁定 如下 ： 

原告方某诉被告黄某离婚纠纷一案一审民事裁定书.txt	依照 《 中华人民共和国 民事 诉讼法 》 第 一百四十 五条 第一款 、 第一百五十四条 第一款 第 （ 五 ） 项之 规定 ， 裁定 如下 ： 

原告普某某诉被告李某某离婚纠纷一审民事裁定书.txt	据此 ， 依照 《 中华人民共和国 民事 诉讼法 》 第一百五十四条 第一款 第 （ 五 ） 项 的 规定 ， 裁定 如下 ： 

原告曹某某与被告曾某某离婚纠纷一案一审民事裁定书.txt	依照 《 中华人民共和国 民事 诉讼法 》 第 一百四十 五条 第一款 、 第一百五十四条 第一款 第 （ 五 ） 项之 规定 ， 裁定 如下 ： 

原告曹某某与被告蒲某某离婚纠纷一案民事裁定书.txt	依照 《 中华人民共和国 民事 诉讼法 》 第 一百四十 五条 一款 及 第一百五十四条 （ 五 ） 项 的 规定 ， 裁定 如下 ： 

原告曾某某诉被告陈某某离婚纠纷一案民事裁定书.txt	依照 《 中华人民共和国 民事 诉讼法 》 第十三条 ， 第 一百四十 五条 第 （ 一 ） 款 ， 第一百五十四条 第一款 第 （ 五 ） 项 及 《 诉讼费用 交纳 办法 》 第十五条 的 规定 ， 裁定 如下 ： 

原告曾某某诉被告黄某离婚纠纷一审裁定书.txt	依照 《 中华人民共和国 民事 诉讼法 》 第 一百四十 五条 第一款 、 第一百五十四条 第一款 第 （ 五 ） 项 的 规定 ， 裁定 如下 ： 

原告李某某与被告王某某离婚纠纷一案的民事裁定书.txt	依照 《 中华人民共和国 民事 诉讼法 》 第十三条 第二款 、 第 一百四十 五条 、 第一百五十四条 第一款 第 （ 五 ） 项之 规定 ， 裁定 如下 ： 

原告李某某与被告谭某某离婚后财产纠纷一审民事裁定书.txt	依照 《 中华人民共和国 民事 诉讼法 》 第 一百四十 五条 第一款 、 第一百五十四条 第一款 第 （ 五 ） 项之 规定 ， 裁定 如下 ： 

原告李某某诉被告杨某某离婚纠纷一审民事裁定书.txt	依照 《 中华人民共和国 民事 诉讼法 》 第十三条 第二款 ， 第 一百四十 五条 第一款 ， 第一百五十四条 第一款 （ 五 ） 项之 规定 ， 裁定 如下 ： 

原告李某某诉被告王某某离婚纠纷一案一审民事裁定书.txt	据此 ， 依照 《 中华人民共和国 民事 诉讼法 》 第一百五十四条 第一款 第 （ 五 ） 项 的 规定 ， 裁定 如下 ： 

原告李某某诉被告蔡某某离婚纠纷一审民事裁定书.txt	依照 《 中华人民共和国 民事 诉讼法 》 第十三条 第二款 ， 第 一百四十 五条 第一款 ， 第一百五十四条 第一款 （ 五 ） 项之 规定 ， 裁定 如下 ： 

原告李某诉被告任某某离婚纠纷一案民事裁定书.txt	依照 《 中华人民共和国 民事 诉讼法 》 第一百五十四条 第 （ 五 ） 项之 规定 ， 裁定 如下 ： 

原告李衣菊与被告胡天义离婚纠纷一审民事裁定书.txt	依照 《 中华人民共和国 民事 诉讼法 》 第 一百四十 五条 第一款 、 第一百五十四条 第一款 （ 五 ） 项之 规定 ， 裁定 如下 ： 

原告杜某某与被告向某某离婚纠纷一审民事裁定书.txt	依照 《 中华人民共和国 民事 诉讼法 》 第 一百四十 五条 第一款 、 第一百五十四条 第一款 第 （ 五 ） 项之 规定 ， 裁定 如下 ： 

原告杨某与被告钟某某离婚纠纷一案一审民事裁定书.txt	依照 《 中华人民共和国 民事 诉讼法 》 第 一百四十 五条 第一款 、 第一百五十四条 第一款 第 （ 五 ） 项之 规定 ， 裁定 如下 ： 

原告杨某某与被告甘某某离婚纠纷一审民事裁定书.txt	依照 《 中华人民共和国 民事 诉讼法 》 第 一百四十 五条 第一款 、 第一百五十四条 第一款 （ 五 ） 项之 规定 ， 裁定 如下 ： 

原告杨某某诉被告宋某某离婚纠纷一案一审民事裁定书.txt	依照 《 中华人民共和国 民事 诉讼法 》 第 一百四十 五条 第一款 、 第一百五十四条 第一款 （ 五 ） 项之 规定 ， 裁定 如下 ： 

原告杨某某诉被告杨某甲离婚纠纷一案民事裁定书.txt	依照 《 中华人民共和国 民事 诉讼法 》 第十三条 第二款 、 第 一百四十 五条 第一款 、 第一百五十四条 第一款 第 （ 五 ） 项 和 《 诉讼费用 交纳 办法 》 第十五条 之 规定 ， 裁定 如下 ： 

原告杨某诉被告张某离婚纠纷一案一审民事裁定书.txt	依照 《 中华人民共和国 民事 诉讼法 》 第 一百四十 五条 第一款 、 第一百五十四条 第一款 第 （ 五 ） 项之 规定 ， 裁定 如下 ： 

原告林某诉被告祖某某离婚纠纷一审民事裁定书.txt	依照 《 中华人民共和国 民事 诉讼法 》 第 一百四十 五条 第一款 、 第一百五十四条 第一款 （ 五 ） 项 的 规定 ， 裁定 如下 ： 

原告桂某某诉被告徐某某离婚纠纷一案一审民事裁定书.txt	依照 《 中华人民共和国 民事 诉讼法 》 第 一百四十 五条 第一款 、 第一百五十四条 （ 五 ） 项 的 规定 ， 裁定 如下 ： 

原告樊某某诉被告王某某离婚纠纷一案的一审民事裁定书.txt	根据 《 中华人民共和国 民事 诉讼法 》 第 一百四十 五条 、 第一百五十四条 第一款 第 （ 五 ） 项之 规定 ， 裁定 如下 ： 

原告樊某某诉被告郭某某离婚纠纷一审民事裁定书.txt	依照 《 中华人民共和国 民事 诉讼法 》 第 一百四十 五条 第一款 、 第一百五十四条 第一款 （ 五 ） 项 的 规定 ， 裁定 如下 ： 

原告欧某某与被告林某某离婚纠纷一案一审民事裁定书.txt	依照 《 中华人民共和国 民事 诉讼法 》 第 一百四十 五条 第一款 、 第一百五十四条 第一款 （ 五 ） 项之 规定 ， 裁定 如下 ： 

原告段某某与被告罗某某离婚纠纷一案民事裁定书.txt	依照 《 中华人民共和国 民事 诉讼法 》 第 一百四十 五条 一款 及 第一百五十四条 （ 五 ） 项 的 规定 ， 裁定 如下 ： 

原告潘某某与被告赵某某离婚纠纷一审民事裁定书.txt	依照 《 中华人民共和国 民事 诉讼法 》 第 一百四十 五条 第一款 、 第一百五十四条 第一款 第 （ 五 ） 项之 规定 ， 裁定 如下 ： 

原告潘某某诉被告吴某某离婚纠纷一案民事裁定书.txt	依照 《 中华人民共和国 民事 诉讼法 》 第十三条 ， 第 一百四十 五条 第 （ 一 ） 款 ， 第一百五十四条 第一款 第 （ 五 ） 项 及 《 诉讼费用 交纳 办法 》 第十五条 的 规定 ， 裁定 如下 ： 

原告熊珍与被告邱琳离婚纠纷一案一审民事裁定书.txt	依照 《 中华人民共和国 民事 诉讼法 》 第 一百四十 五条 第一款 、 第一百五十四条 第一款 第 （ 五 ） 项之 规定 ， 裁定 如下 ： 

原告王某某与被告谭某某离婚纠纷一审民事裁定书.txt	依照 《 中华人民共和国 民事 诉讼法 》 第 一百四十 五条 第一款 、 第一百五十四条 第一款 （ 五 ） 项之 规定 ， 裁定 如下 ： 

原告王某某诉被告李某某离婚纠纷一案一审民事裁定书.txt	依照 《 中华人民共和国 民事 诉讼法 》 第 一百四十 五条 第一款 、 第一百五十四条 第一款 第 （ 五 ） 项之 规定 ， 裁定 如下 ： 

原告王某某诉被告杨某离婚纠纷一案民事裁定书.txt	依照 《 中华人民共和国 民事 诉讼法 》 第十三条 ， 第 一百四十 五条 第 （ 一 ） 款 ， 第一百五十四条 第一款 第 （ 五 ） 项 及 《 诉讼费用 交纳 办法 》 第十五条 的 规定 ， 裁定 如下 ： 

原告王某某诉被告陈某某为离婚纠纷一案一审民事裁定书.txt	依照 《 中华人民共和国 民事 诉讼法 》 第 一百四十 五条 第一款 、 第一百五十四条 第一款 第 （ 五 ） 项 的 规定 ， 裁定 如下 ： 

原告王某诉被告刘某某离婚纠纷一案一审民事裁定书.txt	依照 《 中华人民共和国 民事 诉讼法 》 第 一百四十 五条 第一款 、 第一百五十四条 第一款 （ 五 ） 项之 规定 ， 裁定 如下 ： 

原告罗太举诉被告周小蓉离婚纠纷一案民事裁定书.txt	依照 《 中华人民共和国 民事 诉讼法 》 第 一百四十 五条 第一款 、 第一百五十四条 第一款 （ 五 ） 项 ， 裁定 如下 ： 

原告罗某某与被告赵某某“离婚纠纷”一案民事裁定书.txt	依照 《 中华人民共和国 民事 诉讼法 》 第 一百四十 五条 第一款 、 第一百五十四条 第一款 （ 五 ） 项 的 规定 ， 裁定 如下 ： 

原告肖某某与被告张某某离婚纠纷一审民事裁定书.txt	依照 《 中华人民共和国 民事 诉讼法 》 第 一百四十 五条 第一款 、 第一百五十四条 第一款 （ 五 ） 项之 规定 ， 裁定 如下 ： 

原告苏某某诉被告梁某离婚纠纷一审民事裁定书.txt	据此 ， 依照 《 中华人民共和国 民事 诉讼法 》 第一百五十四条 第一款 第 （ 五 ） 项 的 规定 ， 裁定 如下 ： 

原告蒋XX诉被告陈XX离婚纠纷一案一审民事裁定书.txt	依照 《 中华人民共和国 民事 诉讼法 》 第 一百四十 五条 第一款 、 第一百五十四条 第一款 第 （ 五 ） 项之 规定 ， 裁定 如下 ： 

原告蒋亚林诉被告龙永官离婚纠纷一审民事裁定书.txt	依照 《 中华人民共和国 民事 诉讼法 》 第 一百四十 五条 第一款 、 第一百五十四条 第一款 （ 五 ） 项之 规定 ， 裁定 如下 ： 

原告蒋某诉被告张某某离婚纠纷一案一审民事裁定书.txt	依照 《 中华人民共和国 民事 诉讼法 》 第 一百四十 五条 第一款 、 第一百五十四条 第一款 第 （ 五 ） 项 的 规定 ， 裁定 如下 ： 

原告蔡某与被告刘某离婚纠纷一审民事裁定书.txt	依照 《 中华人民共和国 民事 诉讼法 》 第 一百四十 五条 第一款 、 第一百五十四条 第一款 第 （ 五 ） 项之 规定 ， 裁定 如下 ： 

原告袁某诉被告李某离婚纠纷一审民事裁定书.txt	依照 《 中华人民共和国 民事 诉讼法 》 第 一百四十 五条 第一款 、 第一百五十四条 第一款 （ 五 ） 项 的 规定 ， 裁定 如下 ： 

原告许某某诉被告高某某离婚纠纷一案民事裁定书.txt	依照 《 中华人民共和国 民事 诉讼法 》 第十三条 第二款 、 第 一百四十 五条 第一款 、 第一百五十四条 第一款 第 （ 五 ） 项 和 《 诉讼费用 交纳 办法 》 第十五条 之 规定 ， 裁定 如下 ： 

原告谢某某诉被告刘某某离婚纠纷一审民事裁定书.txt	据此 ， 依照 《 中华人民共和国 民事 诉讼法 》 第一百五十四条 第一款 第 （ 五 ） 项 的 规定 ， 裁定 如下 ： 

原告谢某某诉被告罗某某离婚纠纷一案民事裁定书.txt	依照 《 中华人民共和国 民事 诉讼法 》 第十三条 第二款 、 第 一百四十 五条 第一款 、 第一百五十四条 第一款 第 （ 五 ） 项 和 《 诉讼费用 交纳 办法 》 第十五条 之 规定 ， 裁定 如下 ： 

原告谭某某诉被告许某某离婚纠纷一案一审民事裁定书.txt	依照 《 中华人民共和国 民事 诉讼法 》 第 一百四十 五条 、 第一百五十四条 的 规定 ， 裁定 如下 ： 

原告贺某诉被告张某离婚纠纷一审民事裁定书.txt	依照 《 中华人民共和国 民事 诉讼法 》 第 一百四十 五条 第一款 、 第一百五十四条 第一款 （ 五 ） 项 的 规定 ， 裁定 如下 ： 

原告贾某诉被告刘某离婚纠纷一案一审民事裁定书.txt	依照 《 中华人民共和国 民事 诉讼法 》 第 一百四十 五条 第一款 、 第一百五十四条 第一款 第 （ 五 ） 项之 规定 ， 裁定 如下 ： 

原告贾某诉被告杨某离婚纠纷一审民事裁定书.txt	依照 《 中华人民共和国 民事 诉讼法 》 第 一百四十 五条 第一款 、 第一百五十四条 第一款 （ 五 ） 项 的 规定 ， 裁定 如下 ： 

原告赖某某诉被告付某某离婚纠纷一审民事裁定书.txt	依照 《 中华人民共和国 民事 诉讼法 》 第十三条 第二款 ， 第 一百四十 五条 第一款 ， 第一百五十四条 第一款 （ 五 ） 项之 规定 ， 裁定 如下 ： 

原告赵某某与被告孟某某离婚纠纷一审民事裁定书.txt	依照 《 中华人民共和国 民事 诉讼法 》 第 一百四十 五条 第一款 、 第一百五十四条 第一款 第 （ 五 ） 项之 规定 ， 裁定 如下 ： 

原告赵某某与被告罗某某离婚纠纷一审民事裁定书.txt	依照 《 中华人民共和国 民事 诉讼法 》 第 一百四十 五条 第一款 、 第一百五十四条 第一款 第 （ 五 ） 项之 规定 ， 裁定 如下 ： 

原告赵某某诉被告邹某某离婚纠纷一案民事裁定书.txt	依照 《 中华人民共和国 民事 诉讼法 》 第十三条 ， 第 一百四十 五条 第 （ 一 ） 款 ， 第一百五十四条 第一款 第 （ 五 ） 项 及 《 诉讼费用 交纳 办法 》 第十五条 的 规定 ， 裁定 如下 ： 

原告邓某某诉被告阳某某离婚纠纷一案民事裁定书.txt	依照 《 中华人民共和国 民事 诉讼法 》 第十三条 ， 第 一百四十 五条 第 （ 一 ） 款 ， 第一百五十四条 第一款 第 （ 五 ） 项 及 《 诉讼费用 交纳 办法 》 第十五条 的 规定 ， 裁定 如下 ： 

原告邢某某诉被告戴某某离婚纠纷一案民事裁定书.txt	依照 《 中华人民共和国 民事 诉讼法 》 第十三条 ， 第 一百四十 五条 第 （ 一 ） 款 ， 第一百五十四条 第一款 第 （ 五 ） 项 及 《 诉讼费用 交纳 办法 》 第十五条 的 规定 ， 裁定 如下 ： 

原告郑某某诉被告黄某某离婚纠纷一审裁定书.txt	依照 《 中华人民共和国 民事 诉讼法 》 第 一百四十 五条 第一款 、 第一百五十四条 第一款 第 （ 五 ） 项 的 规定 ， 裁定 如下 ： 

原告钟某某与被告王某某离婚纠纷一案一审民事裁定书.txt	依照 《 中华人民共和国 民事 诉讼法 》 第 一百四十 五条 第一款 、 第一百五十四条 （ 五 ） 项 的 规定 ， 裁定 如下 ： 

原告钟某某与被告陈某某离婚纠纷一审民事裁定书.txt	依照 《 中华人民共和国 民事 诉讼法 》 第 一百四十 五条 第一款 、 第一百五十四条 第一款 （ 五 ） 项之 规定 ， 裁定 如下 ： 

原告钟某诉被告徐某某离婚纠纷一案民事裁定书.txt	依照 《 中华人民共和国 民事 诉讼法 》 第十三条 ， 第 一百四十 五条 第 （ 一 ） 款 ， 第一百五十四条 第一款 第 （ 五 ） 项 及 《 诉讼费用 交纳 办法 》 第十五条 的 规定 ， 裁定 如下 ： 

原告陈国勤诉被告杨国英离婚后财产纠纷一案一审民事裁定书.txt	依照 《 中华人民共和国 民事 诉讼法 》 第 一百四十 五条 第一款 、 第一百五十四条 第一款 第 （ 五 ） 项之 规定 ， 裁定 如下 ： 

原告陈某与被告唐某某离婚纠纷一案的民事裁定书.txt	依照 《 中华人民共和国 民事 诉讼法 》 第十三条 、 第 一百四十 五条 、 第一百五十四条 第一款 第 （ 五 ） 项之 规定 ， 裁定 如下 ： 

原告陈某某与被告周某某离婚后财产纠纷一审民事裁定书.txt	依照 《 中华人民共和国 民事 诉讼法 》 第 一百四十 五条 第一款 、 第一百五十四条 第一款 第 （ 五 ） 项 的 规定 ， 裁定 如下 ： 

原告陈某某与被告王某离婚纠纷一案的民事裁定书.txt	依照 《 中华人民共和国 民事 诉讼法 》 第十三条 第二款 、 第 一百四十 五条 、 第一百五十四条 第一款 第 （ 五 ） 项之 规定 ， 裁定 如下 ： 

原告陈某某与被告罗某某离婚纠纷一审民事裁定书.txt	依照 《 中华人民共和国 民事 诉讼法 》 第 一百四十 五条 第一款 、 第一百五十四条 第一款 （ 五 ） 项之 规定 ， 裁定 如下 ： 

原告陈某某诉被告张某某离婚纠纷一案的一审民事裁定书.txt	依照 《 中华人民共和国 民事 诉讼法 》 第十三条 、 第 一百四十 五条 第一款 、 第一百五十四条 第一款 （ 五 ） 项之 规定 ， 裁定 如下 ： 

原告陈某某诉被告张某离婚纠纷一案一审民事裁定书.txt	依照 《 中华人民共和国 民事 诉讼法 》 第 一百四十 五条 第一款 、 第一百五十四条 第一款 （ 五 ） 项之 规定 ， 裁定 如下 ： 

原告雷某诉被告曹某离婚纠纷一案一审民事裁定书.txt	依照 《 中华人民共和国 民事 诉讼法 》 第 一百四十 五条 第一款 、 第一百五十四条 第一款 第 （ 五 ） 项之 规定 ， 裁定 如下 ： 

原告高某某与被告陈某某离婚纠纷一审民事裁定书.txt	依照 《 中华人民共和国 民事 诉讼法 》 第 一百四十 五条 第一款 、 第一百五十四条 第一款 第 （ 五 ） 项之 规定 ， 裁定 如下 ： 

原告鲜某某与被告刘某离婚纠纷一案民事裁定书.txt	依照 《 中华人民共和国 民事 诉讼法 》 第 一百四十 五条 一款 及 第一百五十四条 （ 五 ） 项 的 规定 ， 裁定 如下 ： 

原告黄某某诉被告李某离婚纠纷一案一审民事裁定书.txt	依照 《 中华人民共和国 民事 诉讼法 》 第 一百四十 五条 第一款 、 第一百五十四条 （ 五 ） 的 规定 ， 裁定 如下 ： 

原告黄某某诉被告程某某离婚纠纷一审民事裁定书.txt	依照 《 中华人民共和国 民事 诉讼法 》 第十三条 第二款 ， 第 一百四十 五条 第一款 ， 第一百五十四条 第一款 （ 五 ） 项之 规定 ， 裁定 如下 ： 

原告黄正强与被告李菊离婚纠纷一案民事裁定书.txt	据此 ， 依照 《 中华人民共和国 民事 诉讼法 》 第 一百四十 五条 第一款 、 第一百五十四条 第一款 第 （ 五 ） 项之 规定 ， 裁定 如下 ： 

原告黎某某与被告邓某某离婚纠纷一案的民事裁定书.txt	依照 《 中华人民共和国 民事 诉讼法 》 第十三条 、 第 一百四十 五条 、 第一百五十四条 第一款 第 （ 五 ） 项之 规定 ， 裁定 如下 ： 

向某某与蒋某某离婚后财产纠纷一审民事裁定书.txt	依照 《 中华人民共和国 民事 诉讼法 》 第 一百四十 五条 第一款 、 第一百五十四条 第一款 第 （ 五 ） 项之 规定 ， 裁定 如下 ： 

吕某某诉被告周某某离婚纠纷案（2016）川1028民初1803号民事裁定书.txt	依照 《 中华人民共和国 民事 诉讼法 》 第 一百四十 五条 第一款 和 第一百五十四条 第 （ 五 ） 的 规定 ， 裁定 如下 ： 

吴某某与李某某离婚纠纷一审民事裁定书.txt	据此 ， 依照 《 中华人民共和国 民事 诉讼法 》 第 一百四十 五条 第一款 、 第一百五十四条 第一款 第 （ 五 ） 项之 规定 ， 裁定 如下 ： 

吴某某与黎某某离婚纠纷一审民事裁定书.txt	依照 《 中华人民共和国 民事 诉讼法 》 第 一百四十 五条 第一款 、 第一百五十四条 第一款 第 （ 五 ） 项之 规定 ， 裁定 如下 ： 

吴某某诉杜某某离婚纠纷案一审民事裁定书.txt	依照 《 中华人民共和国 民事 诉讼法 》 第 一百四十 五条 、 第一百五十四条 （ 五 ） 项 的 规定 ， 裁定 如下 ： 

吴某某诉被告郑某某离婚纠纷案（2016）川1028民初1160号民事裁定书.txt	依照 《 中华人民共和国 民事 诉讼法 》 第 一百四十 五条 第一款 和 第一百五十四条 第 （ 五 ） 的 规定 ， 裁定 如下 ： 

吴某诉唐某某离婚纠纷一审民事裁定书.txt	根据 《 中华人民共和国 民事 诉讼法 》 第 一百四十 五条 第一款 ， 第一百五十四条 第一款 第 （ 五 ） 项之 规定 ， 裁定 如下 ： 

周某与胡某离婚纠纷一审民事裁定书.txt	依照 《 中华人民共和国 民事 诉讼法 》 第十三条 第二项 、 第 一百四十 五条 第一款 、 第一百五十四条 第 （ 五 ） 项之 规定 ， 裁定 如下 ： 

周某与谭某某离婚纠纷一审民事裁定书.txt	依照 《 中华人民共和国 民事 诉讼法 》 第一百五十四条 第一款 第 （ 五 ） 项 的 规定 ， 裁定 如下 ： 

周某某与但某某离婚纠纷一审民事裁定书.txt	依照 《 中华人民共和国 民事 诉讼法 》 一百四十 五条 第一款 、 一百五十 四条 第一款 第 （ 五 ） 项之 规定 ， 裁定 如下 ： 

周某某与刘某某离婚纠纷一审民事裁定书.txt	依照 《 中华人民共和国 民事 诉讼法 》 第 一百四十 五条 第一款 、 第一百五十四条 第一款 第 （ 五 ） 项之 规定 ， 裁定 如下 ： 

周某某与吴某某离婚纠纷一审民事裁定书.txt	依照 《 中华人民共和国 民事 诉讼法 》 第 一百四十 五条 第一款 和 第一百五十四条 第一款 （ 五 ） 项之 规定 ， 裁定 如下 ： 

周某某与周某离婚纠纷一审民事裁定书.txt	依照 《 中华人民共和国 民事 诉讼法 》 第 一百四十 五条 第一款 、 第一百五十四条 第一款 第 （ 五 ） 项 的 规定 ， 裁定 如下 ： 

周某某与曾某离婚纠纷一审民事裁定书.txt	依照 《 中华人民共和国 民事 诉讼法 》 第 一百四十 五条 第一款 、 第一百五十四条 第一款 （ 五 ） 项之 规定 ， 裁定 如下 ： 

周某某与禹某某离婚纠纷一审民事裁定书.txt	依照 《 中华人民共和国 民事 诉讼法 》 第 一百四十 五条 、 第一百五十四条 第一款 （ 五 ） 项 的 规定 ， 裁定 如下 ： 

周某某与谢某某离婚纠纷一审民事裁定书.txt	依照 《 中华人民共和国 民事 诉讼法 》 第 一百四十 五条 第一款 、 第一百五十四条 第一款 第 （ 五 ） 项之 规定 ， 裁定 如下 ： 

周某某与陈某某离婚纠纷案一审民事裁定书.txt	依照 《 中华人民共和国 民事 诉讼法 》 第 一百四十 五条 、 第一百五十四条 （ 五 ） 项 的 规定 ， 裁定 如下 ： 

周某某诉潘某某离婚纠纷一审民事裁定书.txt	依照 《 中华人民共和国 民事 诉讼法 》 第一百五十四条 第一款 （ 五 ） 项之 规定 ， 裁定 如下 ： 

周某某诉范某某离婚纠纷案(2016)川1028民初1234号一审民事裁定书.txt	依照 《 中华人民共和国 民事 诉讼法 》 第 一百四十 五条 第一款 、 第一百五十四条 第一款 第 （ 五 ） 项 的 规定 ， 裁定 如下 ： 

唐某某与文某某离婚纠纷一审民事裁定书.txt	据此 ， 依照 《 中华人民共和国 民事 诉讼法 》 第 一百四十 五条 第一款 、 第一百五十四条 第一款 第 （ 五 ） 项之 规定 ， 裁定 如下 ： 

唐某某与李某某离婚纠纷案一审民事裁定书.txt	依照 《 中华人民共和国 民事 诉讼法 》 第 一百四十 五条 、 第一百五十四条 （ 五 ） 项 的 规定 ， 裁定 如下 ： 

唐某某诉黎某某离婚纠纷一案（2016）川1028民初1308号一审民事裁定书.txt	依照 《 中华人民共和国 民事 诉讼法 》 第 一百四十 五条 第一款 和 第一百五十四条 第 （ 五 ） 项 的 规定 ， 裁定 如下 ： 

夏某某与赵某甲离婚纠纷一审民事裁定书.txt	依照 《 中华人民共和国 民事 诉讼法 》 第 一百四十 五条 第一款 、 第一百五十四条 第一款 第 （ 五 ） 项之 规定 ， 裁定 如下 ： 

姚某某与母某某离婚纠纷一审民事裁定书.txt	据此 ， 依照 《 中华人民共和国 民事 诉讼法 》 第 一百四十 五条 第一款 、 第一百五十四条 第一款 第 （ 五 ） 项之 规定 ， 裁定 如下 ： 

孙某与刘某某离婚纠纷一审民事裁定书.txt	依照 《 中华人民共和国 民事 诉讼法 》 第 一百四十 五条 第一款 、 第一百五十四条 第一款 第 （ 五 ） 项 的 规定 ， 裁定 如下 ： 

宁某与邓某某离婚纠纷案一审民事裁定书.txt	依照 《 中华人民共和国 民事 诉讼法 》 第 一百四十 五条 第一款 及 第一百五十四条 第一款 第 （ 五 ） 项 的 规定 ， 裁定 如下 ： 

安某某与陈某某离婚纠纷一审民事裁定书.txt	依照 《 中华人民共和国 民事 诉讼法 》 第 一百四十 五条 第一款 、 第一百五十四条 第一款 第 （ 五 ） 项之 规定 ， 裁定 如下 ： 

宋某某与何某某离婚纠纷案一审民事裁定书.txt	依照 《 中华人民共和国 民事 诉讼法 》 第 一百四十 五条 一款 、 第一百五十四条 一款 （ 五 ） 项之 规定 ， 裁定 如下 ： 

宋某某与周某某离婚纠纷一审民事裁定书.txt	依照 《 中华人民共和国 民事 诉讼法 》 第十三条 、 第 一百四十 五条 第一款 、 第一百五十四条 第一款 第 （ 五 ） 项之 规定 ， 裁定 如下 ： 

宋某某与货某某离婚纠纷一审民事裁定书.txt	依照 《 中华人民共和国 民事 诉讼法 》 第 一百四十 五条 第一款 、 第一百五十四条 第一款 第 （ 五 ） 项之 规定 ， 裁定 如下 ： 

宋某某与鲁某某离婚纠纷一审民事裁定书.txt	依照 《 中华人民共和国 民事 诉讼法 》 第 一百四十 五条 、 第一百五十四条 第一款 第 （ 五 ） 项之 规定 ， 裁定 如下 ： 

宾某某诉程某离婚纠纷一审民事裁定书.txt	依照 《 中华人民共和国 民事 诉讼法 》 第 一百四十 五条 第一款 、 第一百五十四条 第一款 （ 五 ） 项之 规定 ， 裁定 如下 ： 

宾某某诉程红某某离婚纠纷一审民事裁定书.txt	依照 《 中华人民共和国 民事 诉讼法 》 第 一百四十 五条 第一款 、 第一百五十四条 第一款 （ 五 ） 项之 规定 ， 裁定 如下 ： 

尤某某与袁某某离婚纠纷案一审民事裁定书.txt	依照 《 中华人民共和国 民事 诉讼法 》 第 一百四十 五条 第一款 、 第一百五十四条 第一款 第 （ 五 ） 项之 规定 ， 裁定 如下 ： 

岳某某与王某某离婚纠纷一审民事裁定书.txt	根据 《 中华人民共和国 民事 诉讼法 》 第 一百四十 五条 第一款 、 第一百五十四条 第一款 第 （ 五 ） 项之 规定 ， 裁定 如下 ： 

岳某某与王某某离婚纠纷民事一审裁定书.txt	根据 《 中华人民共和国 民事 诉讼法 》 第 一百四十 五条 第一款 、 第一百五十四条 第一款 第 （ 五 ） 项之 规定 ， 裁定 如下 ： 

岳某某诉曹某某离婚纠纷一审民事裁定书.txt	依照 《 中华人民共和国 民事 诉讼法 》 第 一百四十 五条 第一款 、 第一百五十四条 第一款 第 （ 五 ） 项 的 规定 ， 裁定 如下 ： 

帅某某与何某甲离婚纠纷一审民事裁定书.txt	依照 《 中华人民共和国 民事 诉讼法 》 第 一百四十 五条 第一款 、 第一百五十四条 第一款 第 （ 五 ） 项之 规定 ， 裁定 如下 ： 

庞某某与付某某离婚纠纷案一审民事裁定书.txt	依照 《 中华人民共和国 民事 诉讼法 》 第 一百四十 五条 、 第一百五十四条 （ 五 ） 项 的 规定 ， 裁定 如下 ： 

康某某与张某某离婚纠纷案一审民事裁定书.txt	依照 《 中华人民共和国 民事 诉讼法 》 第 一百四十 五条 、 第一百五十四条 （ 五 ） 项 的 规定 ， 裁定 如下 ： 

廖某某与但某某离婚纠纷一审民事裁定书.txt	依照 《 中华人民共和国 民事 诉讼法 》 一百四十 五条 第一款 、 一百五十 四条 第一款 第 （ 五 ） 项之 规定 ， 裁定 如下 ： 

廖某某与杜某某离婚纠纷一审民事裁定书.txt	依照 《 中华人民共和国 民事 诉讼法 》 第 一百四十 五条 第一款 、 第一百五十四条 第一款 第 （ 五 ） 项之 规定 ， 裁定 如下 ： 

廖某某与杨某离婚纠纷一审民事裁定书.txt	依照 《 中华人民共和国 民事 诉讼法 》 第 一百四十 五条 第一款 和 第一百五十四条 第一款 （ 五 ） 项之 规定 裁定 如下 ： 

廖某某与谢某某离婚纠纷一审民事裁定书.txt	依照 《 中华人民共和国 民事 诉讼法 》 第 一百四十 五条 第一款 、 第一百五十四条 第一款 第 （ 五 ） 项之 规定 ， 裁定 如下 ： 

张某与周某某离婚纠纷一审民事裁定书.txt	依照 《 中华人民共和国 民事 诉讼法 》 第 一百四十 五条 第一款 、 第一百五十四条 第一款 第 （ 五 ） 项 的 规定 ， 裁定 如下 ： 

张某与黄某某离婚纠纷一审民事裁定书.txt	依照 《 中华人民共和国 民事 诉讼法 》 第 一百四十 五条 第一款 、 第一百五十四条 第一款 第 （ 五 ） 项 的 规定 ， 裁定 如下 ： 

张某丽与郑某成关于离婚纠纷一审民事判决书.txt	依照 《 中华人民共和国 民事 诉讼法 》 第十三条 第二款 、 第 一百四十 五条 第一款 、 第一百五十四条 第 （ 五 ） 项之 规定 ， 裁定 如下 ： 

张某某与何某某离婚纠纷一审民事裁定书.txt	依照 《 中华人民共和国 民事 诉讼法 》 第 一百四十 五条 第一款 、 第一百五十四条 第一款 （ 五 ） 项之 规定 ， 裁定 如下 ： 

张某某与冯某某离婚纠纷一审民事裁定书.txt	依照 《 中华人民共和国 民事 诉讼法 》 第 一百四十 五条 第一款 、 第一百五十四条 第一款 第 （ 五 ） 项之 规定 ， 裁定 如下 ： 

张某某与吴某某离婚纠纷一审民事裁定书.txt	依照 《 中华人民共和国 民事 诉讼法 》 第 一百四十 五条 第一款 、 第一百五十四条 第一款 （ 五 ） 项之 规定 ， 裁定 如下 ： 

张某某与姚某某离婚纠纷一审民事裁定书.txt	据此 ， 依照 《 中华人民共和国 民事 诉讼法 》 第 一百四十 五条 第一款 、 第一百五十四条 第一款 （ 五 ） 项之 规定 ， 裁定 如下 ： 

张某某与彭某某离婚纠纷案一审民事裁定书.txt	依照 《 中华人民共和国 民事 诉讼法 》 第 一百四十 五条 第一款 、 第一百五十四条 第一款 （ 五 ） 项 的 规定 ， 裁定 如下 ： 

张某某与朱某某离婚纠纷一审民事裁定书.txt	依照 《 中华人民共和国 民事 诉讼法 》 第 一百四十 五条 第一款 和 第一百五十四条 第一款 （ 五 ） 之 规定 ， 裁定 如下 ： 

张某某与杨某某离婚纠纷一审民事裁定书.txt	据此 ， 依照 《 中华人民共和国 民事 诉讼法 》 第 一百四十 五条 第一款 、 第一百五十四条 第一款 第 （ 五 ） 项之 规定 ， 裁定 如下 ： 

张某某与王某某离婚纠纷一审民事裁定书.txt	依照 《 中华人民共和国 民事 诉讼法 》 第 一百四十 五条 第一款 、 第一百五十四条 第一款 第 （ 五 ） 项之 规定 ， 裁定 如下 ： 

张某某与胡某离婚纠纷案一审民事裁定书.txt	依照 《 中华人民共和国 民事 诉讼法 》 第 一百四十 五条 、 第一百五十四条 一款 （ 五 ） 项之 规定 ， 裁定 如下 ： 

张某某与许某某离婚纠纷一审民事裁定书.txt	依照 《 中华人民共和国 民事 诉讼法 》 第 一百四十 五条 第一款 、 第一百五十四条 第一款 第 （ 五 ） 项之 规定 ， 裁定 如下 ： 

张某某诉潘某某离婚纠纷一审民事裁定书.txt	依照 《 中华人民共和国 民事 诉讼法 》 第 一百四十 五条 第一款 、 第一百五十四条 第一款 第 （ 五 ） 项之 规定 ， 裁定 如下 ： 

张某某诉罗某某离婚纠纷案（2016）川1028民初1517号民事裁定书.txt	依照 《 中华人民共和国 民事 诉讼法 》 第 一百四十 五条 第一款 和 第一百五十四条 第 （ 五 ） 的 规定 ， 裁定 如下 ： 

张某某诉黄某某离婚纠纷一案（2016）川1028民初1600号一审民事裁定书.txt	依照 《 中华人民共和国 民事 诉讼法 》 第 一百四十 五条 第一款 和 第一百五十四条 第 （ 五 ） 项 的 规定 ， 裁定 如下 ： 

张某诉徐某某离婚纠纷一审民事裁定书.txt	依照 《 中华人民共和国 民事 诉讼法 》 第 一百四十 五条 第一款 、 第一百五十四条 （ 五 ） 项之 规定 ， 裁定 如下 ： 

彭某某与王某某离婚纠纷案一审民事裁定书.txt	依照 《 中华人民共和国 民事 诉讼法 》 第 一百四十 五条 、 第一百五十四条 （ 五 ） 项 的 规定 ， 裁定 如下 ： 

彭某某与蒋某某离婚纠纷案一审民事裁定书.txt	依照 《 中华人民共和国 民事 诉讼法 》 第 一百四十 五条 、 第一百五十四条 第一款 （ 五 ） 项之 规定 ， 裁定 如下 ： 

彭某某诉吴某离婚纠纷案（2016）川1028民初1129号一审裁定书.txt	依照 《 中华人民共和国 民事 诉讼法 》 第 一百四十 三条 和 第一百五十四条 第 （ 五 ） 项 的 规定 ， 裁定 如下 ： 

徐某某与李某某离婚纠纷一审民事裁定书.txt	依照 《 中华人民共和国 民事 诉讼法 》 第 一百四十 五条 第一款 、 第一百五十四条 第一款 第 （ 五 ） 项之 规定 ， 裁定 如下 ： 

徐某某与洪某某离婚纠纷一审民事裁定书.txt	依照 《 中华人民共和国 民事 诉讼法 》 第 一百四十 五条 第一款 、 第一百五十四条 第一款 第 （ 五 ） 项 的 规定 ， 裁定 如下 ： 

徐某某诉童某某离婚纠纷一审民事裁定书.txt	依照 《 中华人民共和国 民事 诉讼法 》 第 一百四十 五条 第一款 、 第一百五十四条 第一款 （ 五 ） 项之 规定 ， 裁定 如下 ： 

徐某甲与徐某乙离婚纠纷一审民事裁定书.txt	依照 《 中华人民共和国 民事 诉讼法 》 第 一百四十 五条 第一款 、 第一百五十四条 第一款 第 （ 五 ） 项之 规定 ， 裁定 如下 ： 

敬某某与杨某某离婚纠纷一审民事裁定书.txt	依照 《 中华人民共和国 民事 诉讼法 》 第 一百四十 五条 第一款 、 第一百五十四条 第一款 第 （ 五 ） 项之 规定 ， 裁定 如下 ： 

易某某与潘某某离婚纠纷一审民事裁定书.txt	依照 《 中华人民共和国 民事 诉讼法 》 第 一百四十 五条 第一款 、 第一百五十 四 第一款 第 （ 五 ） 项之 规定 ， 裁定 如下 ： 

易某某与贾某某离婚纠纷一审民事裁定书.txt	依照 《 中华人民共和国 民事 诉讼法 》 第 一百四十 五条 第一款 、 第一百五十四条 第一款 第 （ 五 ） 项之 规定 ， 裁定 如下 ： 

曹某某与曾某某离婚纠纷案一审民事裁定书.txt	据此 ， 依照 《 中华人民共和国 民事 诉讼法 》 第五十一条 、 第 一百四十 五条 第一款 、 第一百五十四条 第 （ 五 ） 项之 规定 ， 裁定 如下 ： 

曾某某与王某某离婚纠纷案一审民事裁定书.txt	依照 《 中华人民共和国 民事 诉讼法 》 第 一百四十 五条 、 第一百五十四条 （ 五 ） 项 的 规定 ， 裁定 如下 ： 

曾某某诉伍某某离婚纠纷一审民事裁定书.txt	根据 《 中华人民共和国 民事 诉讼法 》 第 一百四十 五条 第一款 ， 第一百五十四条 第一款 第 （ 五 ） 项之 规定 ， 裁定 如下 ： 

曾某某诉毛某某离婚纠纷一审民事裁定书.txt	根据 《 中华人民共和国 民事 诉讼法 》 第 一百四十 五条 第一款 ， 第一百五十四条 第一款 第 （ 五 ） 项之 规定 ， 裁定 如下 ： 

曾某某诉被告唐某某离婚纠纷案（2016）川1028民初1684号民事裁定书.txt	依照 《 中华人民共和国 民事 诉讼法 》 第 一百四十 五条 第一款 和 第一百五十四条 第 （ 五 ） 的 规定 ， 裁定 如下 ： 

朱某某与何某某离婚纠纷一审民事裁定书.txt	依照 《 中华人民共和国 民事 诉讼法 》 第 一百四十 五条 第一款 、 第一百五十四条 第一款 第 （ 五 ） 项之 规定 ， 裁定 如下 ： 

朱某某与陈某离婚纠纷案一审民事裁定书.txt	依照 《 中华人民共和国 民事 诉讼法 》 第 一百四十 五条 第一款 、 第一百五十四条 第一款 第 （ 五 ） 项之 规定 ， 裁定 如下 ： 

朱某某与魏某某离婚纠纷民事裁定书.txt	据此 ， 依照 《 中华人民共和国 民事 诉讼法 》 第 一百四十 五条 第一款 和 第一百五十四条 第一款 第 （ 五 ） 项之 规定 ， 裁定 如下 ： 

李某与罗某离婚纠纷一审民事裁定书.txt	依照 《 中华人民共和国 民事 诉讼法 》 第 一百四十 五条 第一款 、 第一百五十四条 第一款 第 （ 五 ） 项之 规定 ， 裁定 如下 ： 

李某某与刘某甲离婚纠纷一审民事裁定书.txt	依照 《 中华人民共和国 民事 诉讼法 》 第 一百四十 五条 第一款 ， 第一百五十四条 第一款 第 （ 五 ） 项 的 规定 ， 裁定 如下 ： 

李某某与周某某离婚纠纷一案一审民事裁定书.txt	依照 《 中华人民共和国 民事 诉讼法 》 第 一百四十 五条 、 第一百五十四条 第 （ 五 ） 项之 规定 ， 裁定 如下 ： 

李某某与彭某离婚纠纷一审民事裁定书.txt	依照 《 中华人民共和国 民事 诉讼法 》 第 一百四十 五条 第一款 、 第一百五十四条 第一款 第 （ 五 ） 项之 规定 ， 裁定 如下 ： 

李某某与梁某某离婚纠纷一审民事裁定书.txt	依照 《 中华人民共和国 民事 诉讼法 》 第 一百四十 五条 第一款 、 第一百五十四条 第一款 第 （ 五 ） 项之 规定 ， 裁定 如下 ： 

李某某与胡某某离婚纠纷一审民事裁定书.txt	依照 《 中华人民共和国 民事 诉讼法 》 第 一百四十 三条 、 第一百五十四条 第一款 第 （ 五 ） 项之 规定 ， 裁定 如下 ： 

李某某与邓某某离婚纠纷一审民事裁定书.txt	依照 《 中华人民共和国 民事 诉讼法 》 第 一百四十 五条 第一款 、 第一百五十四条 第一款 （ 五 ） 项之 规定 ， 裁定 如下 ： 

李某某与陈某某离婚纠纷一审民事裁定书.txt	依照 《 中华人民共和国 民事 诉讼法 》 第一百五十四条 （ 五 ） 项 的 规定 ， 裁定 如下 ： 

李某某与陈某离婚纠纷一审民事裁定书.txt	依照 《 中华人民共和国 民事 诉讼法 》 第 一百四十 五条 第一款 、 第一百五十四条 第一款 第 （ 五 ） 项之 规定 ， 裁定 如下 ： 

李某某与黄某某离婚纠纷案一审民事裁定书.txt	依照 《 中华人民共和国 民事 诉讼法 》 第 一百四十 五条 第一款 、 第一百五十四条 第一款 （ 五 ） 项之 规定 ， 裁定 如下 ： 

李某某诉张某某离婚纠纷一审民事裁定书.txt	依照 《 中华人民共和国 民事 诉讼法 》 第 一百四十 五条 第一款 、 第一百五十四条 第一款 第 （ 五 ） 项 的 规定 ， 裁定 如下 ： 

李某某诉杜某某离婚纠纷一审民事裁定书.txt	依照 《 中华人民共和国 民事 诉讼法 》 第 一百四十 五条 第一款 、 第一百五十四条 第一款 （ 五 ） 项之 规定 ， 裁定 如下 ： 

李某某诉被告南某某离婚纠纷案（2016）川1028民初468号民事裁定书.txt	依照 《 中华人民共和国 民事 诉讼法 》 第 一百四十 五条 第一款 和 第一百五十四条 第 （ 五 ） 的 规定 ， 裁定 如下 ： 

李某某诉邱某某离婚纠纷案一审民事裁定书.txt	依照 《 中华人民共和国 民事 诉讼法 》 第 一百四十 五条 、 第一百五十四条 （ 五 ） 项 的 规定 ， 裁定 如下 ： 

李某诉蒋某某离婚纠纷一审民事裁定书.txt	依照 《 中华人民共和国 民事 诉讼法 》 第 一百四十 五条 第一款 、 第一百五十四条 （ 五 ） 项之 规定 ， 裁定 如下 ： 

杜某与李某某离婚纠纷一审民事裁定书.txt	据此 ， 依照 《 中华人民共和国 民事 诉讼法 》 第 一百四十 五条 第一款 、 第一百五十四条 第一款 第 （ 五 ） 项之 规定 ， 裁定 如下 ： 

杜某某与何某某离婚纠纷一审民事裁定书.txt	依照 《 中华人民共和国 民事 诉讼法 》 第 一百四十 五条 、 第一百五十四条 第一款 第 （ 五 ） 项 的 规定 ， 裁定 如下 ： 

杜某某与高某某离婚纠纷一审民事裁定书.txt	依照 《 中华人民共和国 民事 诉讼法 》 第 一百四十 五条 第一款 、 第一百五十四条 第一款 （ 五 ） 项之 规定 ， 裁定 如下 ： 

杨传彬诉被告陈玉洁离婚后财产纠纷民事裁定书.txt	依照 《 中华人民共和国 民事 诉讼法 》 第 一百四十 五条 、 第一百五十四条 第一款 第 （ 五 ） 项之 规定 ， 裁定 如下 ： 

杨启翠与吴召春离婚纠纷一审民事裁定书.txt	据此 ， 依照 《 中华人民共和国 民事 诉讼法 》 第 一百四十 五条 第一款 、 第一百五十四条 第一款 第 （ 五 ） 项之 规定 ， 裁定 如下 ： 

杨某与杨某某离婚纠纷一审民事裁定书.txt	据此 ， 依照 《 中华人民共和国 民事 诉讼法 》 第 一百四十 五条 第一款 、 第一百五十四条 第一款 第 （ 五 ） 项之 规定 ， 裁定 如下 ： 

杨某乙与王某某离婚纠纷一审民事裁定书.txt	依照 《 中华人民共和国 民事 诉讼法 》 第 一百四十 五条 第一款 、 第一百五十四条 第一款 第 （ 五 ） 项之 规定 ， 裁定 如下 ： 

杨某某与余某某离婚纠纷一审民事裁定书.txt	依照 《 中华人民共和国 民事 诉讼法 》 第 一百四十 五条 第一款 、 第一百五十四条 第一款 （ 五 ） 项之 规定 ， 裁定 如下 ： 

杨某某与吴某甲离婚纠纷一审民事裁定书.txt	依照 《 中华人民共和国 民事 诉讼法 》 第 一百四十 五条 第一款 、 第一百五十四条 第一款 第 （ 五 ） 之 规定 ， 裁定 如下 ： 

杨某某与周某某离婚纠纷一审民事裁定书.txt	依照 《 中华人民共和国 民事 诉讼法 》 第 一百四十 五条 第一款 、 第一百五十四条 第一款 第 （ 五 ） 项之 规定 ， 裁定 如下 ： 

杨某某与夏某某离婚纠纷一审民事裁定书.txt	依照 《 中华人民共和国 民事 诉讼法 》 第 一百四十 五条 第一款 、 第一百五十四条 第一款 第 （ 五 ） 项之 规定 ， 裁定 如下 ： 

杨某某与曾某某离婚纠纷一审民事裁定书.txt	依照 《 中华人民共和国 民事 诉讼法 》 第 一百四十 五条 、 第一百五十四条 第一款 第 （ 五 ） 项之 规定 ， 裁定 如下 ： 

杨某某与朱某某离婚纠纷一审民事裁定书.txt	据此 ， 依照 《 中华人民共和国 民事 诉讼法 》 第 一百四十 五条 第一款 、 第一百五十四条 第一款 第 （ 五 ） 项之 规定 ， 裁定 如下 ： 

杨某某与李某某离婚纠纷一审民事裁定书.txt	依照 《 中华人民共和国 民事 诉讼法 》 第 一百四十 五条 第一款 、 第一百五十四条 第一款 （ 五 ） 项之 规定 ， 裁定 如下 ： 

杨某某与潘某某离婚纠纷一审民事裁定书.txt	依照 《 中华人民共和国 民事 诉讼法 》 第十三条 第二款 、 第 一百四十 五条 第一款 、 第一百五十四条 第一款 第 （ 五 ） 项之 规定 ， 裁定 如下 ： 

杨某某与王某某离婚纠纷一审民事裁定书.txt	依照 《 中华人民共和国 民事 诉讼法 》 第 一百四十 五条 第一款 、 第一百五十四条 第一款 （ 五 ） 项之 规定 ， 裁定 如下 ： 

杨某某与王某离婚纠纷一审民事裁定书.txt	依照 《 中华人民共和国 民事 诉讼法 》 第 一百四十 五条 第一款 、 第一百五十四条 第一款 第 （ 五 ） 项之 规定 ， 裁定 如下 ： 

杨某某与谭某某离婚纠纷一审民事裁定书.txt	依照 《 中华人民共和国 民事 诉讼法 》 第 一百四十 五条 第一款 、 第一百五十四条 第一款 第 （ 五 ） 项之 规定 ， 裁定 如下 ： 

杨某某与陈某某离婚纠纷一审民事裁定书.txt	依照 《 中华人民共和国 民事 诉讼法 》 第 一百四十 五条 第一款 、 第一百五十四条 第一款 （ 五 ） 项之 规定 ， 裁定 如下 ： 

杨某某诉徐某某离婚纠纷一审民事裁定书.txt	依照 《 中华人民共和国 民事 诉讼法 》 第 一百四十 五条 第一款 、 第一百五十四条 第一款 （ 五 ） 项之 规定 ， 裁定 如下 ： 

杨某某诉荣某某离婚纠纷一审民事裁定书.txt	据此 ， 依照 《 中华人民共和国 民事 诉讼法 》 第 一百四十 五条 第一款 、 第一百五十四条 第一款 第 （ 五 ） 项之 规定 ， 裁定 如下 ： 

杨某某诉董某某离婚纠纷一审民事裁定书.txt	依照 《 中华人民共和国 民事 诉讼法 》 第 一百四十 五条 第一款 、 第一百五十四条 第一款 第 （ 五 ） 项 的 规定 ， 裁定 如下 ： 

杨某某诉被告李某某离婚纠纷案（2016）川1028民初1300号民事裁定书.txt	依照 《 中华人民共和国 民事 诉讼法 》 第 一百四十 五条 第一款 和 第一百五十四条 第 （ 五 ） 的 规定 ， 裁定 如下 ： 

杨某某诉被告罗某某离婚纠纷案（2016）川1028民初1801号民事裁定书.txt	依照 《 中华人民共和国 民事 诉讼法 》 第 一百四十 五条 第一款 和 第一百五十四条 第 （ 五 ） 的 规定 ， 裁定 如下 ： 

杨某甲与王某某离婚纠纷一审民事裁定书.txt	依照 《 中华人民共和国 民事 诉讼法 》 第 一百四十 五条 第一款 、 第一百五十四条 第一款 第 （ 五 ） 项之 规定 ， 裁定 如下 ： 

杨某诉杜某某离婚纠纷一审民事裁定书.txt	依照 《 中华人民共和国 民事 诉讼法 》 第 一百四十 五条 第一款 、 第一百五十四条 第一款 第 （ 五 ） 项 的 规定 ， 裁定 如下 ： 

柯某某与徐某某离婚纠纷一审民事裁定书.txt	依照 《 中华人民共和国 民事 诉讼法 》 第 一百四十 五条 第一款 、 第一百五十四条 第一款 第 （ 五 ） 项之 规定 ， 裁定 如下 ： 

梁某某与王某某离婚纠纷一审民事裁定书.txt	依照 《 中华人民共和国 民事 诉讼法 》 第 一百四十 五条 第一款 、 第一百五十四条 第一款 （ 五 ） 项之 规定 ， 裁定 如下 ： 

梁某某与苟某某离婚纠纷一审民事裁定书.txt	依照 《 中华人民共和国 民事 诉讼法 》 第 一百四十 五条 、 第一百五十四条 第一款 （ 五 ） 项之 规定 ， 裁定 如下 ： 

梁某某诉曾某某离婚纠纷一案（2016）川1028民初1398号一审民事裁定书.txt	依照 《 中华人民共和国 民事 诉讼法 》 第 一百四十 五条 第一款 和 第一百五十四条 第 （ 五 ） 项 的 规定 ， 裁定 如下 ： 

梁某某诉蔡某离婚纠纷一审民事裁定书.txt	依照 《 中华人民共和国 民事 诉讼法 》 第 一百四十 五条 第一款 、 第一百五十四条 第一款 第 （ 五 ） 项 的 规定 ， 裁定 如下 ： 

母某某与岳某某离婚纠纷一审民事裁定书.txt	据此 ， 依照 《 中华人民共和国 民事 诉讼法 》 第 一百四十 五条 第一款 、 第一百五十四条 第一款 第 （ 五 ） 项之 规定 ， 裁定 如下 ： 

毕某某与谢某某离婚纠纷案一审民事裁定书.txt	依照 《 中华人民共和国 民事 诉讼法 》 第 一百四十 五条 第一款 及 第一百五十四条 第一款 第 （ 五 ） 项 的 规定 ， 裁定 如下 ： 

洪某甲与洪某乙离婚纠纷一审民事裁定书.txt	依照 《 中华人民共和国 民事 诉讼法 》 第 一百四十 五条 第一款 、 第一百五十四条 第一款 第 （ 五 ） 项 的 规定 ， 裁定 如下 ： 

潘某某与易某某离婚纠纷案一审民事裁定书.txt	依照 《 中华人民共和国 民事 诉讼法 》 第 一百四十 五条 第一款 、 第一百五十四条 第一款 第 （ 五 ） 项之 规定 ， 裁定 如下 ： 

潘某某与田某某离婚纠纷一审民事裁定书.txt	依照 《 中华人民共和国 民事 诉讼法 》 第 一百四十 五条 第一款 、 第一百五十四条 第一款 第 （ 五 ） 项 的 规定 ， 裁定 如下 ： 

熊某与李某某离婚纠纷一审民事裁定书.txt	依照 《 中华人民共和国 民事 诉讼法 》 第 一百四十 五条 第一款 、 第一百五十四条 第一款 第 （ 五 ） 项之 规定 ， 裁定 如下 ： 

熊某慧诉胡某勇离婚纠纷一审民事裁定书.txt	据此 ， 依照 《 中华人民共和国 民事 诉讼法 》 第十三条 第二款 、 第 一百四十 五条 第一款 、 第一百五十四条 第 （ 五 ） 项之 规定 ， 裁定 如下 ： 

熊某某与潘某离婚纠纷一审民事裁定书.txt	依照 《 中华人民共和国 民事 诉讼法 》 第 一百四十 五条 第一款 、 第一百五十四条 第一款 第 （ 五 ） 项 的 规定 ， 裁定 如下 ： 

熊某某诉张某某离婚纠纷一审民事裁定书.txt	依照 《 中华人民共和国 民事 诉讼法 》 第 一百四十 五条 第一款 、 第一百五十四条 第一款 第 （ 五 ） 项之 规定 ， 裁定 如下 ： 

王丽蓉与王光伟离婚纠纷一审民事裁定书.txt	依照 《 中华人民共和国 民事 诉讼法 》 第 一百四十 五条 第一款 、 第一百五十四条 第一款 第 （ 五 ） 项之 规定 ， 裁定 如下 ： 

王某与廖某某离婚纠纷一审民事裁定书.txt	依照 《 中华人民共和国 民事 诉讼法 》 第一百五十四条 第一款 第 （ 五 ） 项之 规定 ， 裁定 如下 ： 

王某与杨某某离婚纠纷一案一审裁定书.txt	依照 《 中华人民共和国 民事 诉讼法 》 第 一百四十 五条 第一款 、 第一百五十四条 第一款 第 （ 五 ） 项 的 规定 ， 裁定 如下 ： 

王某与黄某离婚纠纷一审民事裁定书.txt	据此 ， 依照 《 中华人民共和国 民事 诉讼法 》 第 一百四十 五条 第一款 、 第一百五十四条 第一款 （ 五 ） 项之 规定 ， 裁定 如下 ： 

王某某与刘某某离婚纠纷一审民事裁定书.txt	依照 《 中华人民共和国 民事 诉讼法 》 第 一百四十 五条 第一款 、 第一百五十四条 第一款 第 （ 五 ） 项之 规定 ， 裁定 如下 ： 

王某某与孙某某离婚纠纷案一审民事裁定书.txt	依照 《 中华人民共和国 民事 诉讼法 》 第 一百四十 五条 、 第一百五十四条 （ 五 ） 项 的 规定 ， 裁定 如下 ： 

王某某与左某某离婚纠纷一审民事裁定书.txt	依照 《 中华人民共和国 民事 诉讼法 》 第 一百四十 五条 第一款 、 第一百五十四条 第一款 第 （ 五 ） 项之 规定 ， 裁定 如下 ： 

王某某与廖某某离婚纠纷案一审民事裁定书.txt	依照 《 中华人民共和国 民事 诉讼法 》 第 一百四十 五条 第一款 、 第一百五十四条 第一款 第 （ 五 ） 项 的 规定 ， 裁定 如下 ： 

王某某与房某某离婚纠纷案一审民事裁定书.txt	依照 《 中华人民共和国 民事 诉讼法 》 第 一百四十 五条 、 第一百五十四条 （ 五 ） 项 的 规定 ， 裁定 如下 ： 

王某某与杨某某离婚纠纷案一审民事裁定书.txt	依照 《 中华人民共和国 民事 诉讼法 》 第 一百四十 五条 第一款 及 第一百五十四条 第一款 第 （ 五 ） 项 的 规定 ， 裁定 如下 ： 

王某某与罗某某离婚纠纷一审民事裁定书.txt	依照 《 中华人民共和国 民事 诉讼法 》 第 一百四十 五条 第一款 、 第一百五十四条 第一款 第 （ 五 ） 项之 规定 ， 裁定 如下 ： 

王某某与范某某离婚纠纷一审民事裁定书.txt	据此 ， 依照 《 中华人民共和国 民事 诉讼法 》 第 一百四十 五条 第一款 、 第一百五十四条 第一款 第 （ 五 ） 项之 规定 ， 裁定 如下 ： 

王某某与贺某离婚纠纷案一审民事裁定书.txt	依照 《 中华人民共和国 民事 诉讼法 》 第 一百四十 五条 、 第一百五十四条 一款 （ 五 ） 项之 规定 ， 裁定 如下 ： 

王某某与贾某某离婚纠纷一审民事裁定书.txt	依照 《 中华人民共和国 民事 诉讼法 》 第 一百四十 五条 第一款 、 第一百五十四条 第一款 第 （ 五 ） 项之 规定 ， 裁定 如下 ： 

王某某与陈某某离婚纠纷一审民事裁定书.txt	依照 《 中华人民共和国 民事 诉讼法 》 第 一百四十 五条 、 第一百五十四条 第一款 （ 五 ） 项之 规定 ， 裁定 如下 ： 

王某某与韩某某离婚纠纷一审民事裁定书.txt	依照 《 中华人民共和国 民事 诉讼法 》 第 一百四十 五条 第一款 、 第一百五十四条 第一款 第 （ 五 ） 项 的 规定 ， 裁定 如下 ： 

王某甲与王某乙离婚纠纷一审民事裁定书.txt	依照 《 中华人民共和国 民事 诉讼法 》 第 一百四十 五条 第一款 、 第一百五十四条 第一款 第 （ 五 ） 项 的 规定 ， 裁定 如下 ： 

王某甲与王某乙离婚纠纷案一审民事裁定书.txt	依照 《 中华人民共和国 民事 诉讼法 》 第 一百四十 五条 第一款 、 第一百五十四条 第一款 （ 五 ） 项之 规定 ， 裁定 如下 ： 

王某诉胡某离婚纠纷一案（2016）川1028民初1377号一审民事裁定书.txt	依照 《 中华人民共和国 民事 诉讼法 》 第 一百四十 五条 第一款 和 第一百五十四条 第 （ 五 ） 项 的 规定 ， 裁定 如下 ： 

田某与陈某离婚纠纷一审民事裁定书.txt	据此 ， 依照 《 中华人民共和国 民事 诉讼法 》 第 一百四十 五条 第一款 、 第一百五十四条 第一款 （ 五 ） 项之 规定 ， 裁定 如下 ： 

石万秀与陈修兵离婚纠纷一审民事裁定书.txt	依照 《 中华人民共和国 民事 诉讼法 》 第 一百四十 五条 第一款 、 第一百五十四条 第一款 （ 五 ） 项之 规定 ， 裁定 如下 ： 

石某某与邱某某离婚纠纷一审民事裁定书.txt	依照 《 中华人民共和国 民事 诉讼法 》 第 一百四十 五条 第一款 、 第一百五十四条 第一款 （ 五 ） 项之 规定 ， 裁定 如下 ： 

祁某某与何某某离婚纠纷一审民事裁定书.txt	依照 《 中华人民共和国 民事 诉讼法 》 第 一百四十 五条 第一款 、 第一百五十四条 第一款 第 （ 五 ） 项 的 规定 ， 裁定 如下 ： 

祝某某与胡某某离婚纠纷一审民事裁定书.txt	依照 《 中华人民共和国 民事 诉讼法 》 第 一百四十 五条 第一款 、 第一百五十四条 第一款 第 （ 五 ） 项之 规定 ， 裁定 如下 ： 

秦某某诉被告妹某某离婚纠纷案（2016）川1028民初1927号民事裁定书.txt	依照 《 中华人民共和国 民事 诉讼法 》 第 一百四十 五条 第一款 和 第一百五十四条 第一款 第 （ 五 ） 项 的 规定 ， 裁定 如下 ： 

程某某与郑某某离婚纠纷一审民事裁定书.txt	依照 《 中华人民共和国 民事 诉讼法 》 第 一百四十 五条 第一款 、 第一百五十四条 第一款 （ 五 ） 项之 规定 ， 裁定 如下 ： 

符某某与熊某某离婚纠纷一审民事裁定书.txt	依照 《 中华人民共和国 民事 诉讼法 》 第一百五十四条 第一款 第 （ 五 ） 项之 规定 ， 裁定 如下 ： 

简某某与王某离婚纠纷一审民事裁定书.txt	依照 《 中华人民共和国 民事 诉讼法 》 第一百五十四条 第 （ 五 ） 项之 规定 ， 裁定 如下 ： 

米某与李某离婚纠纷一审民事裁定书.txt	依照 《 中华人民共和国 民事 诉讼法 》 第 一百四十 五条 第一款 、 第一百五十四条 第一款 第 （ 五 ） 项之 规定 ， 裁定 如下 ： 

罗小琴与左俊离婚纠纷一审民事裁定书.txt	依照 《 中华人民共和国 民事 诉讼法 》 第一百五十四条 第 （ 五 ） 项 的 规定 ， 裁定 如下 ： 

罗建旭诉杨素容离婚纠纷一审民事裁定书.txt	依照 《 中华人民共和国 民事 诉讼法 》 第 一百四十 五条 第一款 、 第一百五十四条 第一款 （ 五 ） 项之 规定 ， 裁定 如下 ： 

罗某某与刘某某离婚纠纷一审民事裁定书.txt	依照 《 中华人民共和国 民事 诉讼法 》 第 一百四十 五条 第一款 、 第一百五十四条 第一款 （ 五 ） 项之 规定 ， 裁定 如下 ： 

罗某某与周某某离婚纠纷案一审民事裁定书.txt	依照 《 中华人民共和国 民事 诉讼法 》 第 一百四十 五条 第一款 、 第一百五十四条 第一款 （ 五 ） 项之 规定 ， 裁定 如下 ： 

罗某某与孙某某离婚纠纷一审民事裁定书.txt	依照 《 中华人民共和国 民事 诉讼法 》 第 一百四十 五条 第一款 、 第一百五十四条 第一款 第 （ 五 ） 项之 规定 ， 裁定 如下 ： 

罗某某与毛某某离婚纠纷一审民事裁定书.txt	依照 《 中华人民共和国 民事 诉讼法 》 第 一百四十 五条 第一款 、 第一百五十四条 第一款 第 （ 五 ） 项之 规定 ， 裁定 如下 ： 

罗某某与郑某某离婚纠纷一审民事裁定书.txt	依照 《 中华人民共和国 民事 诉讼法 》 第 一百四十 五条 、 第一百五十四条 第一款 （ 五 ） 项之 规定 ， 裁定 如下 ： 

翟某某诉罗某某离婚纠纷一审民事裁定书.txt	依照 《 中华人民共和国 民事 诉讼法 》 第 一百四十 五条 、 第一百五十四条 第一款 第 （ 五 ） 项之 规定 ， 裁定 如下 ： 

肖某与蒋某离婚纠纷一审民事裁定书.txt	依照 《 中华人民共和国 民事 诉讼法 》 第 一百四十 五条 第一款 、 第一百五十四条 第一款 第 （ 五 ） 项 的 规定 ， 裁定 如下 ： 

胡某与游某离婚纠纷一案一审民事裁定书.txt	根据 《 中华人民共和国 民事 诉讼法 》 第 一百四十 五条 第一款 、 第一百五十四条 第一款 （ 五 ） 之 规定 ， 裁定 如下 ： 

胡某某与廖某某离婚纠纷一审民事裁定书.txt	据此 ， 依照 《 中华人民共和国 民事 诉讼法 》 第 一百四十 五条 第一款 、 第一百五十四条 第一款 第 （ 五 ） 项之 规定 ， 裁定 如下 ： 

胡某某与张某某离婚纠纷案一审民事裁定书.txt	依照 《 中华人民共和国 民事 诉讼法 》 第 一百四十 五条 一款 、 第一百五十四条 一款 （ 五 ） 项之 规定 ， 裁定 如下 ： 

舒某某与胡某某离婚纠纷一审民事裁定书.txt	依照 《 中华人民共和国 民事 诉讼法 》 第一百五十四条 第一款 第 （ 五 ） 项 的 规定 ， 裁定 如下 ： 

范某某与刘某某离婚纠纷一审民事裁定书.txt	依照 《 中华人民共和国 民事 诉讼法 》 第 一百四十 五条 第一款 、 第一百五十四条 第一款 第 （ 五 ） 项 的 规定 ， 裁定 如下 ： 

范某某与贺某某离婚纠纷一审民事裁定书.txt	依照 《 中华人民共和国 民事 诉讼法 》 第十三条 第二款 、 第 一百四十 五条 第一款 、 第一百五十四条 第一款 第 （ 五 ） 项之 规定 ， 裁定 如下 ： 

范某某与门某某离婚纠纷一审民事裁定书.txt	依照 《 中华人民共和国 民事 诉讼法 》 第 一百四十 五条 第一款 、 第一百五十四条 第一款 第 （ 五 ） 项之 规定 ， 裁定 如下 ： 

董某某与胡某某离婚纠纷一审民事裁定书.txt	依照 《 中华人民共和国 民事 诉讼法 》 第 一百四十 五条 第一款 、 第一百五十四条 第 （ 五 ） 项之 规定 ， 裁定 如下 ： 

董某甲与董某乙离婚纠纷一审民事裁定书.txt	依照 《 中华人民共和国 民事 诉讼法 》 第 一百四十 五条 第一款 、 第一百五十四条 第一款 第 （ 五 ） 项之 规定 ， 裁定 如下 ： 

蒋某某与刘某某离婚纠纷一审 民事裁定书.txt	据此 ， 依照 《 中华人民共和国 民事 诉讼法 》 第 一百四十 五条 第一款 、 第一百五十四条 第一款 第 （ 五 ） 项之 规定 ， 裁定 如下 ： 

蒋某某与袁某某离婚纠纷一审民事裁定书.txt	依照 《 中华人民共和国 民事 诉讼法 》 第 一百四十 五条 第一款 、 第一百五十四条 第一款 第 （ 五 ） 项之 规定 ， 裁定 如下 ： 

蒙某某与安某某离婚纠纷一审民事裁定书.txt	依照 《 中华人民共和国 民事 诉讼法 》 第 一百四十 五条 第一款 、 第一百五十四条 第一款 第 （ 五 ） 项之 规定 , 裁定 如下 ： 

蒲某某与左某某离婚纠纷一审民事裁定书.txt	依照 《 中华人民共和国 民事 诉讼法 》 第 一百四十 五条 第一款 、 第一百五十四条 第一款 第 （ 五 ） 项之 规定 ， 裁定 如下 ： 

蒲某某与黄某某离婚纠纷一审民事裁定书.txt	依照 《 中华人民共和国 民事 诉讼法 》 第 一百四十 五条 第一款 、 第一百五十四条 第一款 第 （ 五 ） 项 的 规定 ， 裁定 如下 ： 

袁某某与任某某离婚纠纷一审民事裁定书.txt	据此 ， 依照 《 中华人民共和国 民事 诉讼法 》 第 一百四十 五条 第一款 、 第一百五十四条 第一款 第 （ 五 ） 项之 规定 ， 裁定 如下 ： 

袁某某与冯某某离婚纠纷一审民事裁定书.txt	依照 《 中华人民共和国 民事 诉讼法 》 第 一百四十 五条 第一款 、 第一百五十四条 第一款 第 （ 五 ） 项之 规定 ， 裁定 如下 ： 

覃某某诉石某某离婚纠纷一审民事裁定书.txt	根据 《 中华人民共和国 民事 诉讼法 》 第 一百四十 五条 第一款 ， 第一百五十四条 第一款 第 （ 五 ） 项之 规定 ， 裁定 如下 ： 

许某某与李某某离婚纠纷一审民事裁定书.txt	依照 《 中华人民共和国 民事 诉讼法 》 第一百五十四条 第 （ 五 ） 项之 规定 ， 裁定 如下 ： 

许某某诉吴某某离婚纠纷一审民事裁定书.txt	根据 《 中华人民共和国 民事 诉讼法 》 第 一百四十 五条 第一款 ， 第一百五十四条 第一款 第 （ 五 ） 项之 规定 ， 裁定 如下 ： 

谢某与贾某离婚纠纷一审民事裁定书.txt	依照 《 中华人民共和国 民事 诉讼法 》 第 一百四十 五条 第一款 、 第一百五十四条 第一款 第 （ 五 ） 项之 规定 ， 裁定 如下 ： 

谢某某诉被告李某某离婚纠纷案（2016）川1028民初1294号民事裁定书.txt	依照 《 中华人民共和国 民事 诉讼法 》 第 一百四十 五条 第一款 和 第一百五十四条 第 （ 五 ） 的 规定 ， 裁定 如下 ： 

谭某某与吴某某离婚纠纷一审民事裁定书.txt	依照 《 中华人民共和国 民事 诉讼法 》 第 一百四十 五条 第一款 、 第一百五十四条 第一款 第 （ 五 ） 项之 规定 ， 裁定 如下 ： 

贺某诉张某离婚纠纷一审民事裁定书.txt	根据 《 中华人民共和国 民事 诉讼法 》 第 一百四十 五条 第一款 ， 第一百五十四条 第一款 第 （ 五 ） 项之 规定 ， 裁定 如下 ： 

贾某某与康某某离婚纠纷一审民事裁定书.txt	依照 《 中华人民共和国 民事 诉讼法 》 第 一百四十 五条 第一款 、 第一百五十四条 第一款 第 （ 五 ） 项之 规定 ， 裁定 如下 ： 

贾某某与梁某某离婚纠纷一审民事裁定书.txt	依照 《 中华人民共和国 民事 诉讼法 》 第 一百四十 五条 第一款 、 第一百五十四条 第一款 第 （ 五 ） 项之 规定 ， 裁定 如下 ： 

赖某与王某某离婚纠纷一审民事裁定书.txt	依照 《 中华人民共和国 民事 诉讼法 》 第 一百四十 五条 第一款 、 第一百五十四条 第一款 第 （ 五 ） 项之 规定 ， 裁定 如下 ： 

赵某某与吴某某离婚纠纷一审民事裁定书.txt	依照 《 中华人民共和国 民事 诉讼法 》 第 一百四十 五条 第一款 、 第一百五十四条 第一款 （ 五 ） 项之 规定 ， 裁定 如下 ： 

赵某某与杨某某离婚纠纷案一审民事裁定书.txt	依照 《 中华人民共和国 民事 诉讼法 》 第 一百四十 五条 第一款 、 第一百五十四条 第一款 第 （ 五 ） 项之 规定 ， 裁定 如下 ： 

赵某某与罗某某离婚纠纷一审民事裁定书.txt	依照 《 中华人民共和国 民事 诉讼法 》 第 一百四十 五条 第一款 、 第一百五十四条 第一款 第 （ 五 ） 项之 规定 ， 裁定 如下 ： 

赵某某与苏某某离婚纠纷一审民事裁定书.txt	依照 《 中华人民共和国 民事 诉讼法 》 第 一百四十 五条 第一款 、 第一百五十四条 第一款 第 （ 五 ） 项之 规定 ， 裁定 如下 ： 

赵某某与邱某某离婚纠纷一审民事裁定书.txt	依照 《 中华人民共和国 民事 诉讼法 》 第 一百四十 五条 第一款 和 第一百五十四条 第一款 （ 五 ） 项之 规定 ， 裁定 如下 ： 

赵某某与陈某离婚纠纷一案一审裁定书.txt	依照 《 中华人民共和国 民事 诉讼法 》 第 一百四十 五条 第一款 、 第一百五十四条 （ 五 ） 项 的 规定 ， 裁定 如下 ： 

赵某郑某某离婚纠纷案一审民事裁定书.txt	依照 《 中华人民共和国 民事 诉讼法 》 第 一百四十 五条 第一款 、 第一百五十四条 第一款 第 （ 五 ） 项之 规定 ， 裁定 如下 ： 

车某某与艾某某离婚纠纷民事裁定书.txt	依照 《 中华人民共和国 民事 诉讼法 》 第 一百四十 五条 第一款 、 第一百五十四条 第一款 第 （ 五 ） 项 的 规定 ， 裁定 如下 ： 

邓某某与吕某某离婚纠纷一审民事裁定书.txt	依照 《 中华人民共和国 民事 诉讼法 》 第 一百四十 五条 、 第一百五十四条 第一款 第 （ 五 ） 项之 规定 ， 裁定 如下 ： 

邓某某与肖某某离婚纠纷一审民事裁定书.txt	依照 《 中华人民共和国 民事 诉讼法 》 第十三条 第二款 、 第 一百四十 五条 、 第一百五十四条 第一款 第 （ 五 ） 项 的 规定 ， 裁定 如下 ： 

邱某全与谢某芬离婚纠纷民事裁定书.txt	依照 《 中华人民共和国 民事 诉讼法 》 第十三条 第二款 、 第 一百四十 五条 第一款 、 第一百五十四条 第 （ 五 ） 项之 规定 ， 裁定 如下 ： 

邹某某与邓某某离婚纠纷一审民事裁定书.txt	依照 《 中华人民共和国 民事 诉讼法 》 第 一百四十 五条 第一款 、 第一百五十四条 第一款 第 （ 五 ） 项之 规定 ， 裁定 如下 ： 

郑某某与母某某离婚纠纷一审民事裁定书.txt	依照 《 中华人民共和国 民事 诉讼法 》 第 一百四十 五条 、 第一百五十四条 第一款 （ 五 ） 项之 规定 ， 裁定 如下 ： 

郑某某与袁某离婚纠纷案一审民事裁定书.txt	依照 《 中华人民共和国 民事 诉讼法 》 第 一百四十 五条 第一款 、 第一百五十四条 第一款 第 （ 五 ） 项 的 规定 ， 裁定 如下 ： 

郑某某与鲜某某离婚纠纷案一审民事裁定书.txt	依照 《 中华人民共和国 民事 诉讼法 》 第 一百四十 五条 第一款 及 第一百五十四条 第一款 第 （ 五 ） 项 的 规定 ， 裁定 如下 ： 

郭某与王某离婚纠纷一审民事裁定书.txt	依照 《 中华人民共和国 民事 诉讼法 》 第 一百四十 三条 、 第一百五十四条 第一款 第 （ 十一 ） 项之 规定 ， 裁定 如下 ： 

钱某某与黄某某离婚纠纷一审民事裁定书.txt	依照 《 中华人民共和国 民事 诉讼法 》 第 一百四十 五条 第一款 、 第一百五十四条 第一款 第 （ 五 ） 项 的 规定 ， 裁定 如下 ： 

阿呷某某与阿木某某离婚纠纷一审民事裁定书.txt	依照 《 中华人民共和国 民事 诉讼法 》 第十三条 第二款 ， 第 一百四十 五条 第一款 ， 第一百五十四条 第一款 第 （ 五 ） 项 的 规定 ， 裁定 如下 ： 

陈某与任某某离婚纠纷一审民事裁定书.txt	依照 《 中华人民共和国 民事 诉讼法 》 第 一百四十 五条 第一款 、 第一百五十四条 第一款 第 （ 五 ） 项之 规定 ， 裁定 如下 ： 

陈某与梁某某离婚纠纷一审民事裁定书.txt	依照 《 中华人民共和国 民事 诉讼法 》 第 一百四十 三条 、 第一百五十四条 第一款 （ 十一 ） 项之 规定 ， 裁定 如下 ： 

陈某某与熊某某离婚纠纷一审民事裁定书.txt	依照 《 中华人民共和国 民事 诉讼法 》 第 一百四十 五条 第一款 、 第一百五十四条 第一款 第 （ 五 ） 项 的 规定 ， 裁定 如下 ： 

陈某某与王某某离婚纠纷一审民事裁定书.txt	依照 《 中华人民共和国 民事 诉讼法 》 第十三条 第二款 、 第 一百四十 五条 第一款 、 第一百五十四条 第一款 第 （ 五 ） 项之 规定 ， 裁定 如下 ： 

陈某某与谭某某离婚后财产纠纷一审民事裁定书.txt	依照 《 中华人民共和国 民事 诉讼法 》 第 一百四十 五条 第一款 、 第一百五十四条 第一款 第 （ 五 ） 项之 规定 ， 裁定 如下 ： 

陈某某与郑某某离婚纠纷一审民事裁定书.txt	依照 《 中华人民共和国 民事 诉讼法 》 第 一百四十 五条 第一款 、 第一百五十四条 第 （ 五 ） 项之 规定 , 裁定 如下 ： 

陈某某诉涂某某离婚纠纷一审民事裁定书.txt	依照 《 中华人民共和国 民事 诉讼法 》 第 一百四十 五条 第一款 、 第一百五十四条 第一款 第 （ 五 ） 项 的 规定 ， 裁定 如下 ： 

陈某甲与陈某乙离婚纠纷一审民事裁定书.txt	依照 《 中华人民共和国 民事 诉讼法 》 第 一百四十 五条 、 第一百五十四条 第一款 第 （ 五 ） 项之 规定 ， 裁定 如下 ： 

陈碧英与王永东离婚纠纷一审民事裁定书.txt	据此 ， 依照 《 中华人民共和国 民事 诉讼法 》 第 一百四十 五条 第一款 、 第一百五十四条 第一款 第 （ 五 ） 项之 规定 ， 裁定 如下 ： 

顾某与黄某离婚纠纷一审民事裁定书.txt	依照 《 中华人民共和国 民事 诉讼法 》 第 一百四十 五条 第一款 、 第一百五十四条 第一款 第 （ 五 ） 项之 规定 ， 裁定 如下 ： 

顾某某与林某某离婚纠纷案一审民事裁定书.txt	依照 《 中华人民共和国 民事 诉讼法 》 第 一百四十 五条 第一款 、 第一百五十四条 第一款 （ 五 ） 项之 规定 ， 裁定 如下 ： 

马某某与曾某某离婚纠纷一审民事裁定书.txt	依照 《 中华人民共和国 民事 诉讼法 》 第 一百四十 五条 、 第一百五十四条 第一款 第 （ 五 ） 项之 规定 ， 裁定 如下 ： 

马某某与王某某关于离婚后财产纠纷一审民事裁定书.txt	依照 《 中华人民共和国 民事 诉讼法 》 第 一百四十 五条 、 第一百五十四条 的 规定 ， 裁定 如下 ： 

马某某与邓某某离婚纠纷一案一审裁定书.txt	依照 《 中华人民共和国 民事 诉讼法 》 第 一百四十 五条 、 第一百五十四条 （ 五 ） 项 的 规定 ， 裁定 如下 ： 

高某某与黄某某离婚纠纷案一审民事裁定书.txt	依照 《 中华人民共和国 民事 诉讼法 》 第 一百四十 五条 、 第一百五十四条 （ 五 ） 项 的 规定 ， 裁定 如下 ： 

魏某某与杨某某离婚纠纷一审民事裁定书.txt	依照 《 中华人民共和国 民事 诉讼法 》 第 一百四十 五条 第一款 、 第一百五十四条 第一款 第 （ 五 ） 项之 规定 ， 裁定 如下 ： 

魏某某与王某某离婚纠纷案一审民事裁定书.txt	依照 《 中华人民共和国 民事 诉讼法 》 第 一百四十 五条 、 第一百五十四条 一款 （ 五 ） 项之 规定 ， 裁定 如下 ： 

魏某某与秦某某离婚纠纷一审民事裁定书.txt	依照 《 中华人民共和国 民事 诉讼法 》 第 一百四十 五条 第一款 、 第一百五十四条 第一款 第 （ 五 ） 项之 规定 ， 裁定 如下 ： 

魏某某与董某某离婚纠纷一审民事裁定书.txt	依照 《 中华人民共和国 民事 诉讼法 》 第 一百四十 五条 第一款 、 第一百五十四条 第一款 第 （ 五 ） 项之 规定 ， 裁定 如下 ： 

鲁某某诉徐某某离婚纠纷一审民事裁定书.txt	依照 《 中华人民共和国 民事 诉讼法 》 第 一百四十 五条 第一款 、 第一百五十四条 第一款 （ 五 ） 项之 规定 ， 裁定 如下 ： 

黃某某与林某某离婚糾紛一审民事裁定书.txt	依照 《 中华人民共和国 民事 诉讼法 》 第 一百四十 五条 第一款 、 第一百五十四条 第一款 （ 五 ） 项之 规定 ， 裁定 如下 ： 

黄某某与任某离婚纠纷一案一审裁定书.txt	依照 《 中华人民共和国 民事 诉讼法 》 第 一百四十 五条 第一款 、 第一百五十四条 （ 五 ） 项 的 规定 ， 裁定 如下 ： 

黄某某与唐某某离婚纠纷一审民事裁定书.txt	据此 ， 依照 《 中华人民共和国 民事 诉讼法 》 第 一百四十 五条 第一款 、 第一百五十四条 第一款 第 （ 五 ） 项之 规定 ， 裁定 如下 ： 

黄某某与张某某离婚纠纷一审民事裁定书.txt	依照 《 中华人民共和国 民事 诉讼法 》 第 一百四十 五条 第一款 和 第一百五十四条 第一款 （ 五 ） 项之 规定 裁定 如下 ： 

黄某某与张某某离婚纠纷案一审民事裁定书.txt	根据 《 中华人民共和国 民事 诉讼法 》 第 一百四十 五条 、 第一百五十四条 第一款 （ 五 ） 项 的 规定 ， 裁定 如下 ： 

黄某某与杨某某离婚纠纷一审民事裁定书.txt	依照 《 中华人民共和国 民事 诉讼法 》 第 一百四十 五条 第一款 、 第一百五十 四 第一款 第 （ 五 ） 项之 规定 ， 裁定 如下 ： 

黄某某与白某某离婚纠纷一审民事裁定书.txt	依照 《 中华人民共和国 民事 诉讼法 》 第 一百四十 五条 第一款 、 第一百五十四条 第一款 第 （ 五 ） 项之 规定 ， 裁定 如下 ： 

黄某某与蒋某某离婚纠纷一审民事裁定书.txt	根据 《 中华人民共和国 民事 诉讼法 》 第一百五十四条 第一款 第 （ 五 ） 项之 规定 ， 裁定 如下 ： 

黄某某诉罗某某离婚纠纷一审民事裁定书.txt	依照 《 中华人民共和国 民事 诉讼法 》 第 一百四十 五条 第一款 、 第一百五十四条 第一款 第 （ 五 ） 项 的 规定 ， 裁定 如下 ： 

黄某甲与杨某某离婚纠纷一审民事裁定书.txt	依照 《 中华人民共和国 民事 诉讼法 》 第 一百四十 五条 、 第一百五十四条 第一款 第 （ 五 ） 项之 规定 ， 裁定 如下 ： 

黄某诉唐某某离婚纠纷案(2016)川1028民初1232号一审裁定书.txt	依照 《 中华人民共和国 民事 诉讼法 》 第 一百四十 五条 第一款 和 第一百五十四条 第 （ 五 ） 项 的 规定 ， 裁定 如下 ： 

龙某某与周某某离婚纠纷案一审民事裁定书.txt	依照 《 中华人民共和国 民事 诉讼法 》 第 一百四十 五条 、 第一百五十四条 第一款 （ 五 ） 项之 规定 ， 裁定 如下 ： 

龚某与王某离婚纠纷案一审民事裁定书.txt	根据 《 中华人民共和国 民事 诉讼法 》 第 一百四十 五条 第一款 、 第一百五十四条 第一款 第 （ 五 ） 项之 规定 ， 裁定 如下 ： 

龚某某与杜某某离婚纠纷一案一审裁定书.txt	依照 《 中华人民共和国 民事 诉讼法 》 第 一百四十 五条 第一款 、 第一百五十四条 第一款 第 （ 五 ） 项 的 规定 ， 裁定 如下 ： 
