万某某与王某某离婚纠纷一审民事判决书.txt	据此 ， 依照 《 中华人民共和国 民事 诉讼法 》 第六十四 条 第一款 、 《 中华人民共和国 婚姻法 》 第三十二条 的 规定 ， 判决 如下 ： 

万某诉余某离婚纠纷民事一审判决书.txt	据此 ， 依照 《 中华人民共和国 婚姻法 》 第三十二条 、 《 中华人民共和国 民事 诉讼法 》 第 一百四十四 条 之 规定 ， 判决 如下 ： 

严某与李某某离婚纠纷一审民事判决书.txt	依照 《 中华人民共和国 婚姻法 》 第三十二条 之 规定 ， 判决 如下 ： 

于某与苏某某离婚纠纷案一审民事判决书.txt	据此 ， 依照 《 中华人民共和国 婚姻法 》 第三十二条 及 《 中华人民共和国 民事 诉讼法 》 第 一百四十四 条 之 规定 ， 判决 如下 ： 

付某某与张某某离婚纠纷一审民事判决书.txt	依照 《 中华人民共和国 婚姻法 》 第三十二条 之 规定 ， 判决 如下 ： 

任某某与杜某离婚纠纷一审民事判决书.txt	依照 《 中华人民共和国 婚姻法 》 第三十二条 ， 《 中华人民共和国 民事 诉讼法 》 第六十四 条 的 规定 ， 判决 如下 ： 

伍某某与李某某离婚纠纷一审民事判决书.txt	据此 ， 依照 《 中华人民共和国 婚姻法 》 第三十二条 之 规定 ， 判决 如下 ： 

伏某甲与伏某乙离婚纠纷一审民事判决书.txt	依照 《 中华人民共和国 民事 诉讼法 》 第六十四 条 一款 、 第 一百四十四 条 之 规定 ， 判决 如下 ： 

何文艳与冯全离婚纠纷一审民事判决书.txt	据此 ， 依照 《 中华人民共和国 婚姻法 》 第三十二条 之 规定 ， 判决 如下 ： 

何某某与任某某离婚纠纷一审民事判决书.txt	据此 ， 依照 《 中华人民共和国 婚姻法 》 第三十二条 之 规定 ， 判决 如下 ： 

何某某与何某甲离婚纠纷一审民事判决书.txt	依照 《 中华人民共和国 婚姻法 》 第三十二条 、 《 中华人民共和国 民事 诉讼法 》 第 一百四十四 条 之 规定 ， 判决 如下 ： 

何某某与刘某某离婚纠纷一审民事判决书.txt	据此 、 依照 《 中华人民共和国 婚姻法 》 第三十二条 之 规定 ， 判决 如下 ： 

何某某与唐某甲离婚纠纷一审民事判决书.txt	依照 《 中华人民共和国 婚姻法 》 第三十二条 之 规定 ， 判决 如下 ： 

何某某与徐某离婚纠纷一审民事判决书.txt	据此 ， 依照 《 中华人民共和国 婚姻法 》 第三十二条 ， 《 中华人民共和国 民事 诉讼法 》 第六十四 条 、 第 一百四十四 条 之 规定 ， 判决 如下 ： 

何某某与曾某甲离婚纠纷一审民事判决书.txt	依照 《 中华人民共和国 婚姻法 》 第三十二条 、 《 中华人民共和国 民事 诉讼法 》 第六十四 条 之 规定 ， 判决 如下 ： 

何某某与李某某离婚纠纷一审民事判决书.txt	依照 《 中华人民共和国 婚姻法 》 第三十二条 之 规定 ， 判决 如下 ： 

何某某与董某甲离婚纠纷一审民事判决书.txt	据此 ， 依照 《 中华人民共和国 婚姻法 》 第三十二条 、 《 中华人民共和国 民事 诉讼法 》 第六十四 条 之 规定 ， 判决 如下 ： 

何某某与被告魏某某离婚纠纷民事一审判决书.txt	据此 ， 依照 《 中华人民共和国 婚姻法 》 第三十二条 、 《 中华人民共和国 民事 诉讼法 》 第六十四 之 规定 ， 判决 如下 ： 

何某某与谢某甲离婚纠纷一审民事判决书.txt	依照 《 中华人民共和国 婚姻法 》 第三十二条 、 《 中华人民共和国 民事 诉讼法 》 第六十四 条 第一款 之 规定 ， 判决 如下 ： 

何某某与邓某某离婚纠纷案一审民事判决书.txt	依照 《 中华人民共和国 婚姻法 》 第三十二条 ， 《 中华人民共和国 民事 诉讼法 》 第 一百四十四 条 之 规定 ， 判决 如下 ： 

何某某与钟某某离婚纠纷一审民事判决书.txt	据此 ， 依照 《 中华人民共和国 婚姻法 》 第三十二条 之 规定 ， 判决 如下 ： 

何某某与马某某离婚纠纷一审民事判决书.txt	据此 ， 依照 《 中华人民共和国 婚姻法 》 第三十二条 之 规定 ， 判决 如下 ： 

何某某诉杨某某离婚纠纷一审民事判决书.txt	依照 《 中华人民共和国 婚姻法 》 第三十二条 、 《 中华人民共和国 民事 诉讼法 》 第六十四 条 之 规定 ， 判决 如下 ： 

何某甲与丁某某离婚纠纷一审民事判决书.txt	依照 《 中华人民共和国 婚姻法 》 第三十二条 之 规定 ， 判决 如下 ： 

何某甲与杨某离婚纠纷一审民事判决书.txt	据此 ， 依照 《 中华人民共和国 婚姻法 》 第三十二条 和 《 中华人民共和国 民事 诉讼法 》 第六十四 条 的 规定 ， 判决 如下 ： 

余某某诉晏某甲离婚纠纷一审民事判决书.txt	据此 ， 依照 《 中华人民共和国 婚姻法 》 第三十二条 第二款 、 《 中华人民共和国 民事 诉讼法 》 第六十四 条 的 规定 ， 判决 如下 ： 

倪某某与肖某离婚纠纷一审民事判决书.txt	据此 ， 判决 如下 ： 

兰某某与李某某离婚纠纷一审民事判决书.txt	依照 《 中华人民共和国 民事 诉讼法 》 第 一百四十四 条 ， 《 中华人民共和国 婚姻法 》 第三十二条 之 规定 ， 缺席判决 如下 ： 

兰某某与黄某甲离婚纠纷一审民事判决书.txt	依照 《 中华人民共和国 婚姻法 》 第三十二条 之 规定 ， 判决 如下 ： 

冯某某与李某某离婚纠纷一审民事判决书.txt	据此 根据 《 中华人民共和国 民事 诉讼法 》 第六十四 条 之 规定 ， 判决 如下 ： 

冯某某与王某某离婚纠纷一审民事判决书.txt	据此 ， 依照 《 中华人民共和国 婚姻法 》 第三十二条 ， 《 中华人民共和国 民事 诉讼法 》 第六十四 条 之 规定 ， 判决 如下 ： 

冯某甲诉张某甲离婚纠纷民事判决书.txt	依照 《 中华人民共和国 婚姻法 》 第三十二条 之 规定 ， 判决 如下 ： 

刘某与唐某某离婚纠纷一审民事判决书.txt	依照 《 中华人民共和国 婚姻法 》 第三十二条 之 规定 ， 判决 如下 ： 

刘某与尹某离婚纠纷案一审民事判决书.txt	据此 ， 依照 《 中华人民共和国 婚姻法 》 第三十二条 ， 《 中华人民共和国 民事 诉讼法 》 第六十四 条 第一款 之 规定 ， 判决 如下 ： 

刘某某与李某某离婚纠纷一审民事判决书.txt	依照 《 中华人民共和国 婚姻法 》 第三十二条 、 《 中华人民共和国 民事 诉讼法 》 第 一百四十四 条 之 规定 ， 判决 如下 ： 

刘某某与沈某某离婚纠纷一审民事判决书.txt	据此 、 依照 《 中华人民共和国 婚姻法 》 第三十二条 之 规定 ， 判决 如下 ： 

刘某某与熊某某离婚纠纷一案一审民事判决书.txt	依照 《 中华人民共和国 婚姻法 》 第三十二条 、 《 中华人民共和国 民事 诉讼法 》 第六十四 条 之 规定 ， 判决 如下 ： 

刘某某与阳某离婚纠纷一审民事判决书.txt	依照 《 中华人民共和国 婚姻法 》 第三十二条 、 第三十六条 、 《 中华人民共和国 民事 诉讼法 》 第 一百四十四 条 之 规定 ， 判决 如下 ： 

刘某某与陈某甲离婚纠纷一审民事判决书.txt	依照 《 中华人民共和国 婚姻法 》 第三十二条 之 规定 判决 如下 ： 

刘某某诉吕某甲离婚纠纷一审民事判决书.txt	据此 ， 依照 《 中华人民共和国 婚姻法 》 第三十二条 的 规定 ， 判决 如下 ： 

刘某某诉干某离婚纠纷案一审民事判决书.txt	据此 ， 依照 《 中华人民共和国 婚姻法 》 第三十二条 ， 《 中华人民共和国 民事 诉讼法 》 第六十四 条 之 规定 ， 判决 如下 ： 

刘某某诉赵某某离婚纠纷一案民事判决书.txt	据此 ， 依照 《 中华人民共和国 婚姻法 》 第三十二条 、 《 中华人民共和国 民事 诉讼法 》 第 一百四十四 条 之 规定 ， 判决 如下 ： 

刘某甲与刘某乙离婚纠纷一审民事判决书.txt	据此 ， 依照 《 中华人民共和国 民事 诉讼法 》 第六十四 条 、 《 中华人民共和国 婚姻法 》 第三十二条 之 规定 ， 判决 如下 ： 

刘某甲与林某某离婚纠纷一审民事判决书.txt	依照 《 中华人民共和国 婚姻法 》 第三十二条 第二款 第四项 、 《 中华人民共和国 民事 诉讼法 》 第六十四 条 、 第 一百四十四 条 之 规定 ， 判决 如下 ： 

刘某甲与樊某甲离婚纠纷一审民事判决书.txt	据此 ， 依照 《 中华人民共和国 婚姻法 》 第三十二条 以及 《 中华人民共和国 民事 诉讼法 》 第 一百四十四 条 之 规定 ， 判决 如下 ： 

刘某诉王某离婚纠纷一审民事判决书.txt	依照 《 中华人民共和国 婚姻法 》 第三十二条 、 《 中华人民共和国 民事 诉讼法 》 第六十四 条 之 规定 ， 判决 如下 ： 

刘某诉贾某某离婚纠纷一审民事判决书.txt	依照 《 中华人民共和国 婚姻法 》 第三十二条 之 规定 ， 判决 如下 ： 

勾某某与何某某离婚纠纷案一审民事判决书.txt	依照 《 中华人民共和国 婚姻法 》 第三十二条 ， 《 中华人民共和国 民事 诉讼法 》 第 一百四十四 条 之 规定 ， 判决 如下 ： 

匡光荣与张书珍离婚纠纷一审民事判决书.txt	依照 《 中华人民共和国 婚姻法 》 第三十二条 之 规定 ， 判决 如下 ： 

卢某某与赵某某离婚纠纷一审民事判决书.txt	据此 ， 根据 《 中华人民共和国 婚姻法 》 第三十二条 及 《 中华人民共和国 民事 诉讼法 》 第 一百四十四 条 之 规定 ， 判决 如下 ： 

卢某某与马某甲离婚纠纷一审民事判决书.txt	依照 《 中华人民共和国 婚姻法 》 第三十二条 之 规定 ， 判决 如下 ： 

卢某甲与付某某离婚纠纷一审民事判决书.txt	据此 ， 本院 根据 《 中华人民共和国 婚姻法 》 第三十二条 、 《 中华人民共和国 民事 诉讼法 》 第六十四 条 之 规定 ， 判决 如下 ： 

原告任某某诉被告张某某离婚纠纷一案一审民事判决书.txt	依照 《 中华人民共和国 婚姻法 》 第三十二条 之 规定 ， 判决 如下 ： 

原告何某某诉被告向某某离婚纠纷一案民事判决书.txt	据此 ， 依照 《 中华人民共和国 婚姻法 》 第三十二条 和 《 中华人民共和国 民事 诉讼法 》 第六十四 条 第一款 之 规定 ， 判决 如下 ： 

原告何某某诉被告李某某离婚纠纷一案民事判决书.txt	据此 ， 依照 《 中华人民共和国 婚姻法 》 第三十二条 和 《 中华人民共和国 民事 诉讼法 》 第六十四 条 第一款 、 第 一百四十四 条 之 规定 ， 判决 如下 ： 

原告何某某诉被告王某某离婚纠纷一案一审民事判决书.txt	依照 《 中华人民共和国 婚姻法 》 第三十二条 ， 判决 如下 ： 

原告何某某诉被告邓某某离婚纠纷一案民事判决书.txt	据此 ， 依照 《 中华人民共和国 婚姻法 》 第三十二条 和 《 中华人民共和国 民事 诉讼法 》 第六十四 条 第一款 之 规定 ， 判决 如下 ： 

原告何某诉被告邓某离婚纠纷一案民事判决书.txt	据此 ， 依照 《 中华人民共和国 婚姻法 》 第三十二条 和 《 中华人民共和国 民事 诉讼法 》 第六十四 条 第一款 之 规定 ， 判决 如下 ： 

原告余某某诉被告李某某离婚纠纷一审民事判决书.txt	据此 ， 判决 如下 ： 

原告侯某甲诉被告邵某甲离婚纠纷一案一审民事判决书.txt	据此 ， 依照 《 中华人民共和国 婚姻法 》 第三十二条 和 《 中华人民共和国 民事 诉讼法 》 第六十四 条 第一款 、 第 一百四十四 条 之 规定 ， 判决 如下 ： 

原告冯某某诉被告杨某某离婚纠纷一案一审民事判决书.txt	据此 ， 依照 《 中华人民共和国 婚姻法 》 第三十二条 之 规定 ， 判决 如下 ： 

原告刘俊芬诉被告张斗亮离婚纠纷一审民事判决书.txt	据此 ， 依照 《 中华人民共和国 民事 诉讼法 》 第六十四 条 第一款 和 《 中华人民共和国 婚姻法 》 第三十二条 之 规定 ， 判决 如下 ： 

原告刘某某诉被告袁某某离婚纠纷一案民事判决书.txt	据此 ， 依照 《 中华人民共和国 婚姻法 》 第三十二条 和 《 中华人民共和国 民事 诉讼法 》 第 一百四十四 条 之 规定 ， 判决 如下 ： 

原告刘某某诉被告赵某某离婚纠纷一案一审民事判决书.txt	据此 ， 依照 《 中华人民共和国 婚姻法 》 第三十二条 之 规定 ， 判决 如下 ： 

原告刘某某诉被告郑某某离婚纠纷一案一审民事判决书.txt	据此 ， 依照 《 中华人民共和国 婚姻法 》 第三十二条 和 《 中华人民共和国 民事 诉讼法 》 第六十四 条 第一款 之 规定 ， 判决 如下 ： 

原告刘某诉被告朱某某离婚纠纷一案一审民事判决书.txt	依照 《 中华人民共和国 婚姻法 》 第三十二条 、 《 中华人民共和国 民事 诉讼法 》 第六十四 条 之 规定 ， 判决 如下 ： 

原告刘某诉被告李某甲离婚纠纷一案民事一审判决书.txt	据此 ， 依照 《 中华人民共和国 婚姻法 》 第三十二条 和 《 中华人民共和国 民事 诉讼法 》 第六十四 条 第一款 之 规定 ， 判决 如下 ： 

原告华某某诉被告雷某离婚纠纷一案民事判决书.txt	据此 ， 依照 《 中华人民共和国 婚姻法 》 第三十二条 和 《 中华人民共和国 民事 诉讼法 》 第六十四 条 第一款 之 规定 ， 判决 如下 ： 

原告卢某某诉被告何某某“离婚纠纷”一案民事判决书.txt	依照 《 中华人民共和国 婚姻法 》 第三十二条 之 规定 ， 判决 如下 ： 

原告吴某某诉被告刘某甲离婚纠纷一审民事判决书.txt	据此 ， 依照 《 中华人民共和国 婚姻法 》 第三十二条 第二款 之 规定 ， 判决 如下 ： 

原告吴某诉被告罗某某离婚纠纷一案民事判决书.txt	据此 ， 依照 《 中华人民共和国 婚姻法 》 第三十二条 和 《 中华人民共和国 民事 诉讼法 》 第六十四 条 第一款 、 第 一百四十四 条 之 规定 ， 判决 如下 ： 

原告周某某与被告刘某某离婚纠纷一审民事判决书.txt	据此 ， 依照 《 中华人民共和国 婚姻法 》 第三十二条 、 《 中华人民共和国 民事 诉讼法 》 第 一百四十四 条 之 规定 ， 缺席判决 如下 ： 

原告周某某与被告魏某某离婚纠纷一案的民事判决书.txt	依照 《 中华人民共和国 婚姻法 》 第三十二条 之 规定 ， 判决 如下 ： 

原告周某某与黄某甲离婚纠纷一审民事判决书.txt	依照 《 中华人民共和国 婚姻法 》 第三十二条 第一款 ， 《 中华人民共和国 民事 诉讼法 》 第六十四 条 第一款 、 第 一百四十四 条 之 规定 ， 缺席判决 如下 ： 

原告周某某诉被告闫某离婚纠纷一案一审民事判决书.txt	依照 《 中华人民共和国 婚姻法 》 第三十二条 第二款 ， 《 中华人民共和国 民事 诉讼法 》 第六十四 条 之 规定 ， 判决 如下 ： 

原告唐某诉被告陈某某离婚纠纷一案一审民事判决书.txt	据此 ， 依照 《 中华人民共和国 婚姻法 》 第三十二条 和 《 中华人民共和国 民事 诉讼法 》 第六十四 条 第一款 、 第 一百四十四 条 之 规定 ， 判决 如下 ： 

原告夏某某与被告蒋某某离婚纠纷一案一审民事判决书.txt	依照 《 中华人民共和国 婚姻法 》 第三十二条 第二款 、 《 中华人民共和国 民事 诉讼法 》 第六十四 条 第一款 之 规定 ， 判决 如下 ： 

原告宋某某与被告吴某某离婚纠纷一审民事判决书.txt	据此 ， 根据 《 中华人民共和国 婚姻法 》 第三十二条 ， 《 中华人民共和国 民事 诉讼法 》 第六十四 条 、 第 一百四十四 条 之 规定 ， 判决 如下 ： 

原告崔某某与被告肖某某离婚纠纷一案的民事判决书.txt	依照 《 中华人民共和国 婚姻法 》 第三十二条 之 规定 ， 判决 如下 ： 

原告廖某某诉被告唐某离婚纠纷一案一审民事判决书.txt	据此 ， 依照 《 中华人民共和国 婚姻法 》 第三十二条 和 《 中华人民共和国 民事 诉讼法 》 第六十四 条 第一款 、 第 一百四十四 条 之 规定 ， 判决 如下 ： 

原告张XX诉被告邓XX离婚纠纷一案一审民事判决书.txt	据此 ， 依照 《 中华人民共和国 婚姻法 》 第三十二条 和 《 中华人民共和国 民事诉讼 》 第六十四 条 之 规定 ， 判决 如下 ： 

原告张某某与被告曾某甲离婚纠纷一审民事判决书.txt	据此 ， 依照 《 中华人民共和国 婚姻法 》 第三十二条 、 《 中华人民共和国 民事 诉讼法 》 第 一百四十四 条 之 规定 ， 缺席判决 如下 ： 

原告张某某与被告聂某某“离婚纠纷”一案民事判决书.txt	依照 《 中华人民共和国 民事 诉讼法 》 第六十四 条 、 《 中华人民共和国 婚姻法 》 第三十二条 之 规定 ， 判决 如下 ： 

原告张某某诉肖某某离婚纠纷案一审民事判决书.txt	依照 《 中华人民共和国 婚姻法 》 第三十二条 、 《 中华人民共和国 民事 诉讼法 》 第六十四 条 之 规定 ， 判决 如下 ： 

原告张某某诉被告侯某某离婚纠纷一案民事判决书.txt	据此 ， 依照 《 中华人民共和国 婚姻法 》 第三十二条 和 《 中华人民共和国 民事 诉讼法 》 第六十四 条 第一款 之 规定 ， 判决 如下 ： 

原告张某甲与被告程某甲离婚纠纷一案一审民事判决书.txt	依照 《 中华人民共和国 婚姻法 》 第三十二条 之 规定 ， 判决 如下 ： 

原告彭小兰与被告冯玉平离婚纠纷一案一审判决书.txt	据此 ， 依照 《 中华人民共和国 民事 诉讼法 》 第六十四 条 、 《 中华人民共和国 婚姻法 》 第三十二条 之 规定 ， 判决 如下 ： 

原告徐某某诉被告韩某某离婚纠纷一案一审民事判决书.txt	依照 《 中华人民共和国 婚姻法 》 第三十二条 第二款 和 《 中华人民共和国 民事 诉讼法 》 第六十四 条 第一款 的 规定 ， 判决 如下 ： 

原告文某诉被告舒某甲离婚纠纷一案一审民事判决书.txt	依照 《 中华人民共和国 婚姻法 》 第三十二条 及 《 中华人民共和国 民事 诉讼法 》 第六十四 条 第一款 之 规定 ， 判决 如下 ： 

原告曹某某诉被告李某某离婚纠纷一案民事判决书.txt	据此 ， 依照 《 中华人民共和国 婚姻法 》 第三十二条 和 《 中华人民共和国 民事 诉讼法 》 第六十四 条 第一款 之 规定 ， 判决 如下 ： 

原告曹某诉被告刘某离婚纠纷一案一审民事判决书.txt	据此 ， 依照 《 中华人民共和国 婚姻法 》 第三十二条 和 《 中华人民共和国 民事 诉讼法 》 第六十四 条 第一款 之 规定 ， 判决 如下 ： 

原告曾某某诉被告龙某某离婚纠纷案一审民事判决书.txt	依照 《 中华人民共和国 婚姻法 》 第三十二条 、 《 中华人民共和国 民事 诉讼法 》 第六十四 条 、 第 一百四十四 条 之 规定 ， 判决 如下 ： 

原告曾某甲诉被告王某某离婚纠纷一案一审民事判决书.txt	据此 ， 依照 《 中华人民共和国 婚姻法 》 第三十二条 之 规定 ， 判决 如下 ： 

原告曾某诉被告陈某离婚纠纷一审判决书.txt	据此 ， 依照 《 中华人民共和国 婚姻法 》 第三十二条 、 《 中华人民共和国 民事 诉讼法 》 第六十四 条 之 规定 ， 判决 如下 ： 

原告朱某与被告张某离婚纠纷一案的民事判决书.txt	据此 依照 《 中华人民共和国 婚姻法 》 第三十二条 之 规定 判决 如下 ： 

原告朱某诉被告张某离婚纠纷一案一审民事判决书.txt	依照 《 中华人民共和国 婚姻法 》 第三十二条 第二款 、 《 中华人民共和国 民事 诉讼法 》 第六十四 条 第一款 、 第 一百四十四 条 之 规定 ， 缺席判决 如下 ： 

原告李XX诉被告洪XX离婚纠纷一案一审民事判决书.txt	据此 ， 依照 《 中华人民共和国 婚姻法 》 第三十二条 第二款 及 《 中华人民共和国 民事 诉讼法 》 第六十四 条 第一款 之 规定 ， 判决 如下 ： 

原告李某某与被告孙某某甲离婚纠纷一案一审民事判决书.txt	依照 《 中华人民共和国 婚姻法 》 第三十二条 之 规定 ， 判决 如下 ： 

原告李某某诉被告张某某离婚纠纷一审民事判决书.txt	依照 《 中华人民共和国 婚姻法 》 第三十二条 第二款 和 《 中华人民共和国 民事 诉讼法 》 第六十四 条 第一款 的 规定 ， 判决 如下 ： 

原告李某某诉被告张某甲离婚纠纷一案一审民事判决书.txt	据此 ， 依照 《 中华人民共和国 婚姻法 》 第三十二条 ， 《 中华人民共和国 民事 诉讼法 》 第六十四 条 第一款 、 第 一百四十四 条 之 规定 ， 判决 如下 ： 

原告李某某诉被告杨某某离婚纠纷一案一审民事判决书.txt	据此 ， 依照 《 中华人民共和国 婚姻法 》 第二十条 、 第三十二条 ， 《 中华人民共和国 民事 诉讼法 》 第六十四 条 、 第 一百四十四 条 的 规定 ， 判决 如下 ： 

原告李某某诉被告高某甲离婚纠纷一案一审民事判决书.txt	据此 ， 依照 《 中华人民共和国 婚姻法 》 第三十二条 ， 判决 如下 ： 

原告李某某诉陈某某离婚纠纷一案一审民事判决书.txt	据此 ， 根据 《 中华人民共和国 婚姻法 》 第三十二条 ， 《 中华人民共和国 民事 诉讼法 》 第六十四 条 之 规定 ， 判决 如下 ： 

原告李某诉被告赵某某离婚纠纷一案一审民事判决书.txt	据此 ， 依照 《 中华人民共和国 婚姻法 》 第三十二条 和 《 中华人民共和国 民事 诉讼法 》 第六十四 条 第一款 、 第 一百四十四 条 之 规定 ， 判决 如下 ： 

原告杨XX诉被告唐XX离婚纠纷一案一审民事判决书.txt	据此 ， 依照 《 中华人民共和国 婚姻法 》 第三十二条 第二款 和 《 中华人民共和国 民事诉讼 》 第六十四 条 第一款 之 规定 ， 判决 如下 ： 

原告杨某与被告文某甲离婚纠纷一审民事判决书.txt	据此 ， 依照 《 中华人民共和国 婚姻法 》 第三十二条 第二款 之 规定 ， 判决 如下 ： 

原告杨某某诉被告曾某某离婚纠纷一案一审判决书.txt	据此 ， 依照 《 中华人民共和国 婚姻法 》 第三十二条 之 规定 ， 判决 如下 ： 

原告杨某某诉被告高某某离婚纠纷一案一审民事判决书.txt	据此 ， 依照 《 中华人民共和国 婚姻法 》 第三十二条 第二款 、 《 中华人民共和国 民事 诉讼法 》 第 一百四十四 条 之 规定 ， 判决 如下 ： 

原告杨某甲与被告马某甲离婚纠纷一案一审民事判决书.txt	依照 《 中华人民共和国 婚姻法 》 第三十二条 之 规定 ， 判决 如下 ： 

原告林某甲诉被告李某甲离婚纠纷一案一审民事判决书.txt	据此 ， 依照 《 中华人民共和国 婚姻法 》 第三十二条 和 《 中华人民共和国 民事 诉讼法 》 第 一百四十四 之 规定 ， 判决 如下 ： 

原告段某甲诉被告李某甲离婚纠纷一案一审民事判决书.txt	据此 ， 依照 《 中华人民共和国 婚姻法 》 第三十二条 和 《 中华人民共和国 民事 诉讼法 》 第 一百四十四 之 规定 ， 判决 如下 ： 

原告沈某某与被告王某某甲离婚纠纷一案一审民事判决书.txt	依照 《 中华人民共和国 婚姻法 》 第三十二条 之 规定 ， 判决 如下 ： 

原告王某某与被告李某某离婚纠纷一案一审民事判决书.txt	据此 ， 依照 《 中华人民共和国 婚姻法 》 第三十二条 ， 《 中华人民共和国 民事 诉讼法 》 第 一百四十四 条 的 规定 ， 判决 如下 ： 

原告王某某与被告赵某某离婚纠纷一案一审民事判决书.txt	依照 《 中华人民共和国 婚姻法 》 第三十二条 第二款 ， 《 中华人民共和国 民事 诉讼法 》 第六十四 条 第一款 、 第 一百四十四 条 之 规定 ， 缺席判决 如下 ： 

原告王某某诉被告甘某甲离婚纠纷一案一审民事判决书.txt	据此 ， 依照 《 中华人民共和国 婚姻法 》 第三十二条 、 《 中华人民共和国 民事 诉讼法 》 第六十四 条 第一款 的 规定 ， 判决 如下 ： 

原告王某某诉被告胡某某离婚纠纷一案民事判决书.txt	据此 ， 依照 《 中华人民共和国 婚姻法 》 第三十二条 和 《 中华人民共和国 民事 诉讼法 》 第六十四 条 第一款 之 规定 ， 判决 如下 ： 

原告王某某诉被告许某离婚纠纷一审民事判决书.txt	据此 ， 判决 如下 ： 

原告王某甲诉被告滕某某离婚纠纷一案一审民事判决书.txt	据此 ， 依照 《 中华人民共和国 婚姻法 》 第三十二条 和 《 中华人民共和国 民事 诉讼法 》 第六十四 条 第一款 之 规定 ， 判决 如下 ： 

原告王某诉被告李某甲离婚纠纷一案一审民事判决书.txt	据此 ， 依照 《 中华人民共和国 婚姻法 》 第三十二条 和 《 中华人民共和国 民事 诉讼法 》 第 一百四十四 之 规定 ， 判决 如下 ： 

原告甘某某与被告郭某某离婚纠纷一审民事判决书.txt	据此 ， 依照 《 中华人民共和国 婚姻法 》 第三十二条 、 《 中华人民共和国 民事 诉讼法 》 第六十四 条 、 第 一百四十四 条 之 规定 ， 判决 如下 ： 

原告石某某诉被告熊某甲离婚纠纷案一审民事判决书.txt	依照 《 中华人民共和国 婚姻法 》 第三十二条 、 《 中华人民共和国 民事 诉讼法 》 第六十四 条 之 规定 ， 判决 如下 ： 

原告罗某某与被告兰某甲离婚纠纷一案一审民事判决书.txt	依照 《 中华人民共和国 婚姻法 》 第三十二条 之 规定 ， 判决 如下 ： 

原告罗某某诉被告滕某某“离婚纠纷”一案民事判决书.txt	依照 《 中华人民共和国 民事 诉讼法 》 第 一百四十四 条 、 《 中华人民共和国 婚姻法 》 第三十二条 之 规定 ， 判决 如下 ： 

原告罗某某诉被告陈某某离婚纠纷一审民事判决书.txt	据此 ， 依照 依照 《 中华人民共和国 民事 诉讼法 》 第六十四 条 、 《 中华人民共和国 婚姻法 》 第三十二条 之 规定 ， 判决 如下 ： 

原告罗某诉被告徐某某离婚纠纷一案一审民事判决书.txt	依照 《 中华人民共和国 婚姻法 》 第三十二条 第二款 和 《 中华人民共和国 民事 诉讼法 》 第六十四 条 第一款 的 规定 ， 判决 如下 ： 

原告罗某诉被告李某离婚纠纷一案一审民事判决书.txt	据此 ， 根据 《 中华人民共和国 婚姻法 》 第三十二条 ， 《 中华人民共和国 民事 诉讼法 》 第六十四 条 规定 ， 判决 如下 ： 

原告肖某某与被告伍某某离婚纠纷一案一审民事判决书.txt	依照 《 中华人民共和国 婚姻法 》 第三十二条 第二款 、 《 中华人民共和国 民事 诉讼法 》 第六十四 条 第一款 、 第 一百四十四 条 之 规定 ， 缺席判决 如下 ： 

原告胡某与被告孙某离婚纠纷一案一审民事判决书.txt	据此 ， 依照 《 中华人民共和国 婚姻法 》 第三十二条 第二款 之 规定 、 《 中华人民共和国 民事 诉讼法 》 第六十四 条 第一款 之 规定 ， 判决 如下 ： 

原告胡某某与被告陈某甲离婚纠纷一审判决书.txt	据此 ， 依照 《 中华人民共和国 婚姻法 》 第三十二条 之 规定 ， 判决 如下 ： 

原告胡某某诉被告曾某甲离婚纠纷一审民事判决书.txt	依照 《 中华人民共和国 婚姻法 》 第三十二条 之 规定 ， 判决 如下 ： 

原告胡永红诉被告张建平离婚纠纷一案一审民事判决书.txt	据此 ， 依照 《 中华人民共和国 婚姻法 》 第三十二条 和 《 中华人民共和国 民事 诉讼法 》 第 一百四十四 之 规定 ， 判决 如下 ： 

原告苟某某诉被告李某甲离婚纠纷一案一审民事判决书.txt	据此 ， 依照 《 中华人民共和国 婚姻法 》 第三十二条 之 规定 ， 判决 如下 ： 

原告荣XX诉被告邹XX离婚纠纷一案一审民事判决书.txt	据此 ， 依照 《 中华人民共和国 婚姻法 》 第三十二条 第二款 和 《 中华人民共和国 民事诉讼 》 第六十四 条 第一款 、 第 一百四十四 条 之 规定 ， 判决 如下 ： 

原告覃XX诉被告蒋XX离婚纠纷一案一审民事判决书.txt	据此 ， 依照 《 中华人民共和国 婚姻法 》 第三十二条 第二款 和 《 中华人民共和国 民事诉讼 》 第六十四 条 第一款 之 规定 ， 判决 如下 ： 

原告覃某某诉被告胡某某离婚纠纷一案民事判决书.txt	据此 ， 依照 《 中华人民共和国 婚姻法 》 第三十二条 和 《 中华人民共和国 民事 诉讼法 》 第六十四 条 第一款 、 第 一百四十四 条 之 规定 ， 判决 如下 ： 

原告谢某与被告何某某离婚纠纷一案的民事判决书.txt	依照 《 中华人民共和国 婚姻法 》 第三十二条 之 规定 ， 判决 如下 ： 

原告谢某某诉被告刘某某离婚纠纷一案一审民事判决书.txt	依照 《 中华人民共和国 婚姻法 》 第三十二条 、 《 中华人民共和国 民事 诉讼法 》 第六十四 条 、 第 一百四十四 条 之 规定 ， 判决 如下 ： 

原告谢某甲诉被告程某某离婚纠纷一案民事判决书.txt	据此 ， 依照 《 中华人民共和国 婚姻法 》 第三十二条 之 规定 ， 判决 如下 ： 

原告谭某某诉被告刘某某离婚纠纷一案民事判决书.txt	据此 ， 依照 《 中华人民共和国 婚姻法 》 第三十二条 和 《 中华人民共和国 民事 诉讼法 》 第六十四 条 第一款 、 第 一百四十四 条 之 规定 ， 判决 如下 ： 

原告谭某甲诉被告冉某某离婚纠纷一案一审民事判决书.txt	依照 《 中华人民共和国 婚姻法 》 第三十二条 ， 《 中华人民共和国 民事 诉讼法 》 第六十四 条 第一款 、 第 一百四十四 条 之 规定 ， 判决 如下 ： 

原告谭某甲诉被告张某某离婚纠纷一案一审民事判决书.txt	据此 ， 依照 《 中华人民共和国 婚姻法 》 第三十二条 和 《 中华人民共和国 民事 诉讼法 》 第六十四 条 第一款 、 第 一百四十四 条 之 规定 ， 判决 如下 ： 

原告谷某某诉被告王某甲离婚纠纷一案一审民事判决书.txt	据此 ， 依照 《 中华人民共和国 婚姻法 》 第三十二条 第二款 及 《 中华人民共和国 民事 诉讼法 》 第六十四 条 第一款 的 规定 ， 判决 如下 ： 

原告赵某某与被告伍某某离婚纠纷一案一审民事判决书.txt	依照 《 中华人民共和国 婚姻法 》 第三十二条 之 规定 ， 判决 如下 ： 

原告赵某某与被告柳某甲离婚纠纷一案一审民事判决书.txt	依照 《 中华人民共和国 婚姻法 》 第三十二条 ； 《 中华人民共和国 民事 诉讼法 》 第六十四 条 ； 第 一百四十四 条 之 规定 判决 如下 ： 

原告赵某某与被告田某离婚纠纷一案一审民事判决书.txt	据此 ， 依照 《 中华人民共和国 婚姻法 》 第三十二条 、 《 中华人民共和国 民事 诉讼法 》 第 一百四十四 条 之 规定 ， 判决 如下 ： 

原告赵某某诉被告何某甲离婚纠纷一案一审民事判决书.txt	据此 ， 依照 《 中华人民共和国 婚姻法 》 第三十二条 之 规定 ， 判决 如下 ： 

原告邓某某与被告潘某甲离婚纠纷一审民事判决书.txt	据此 ， 依照 《 中华人民共和国 婚姻法 》 第三十二条 之 规定 ， 判决 如下 ： 

原告邓某某诉被告周某某离婚纠纷一案一审民事判决书.txt	据此 ， 依照 《 中华人民共和国 婚姻法 》 第三十二条 和 《 中华人民共和国 民事 诉讼法 》 第六十四 条 第一款 之 规定 ， 判决 如下 ： 

原告郑某某与被告张某甲离婚纠纷一案一审民事判决书.txt	依照 《 中华人民共和国 婚姻法 》 第三十二条 和 《 中华人民共和国 民事 诉讼法 》 第六十四 条 第一款 的 规定 ， 判决 如下 ： 

原告钟某某诉被告刘某某离婚纠纷一案一审民事判决书.txt	据此 ， 根据 《 中华人民共和国 婚姻法 》 第三十二条 ， 《 中华人民共和国 民事 诉讼法 》 第六十四 条 的 规定 ， 判决 如下 ： 

原告钱某诉被告秦某离婚纠纷一案民事判决书.txt	据此 ， 依照 《 中华人民共和国 婚姻法 》 第三十二条 和 《 中华人民共和国 民事 诉讼法 》 第六十四 条 第一款 之 规定 ， 判决 如下 ： 

原告闫某某诉被告谢某某离婚纠纷一案一审民事判决书.txt	依照 《 中华人民共和国 婚姻法 》 第三十二条 、 《 中华人民共和国 民事 诉讼法 》 第六十四 条 之 规定 ， 判决 如下 ： 

原告陈某与被告林某某离婚纠纷一审民事判决书.txt	据此 ， 根据 《 中华人民共和国 婚姻法 》 第三十二条 、 《 中华人民共和国 民事 诉讼法 》 第六十四 条 ， 《 中华人民共和国 民事 诉讼法 》 第 一百四十四 条 之 规定 ， 判决 如下 ： 

原告陈某与被告简某某离婚纠纷一案的一审民事判决书.txt	依照 《 中华人民共和国 婚姻法 》 第三十二条 之 规定 ， 判决 如下 ： 

原告陈某某与被告詹某某离婚纠纷一审判决书.txt	据此 ， 根据 《 中华人民共和国 婚姻法 》 第三十二条 、 《 中华人民共和国 民事 诉讼法 》 第六十四 条 ， 《 中华人民共和国 民事 诉讼法 》 第 一百四十四 条 之 规定 ， 判决 如下 ： 

原告陈某某诉被告唐某某离婚纠纷案一审民事判决书.txt	据此 ， 依照 《 中华人民共和国 婚姻法 》 第三十二条 之 规定 ， 判决 如下 ： 

原告陈某某诉被告李某某离婚纠纷一案一审民事判决书.txt	依照 《 中华人民共和国 婚姻法 》 第三十二条 、 《 中华人民共和国 民事 诉讼法 》 第六十四 条 、 第 一百四十四 条 之 规定 ， 判决 如下 ： 

原告陈某某诉被告江某某离婚后财产纠纷案一审民事判决书.txt	依照 《 中华人民共和国 民事 诉讼法 》 第六十四 条 、 第 一百四十四 条 之 规定 ， 判决 如下 ： 

原告陈某诉被告余某离婚纠纷一审民事判决书.txt	据此 ， 依照 《 中华人民共和国 婚姻法 》 第三十二条 的 规定 ， 判决 如下 ： 

原告陈某诉被告姜某甲离婚纠纷一案一审民事判决书.txt	依照 《 中华人民共和国 婚姻法 》 第三十二条 及 《 中华人民共和国 民事 诉讼法 》 第六十四 条 第一款 之 规定 ， 判决 如下 ： 

原告陈某诉被告龙某甲离婚纠纷一案一审民事判决书.txt	依照 《 中华人民共和国 婚姻法 》 第三十二条 及 《 中华人民共和国 民事 诉讼法 》 第六十四 条 第一款 之 规定 ， 判决 如下 ： 

原告韩某诉被告蔡某离婚纠纷一案一审民事判决书.txt	据此 ， 依照 《 中华人民共和国 婚姻法 》 第三十二条 之 规定 ， 判决 如下 ： 

原告颜某与被告李某某永离婚纠纷一审判决书.txt	根据 《 中华人民共和国 婚姻法 》 第三十二条 ， 《 中华人民共和国 民事 诉讼法 》 第六十四 条 和 第 一百四十四 条 之 规定 ， 判决 如下 ： 

原告颜某某诉被告李某离婚纠纷案一审民事判决书.txt	据此 ， 依照 《 中华人民共和国 婚姻法 》 第三十二条 之 规定 ， 判决 如下 ： 

原告马某某与被告杨某某离婚纠纷一案一审民事判决书.txt	据此 ， 依照 《 中华人民共和国 婚姻法 》 第三十二条 、 《 中华人民共和国 民事 诉讼法 》 第 一百四十四 条 之 规定 ， 判决 如下 ： 

原告魏XX诉被告唐XX离婚纠纷一案一审民事判决书.txt	据此 ， 依照 《 中华人民共和国 婚姻法 》 第三十二条 第二款 和 《 中华人民共和国 民事诉讼 》 第六十四 条 第一款 之 规定 ， 判决 如下 ： 

原告魏某某与被告刘某某离婚纠纷一案的民事判决书.txt	依照 《 中华人民共和国 婚姻法 》 第三十二条 之 规定 ， 判决 如下 ： 

原告魏某某诉被告时某某离婚纠纷一案一审民事判决书.txt	依照 《 中华人民共和国 婚姻法 》 第三十二条 ， 判决 如下 ： 

原告黄某某诉被告何某甲离婚纠纷一案一审民事判决书.txt	依照 《 中华人民共和国 婚姻法 》 第三十二条 及 《 中华人民共和国 民事 诉讼法 》 第六十四 条 第一款 之 规定 ， 判决 如下 ： 

叶某洁与汤某桥关于离婚纠纷一审民事判决书.txt	据此 ， 依照 《 中华人民共和国 婚姻法 》 第三十二条 之 规定 ， 判决 如下 ： 

向某某与杨某某离婚纠纷一审民事判决书.txt	据此 ， 依照 《 中华人民共和国 婚姻法 》 第三十二条 第一款 、 《 中华人民共和国 民事 诉讼法 》 第六十四 条 第一款 之 规定 ， 判决 如下 ： 

向某某与雷某某离婚纠纷一审民事判决书.txt	据此 ， 依照 《 中华人民共和国 婚姻法 》 第三十二条 之 规定 ， 判决 如下 ： 

吕某某诉何某甲离婚纠纷民事判决书.txt	依照 《 中华人民共和国 婚姻法 》 第三十二条 之 规定 ， 判决 如下 ： 

吴某某与梁某甲离婚纠纷一审民事判决书.txt	依照 《 中华人民共和国 婚姻法 》 第三十二条 、 第三十六条 ， 《 中华人民共和国 民事 诉讼法 》 第 一百四十四 条 之 规定 ， 判决 如下 ： 

吴某某诉郑某离婚纠纷一审民事判决书.txt	依照 《 中华人民共和国 婚姻法 》 第三十二条 之 规定 ， 判决 如下 ： 

周某与喻某离婚纠纷一审民事判决书.txt	依照 《 中华人民共和国 婚姻法 》 第三十二条 之 规定 ， 判决 如下 ： 

周某与李某某离婚纠纷案一审民事判决书.txt	据此 ， 依照 《 中华人民共和国 婚姻法 》 第三十二条 、 《 中华人民共和国 民事 诉讼法 》 第六十四 条 第一款 之 规定 ， 判决 如下 ： 

周某与胡某华离婚纠纷一审民事判决书.txt	依照 《 中华人民共和国 婚姻法 》 第三十二条 之 规定 ， 判决 如下 ： 

周某某与张某某离婚纠纷一审民事判决书.txt	据此 ， 依照 《 中华人民共和国 婚姻法 》 第三十二条 、 《 中华人民共和国 民事 诉讼法 》 第六十四 条 第一款 之 规定 ， 判决 如下 ： 

周某某诉张某甲离婚纠纷一案一审民事判决书.txt	据此 ， 依照 《 中华人民共和国 婚姻法 》 第三十二条 和 《 中华人民共和国 民事 诉讼法 》 第六十四 条 第一款 、 第 一百四十四 条 之 规定 ， 判决 如下 ： 

周某某诉彭甲离婚纠纷一案一审民事判决书.txt	据此 ， 依照 《 中华人民共和国 婚姻法 》 第三十二条 和 《 中华人民共和国 民事 诉讼法 》 第六十四 条 第一款 规定 ， 判决 如下 ： 

唐妹秀与韦小平离婚纠纷一审民事判决书.txt	依照 《 中华人民共和国 婚姻法 》 第三十二条 之 规定 ， 判决 如下 ： 

唐某与刘某某离婚纠纷一审民事判决书.txt	依照 《 中华人民共和国 婚姻法 》 第三十二条 ， 《 中华人民共和国 民事 诉讼法 》 第六十四 条 的 规定 ， 判决 如下 ： 

唐某与被告杨某离婚纠纷一审民事判决书.txt	据此 ， 依照 《 中华人民共和国 婚姻法 》 第三十二条 第二款 及 《 中华人民共和国 民事 诉讼法 》 第六十四 条 第一款 之 规定 ， 判决 如下 ： 

唐某某与龙某某离婚纠纷一审民事判决书.txt	据此 ， 依照 《 中华人民共和国 婚姻法 》 第三十二条 之 规定 ， 判决 如下 ： 

唐某某诉谢某某离婚纠纷一审民事判决书.txt	据此 ， 依照 《 中华人民共和国 婚姻法 》 第三十二条 、 第三十六条 ， 中华人民共和国 民事 诉讼法 》 第 一百四十四 条 的 规定 判决 如下 ： 

唐某甲与王某甲离婚纠纷一审民事判决书.txt	依照 《 中华人民共和国 婚姻法 》 第三十二条 之 规定 ， 判决 如下 ： 

唐某诉欧某某离婚纠纷一审民事判决书.txt	据此 判决 如下 ： 

喻某某与杨某某离婚纠纷一审民事判决书.txt	据此 ， 依照 《 中华人民共和国 婚姻法 》 第三十二条 之 规定 ， 判决 如下 ： 

喻某某与罗某某离婚纠纷一审民事判决书.txt	据此 ， 依照 《 中华人民共和国 婚姻法 》 第三十二条 、 第三十七条 ， 《 中华人民共和国 民事 诉讼法 》 第 一百四十四 条 之 规定 ， 判决 如下 ： 

夏某与白某离婚纠纷一审民事判决书.txt	依照 《 中华人民共和国 婚姻法 》 第三十二条 、 《 中华人民共和国 民事 诉讼法 》 第 一百四十四 条 之 规定 ， 判决 如下 ： 

夏某某与何某某离婚纠纷一审民事判决书.txt	依照 《 中华人民共和国 婚姻法 》 第三十二条 之 规定 ， 判决 如下 ： 

夏某某与刘某甲离婚纠纷一审民事判决书.txt	据此 ， 依照 《 中华人民共和国 婚姻法 》 第三十二条 之 规定 ， 判决 如下 ： 

夏某某诉向某甲离婚纠纷一审民事判决书.txt	依照 《 中华人民共和国 婚姻法 》 第三十二条 之 规定 ， 判决 如下 ： 

孔某某与何某甲离婚纠纷一审民事判决书.txt	依照 《 中华人民共和国 婚姻法 》 第三十二条 之 规定 ， 判决 如下 ： 

孙利君与胡光军离婚一审民事判决书.txt	依照 《 中华人民共和国 婚姻法 》 第三十二条 之 规定 ， 判决 如下 ： 

孙某某与张某某离婚纠纷一审民事判决书.txt	依照 《 中华人民共和国 婚姻法 》 第三十二条 之 规定 ， 判决 如下 ： 

孙某某与陈某某离婚纠纷一审民事判决书.txt	据此 ， 本院 根据 《 中华人民共和国 婚姻法 》 第三十二条 、 《 中华人民共和国 民事 诉讼法 》 第六十四 条 之 规定 ， 判决 如下 ： 

孙某某诉肖某某离婚纠纷一审民事判决书.txt	依照 《 中华人民共和国 婚姻法 》 第三十二条 、 《 中华人民共和国 民事 诉讼法 》 第六十四 条 第一款 之 规定 ， 判决 如下 ： 

季某某与李某某离婚纠纷民事判决书.txt	据此 ， 依照 《 中华人民共和国 婚姻法 》 第三十二条 第二款 、 《 中华人民共和国 民事 诉讼法 》 第 一百四十四 条 之 规定 ， 判决 如下 ： 

宋某某与杨某某离婚纠纷一审民事判决书.txt	据此 ， 依照 《 中华人民共和国 婚姻法 》 第三十二条 ， 《 中华人民共和国 民事 诉讼法 》 第六十四 条 第一款 的 规定 ， 判决 如下 ： 

宋某甲与邓某某离婚纠纷一审民事判决书.txt	依照 《 中华人民共和国 民事 诉讼法 》 第 一百四十四 条 的 规定 ， 判决 如下 ： 

官某某与刘某离婚纠纷一案一审民事判决书.txt	据此 ， 依照 《 中华人民共和国 婚姻法 》 第三十二条 第二款 之 规定 ， 判决 如下 ： 

崔某某与刘某某离婚纠纷一审民事判决书.txt	依照 《 中华人民共和国 婚姻法 》 第三十二条 和 《 中华人民共和国 民事 诉讼法 》 第 一百四十四 条 的 规定 ， 判决 如下 ： 

左某某与陈某甲离婚纠纷一审民事判决书.txt	据此 ， 依照 《 中华人民共和国 婚姻法 》 第三十二条 、 《 中华人民共和国 民事 诉讼法 》 第六十四 条 、 第 一百四十四 条 之 规定 ， 判决 如下 ： 

帅某某与陈某某离婚纠纷案一审民事判决书.txt	据此 ， 依照 《 中华人民共和国 婚姻法 》 第三十二条 ， 《 中华人民共和国 民事 诉讼法 》 第六十四 条 的 规定 ， 判决 如下 ： 

席某某与陈某某离婚纠纷一审民事判决书.txt	根据 《 中华人民共和国 民事 诉讼法 》 第六十四 条 之 规定 ， 判决 如下 ： 

干某某与吴某某离婚纠纷一审民事判决书.txt	据此 ， 依照 《 中华人民共和国 婚姻法 》 第三十二条 之 规定 ， 判决 如下 ： 

康某某与毛某某离婚纠纷一审民事判决书.txt	据此 ， 依照 《 中华人民共和国 婚姻法 》 第三十二条 之 规定 ， 判决 如下 ： 

廖某与彭某某离婚纠纷一审民事判决书.txt	据此 ， 依照 《 中华人民共和国 婚姻法 》 第三十二条 之 规定 ， 判决 如下 ： 

廖某与潘某离婚纠纷一审民事判决书.txt	依照 《 中华人民共和国 婚姻法 》 第三十二条 之 规定 ， 判决 如下 ： 

廖某某与胡某某离婚纠纷一审民事判决书.txt	据此 ， 依照 《 中华人民共和国 婚姻法 》 第三十二条 ， 《 中华人民共和国 民事 诉讼法 》 第六十四 条 之 规定 ， 判决 如下 ： 

廖某某与贺某某离婚纠纷一审民事判决书.txt	据此 ， 依照 《 中华人民共和国 婚姻法 》 第三十二条 之 规定 ， 判决 如下 ： 

廖某某与魏某某离婚纠纷一审民事判决书.txt	依照 《 中华人民共和国 婚姻法 》 第三十二条 、 《 中华人民共和国 民事 诉讼法 》 第六十四 条 之 规定 ， 判决 如下 ： 

张某与李某离婚纠纷一审民事判决书.txt	据此 ， 依照 《 中华人民共和国 婚姻法 》 第三十二条 之 规定 ， 判决 如下 ： 

张某与王某甲离婚纠纷一审民事判决书.txt	依照 《 中华人民共和国 婚姻法 》 第三十二条 之 规定 ， 判决 如下 ： 

张某与陈某离婚纠纷一审民事判决书.txt	据此 ， 依照 《 中华人民共和国 婚姻法 》 第三十二条 之 规定 ， 判决 如下 ： 

张某某与周某某离婚纠纷案一审民事判决书.txt	依照 《 中华人民共和国 婚姻法 》 第三十二条 和 《 中华人民共和国 民事 诉讼法 》 第六十四 条 、 第 一百四十四 条 、 第一百 六十条 之 规定 ， 判决 如下 ： 

张某某与唐某某离婚纠纷一审民事判决书.txt	依照 《 中华人民共和国 婚姻法 》 第三十二条 之 规定 ， 判决 如下 ： 

张某某与张某甲离婚纠纷一审民事判决书.txt	据此 ， 依照 《 中华人民共和国 婚姻法 》 第三十二条 之 规定 ， 判决 如下 ： 

张某某与朱某离婚纠纷一审民事判决书.txt	依照 《 中华人民共和国 婚姻法 》 第三十二条 之 规定 ， 判决 如下 ： 

张某某与王某某离婚纠纷民事一审判决书.txt	据此 ， 依照 《 中华人民共和国 婚姻法 》 第三十二条 判决 如下 ： 

张某某与申某甲离婚纠纷一审民事判决书.txt	依照 《 中华人民共和国 婚姻法 》 第三十二条 、 《 中华人民共和国 民事 诉讼法 》 第 一百四十四 条 的 规定 ， 判决 如下 ： 

张某某与蒙某甲离婚纠纷一审民事判决书.txt	依照 《 中华人民共和国 婚姻法 》 第三十二条 之 规定 ， 判决 如下 ： 

张某某与郭某某离婚纠纷一审民事判决书.txt	依照 《 中华人民共和国 婚姻法 》 第三十二条 、 《 中华人民共和国 民事 诉讼法 》 第六十四 条 第一款 之 规定 ， 判决 如下 ： 

张某某与陈某某离婚纠纷一审民事判决书.txt	据此 ， 依照 《 中华人民共和国 婚姻法 》 第三十二条 之 规定 ， 判决 如下 ： 

张某某与陈某甲离婚纠纷一审民事判决书.txt	依照 《 中华人民共和国 婚姻法 》 第三十二条 、 《 中华人民共和国 民事 诉讼法 》 第六十四 条 第一款 、 第 一百四十四 条 之 规定 ， 判决 如下 ： 

张某某与顾某某离婚纠纷一案一审民事判决书.txt	依照 《 中华人民共和国 婚姻法 》 第三十二条 、 《 中华人民共和国 民事 诉讼法 》 第六十四 条 之 规定 ， 判决 如下 ： 

张某某与颜某某离婚纠纷一审民事判决书.txt	据此 ， 依照 《 中华人民共和国 婚姻法 》 第三十二条 之 规定 ， 判决 如下 ： 

张某某与黄某离婚纠纷一审民事判决书.txt	依照 《 中华人民共和国 民事 诉讼法 》 第 一百四十四 条 和 《 中华人民共和国 婚姻法 》 第三十二条 之 规定 ， 判决 如下 ： 

张某某与龚某某离婚纠纷一审判决书.txt	据此 ， 判决 如下 ： 

张某某诉吕某某离婚纠纷一审民事判决书.txt	依照 《 中华人民共和国 婚姻法 》 第三十二条 之 规定 ， 判决 如下 ： 

张某某诉王某某离婚纠纷一审民事判决书.txt	依照 《 中华人民共和国 婚姻法 》 第三十二条 、 《 中华人民共和国 民事 诉讼法 》 第 一百四十四 条 之 规定 ， 判决 如下 ： 

张某某诉程某某离婚纠纷一审民事判决书.txt	依照 《 中华人民共和国 婚姻法 》 第三十二条 及 《 中华人民共和国 民事 诉讼法 》 第六十四 条 之 规定 ， 判决 如下 ： 

张某某诉颜某某离婚纠纷一审民事判决书.txt	据此 ， 依照 《 中华人民共和国 婚姻法 第三十二条 》 ， 《 中华人民共和国 民事 诉讼法 》 第六十四 条 之 规定 ， 判决 如下 ： 

张某某诉龚某某离婚纠纷一审民事判决书.txt	据此 ， 依照 《 中华人民共和国 婚姻法 》 第三十二条 的 规定 ， 判决 如下 ： 

张某甲与周某某离婚纠纷一审民事判决书.txt	据此 ， 依照 《 中华人民共和国 民事 诉讼法 》 第六十四 条 第一款 之 规定 ， 判决 如下 ： 

张某甲与廖某甲离婚纠纷一审民事判决书.txt	依照 《 中华人民共和国 婚姻法 》 第三十二条 和 《 中华人民共和国 民事 诉讼法 》 第 一百四十四 条 之 规定 ， 判决 如下 ： 

张某甲与熊某甲离婚纠纷一审民事判决书.txt	依照 《 中华人民共和国 婚姻法 》 第三十二条 第二款 ， 《 中华人民共和国 民事 诉讼法 》 第六十四 条 第一款 之 规定 ， 判决 如下 ： 

张某诉任某某离婚纠纷一审民事判决书.txt	依照 《 中华人民共和国 婚姻法 》 第三十二条 之 规定 ， 判决 如下 ： 

张某诉杨某甲离婚纠纷一案一审民事判决书.txt	据此 ， 依照 《 中华人民共和国 婚姻法 》 第三十二条 和 《 中华人民共和国 民事 诉讼法 》 第六十四 条 第一款 ， 判决 如下 ： 

张英诉李志刚离婚纠纷一案一审民事判决书.txt	据此 ， 依照 《 中华人民共和国 婚姻法 》 第三十二条 之 规定 ， 判决 如下 ： 

彭某某与冉某甲离婚纠纷一审民事判决书.txt	依照 《 中华人民共和国 婚姻法 》 第三十二条 、 《 中华人民共和国 民事 诉讼法 》 第六十四 条 之 规定 ， 判决 如下 ： 

彭某某与张某甲离婚纠纷一审民事判决书.txt	据此 ， 依照 《 中华人民共和国 婚姻法 》 第三十二条 之 规定 ， 判决 如下 ： 

彭某甲诉杨某某离婚纠纷一审民事判决书.txt	依照 《 中华人民共和国 婚姻法 》 第三十二条 之 规定 ， 判决 如下 ： 

徐某某与刘某某离婚纠纷一案一审民事判决书.txt	根据 《 中华人民共和国 婚姻法 》 第三十二条 、 三十七 条 、 《 中华人民共和国 民事 诉讼法 》 第六十四 条 、 第 一百四十四 条 之 规定 之 规定 ， 判决 如下 ： 

徐某某与李某某离婚纠纷一审民事判决书.txt	据此 ， 依照 《 中华人民共和国 婚姻法 》 第三十二条 之 规定 ， 判决 如下 ： 

支某某与陈某某离婚纠纷案一审民事判决书.txt	依照 《 中华人民共和国 婚姻法 》 第三十二条 之 规定 ， 判决 如下 ： 

敬永杰与敬永莲离婚纠纷一审民事判决书.txt	据此 ， 依照 《 中华人民共和国 婚姻法 》 第三十二条 第二款 和 《 中华人民共和国 民事 诉讼法 》 第 一百四十四 条 之 规定 ， 判决 如下 ： 

文某某与何某某离婚纠纷一审民事判决书.txt	据此 ， 依照 《 中华人民共和国 婚姻法 》 第三十二条 之 规定 ， 判决 如下 ： 

文某某与周某某离婚纠纷一审民事判决书.txt	据此 ， 依照 《 中华人民共和国 婚姻法 》 第三十二条 之 规定 ， 判决 如下 ： 

文某甲与张某某离婚纠纷一审民事判决书.txt	据此 ， 依照 《 中华人民共和国 婚姻法 》 第三十二条 、 《 中华人民共和国 民事 诉讼法 》 第六十四 条 第一款 之 规定 ， 判决 如下 ： 

文某甲与滕某某离婚纠纷一审民事判决书.txt	据此 ， 依照 《 中华人民共和国 婚姻法 》 第三十二条 第二款 和 《 中华人民共和国 民事 诉讼法 》 第六十四 条 第一款 、 第 一百四十四 条 之 规定 ， 判决 如下 ： 

文某甲与胡某离婚纠纷一审民事判决书.txt	据此 ， 依照 《 中华人民共和国 婚姻法 》 第三十二条 ， 《 中华人民共和国 民事 诉讼法 》 第六十四 条 之 规定 ， 判决 如下 ： 

施某诉李某离婚纠纷一审民事判决书.txt	据此 ， 依照 《 中华人民共和国 婚姻法 》 第三十二条 第二款 之 规定 ， 判决 如下 ： 

明某某与何某某离婚纠纷一审民事判决书.txt	依照 《 中华人民共和国 婚姻法 》 第三十二条 之 规定 ， 判决 如下 ： 

易某某与张某甲离婚纠纷一审民事判决书.txt	依照 《 中华人民共和国 婚姻法 》 第三十二条 之 规定 ， 判决 如下 ： 

晏某星与李某川关于离婚纠纷一审民事判决书.txt	据此 ， 依照 《 中华人民共和国 婚姻法 》 第三十二条 之 规定 ， 判决 如下 ： 

曹某某与陈某某离婚纠纷一审民事判决书.txt	依照 《 中华人民共和国 婚姻法 》 第三十二条 之 规定 ， 判决 如下 ： 

曾某某与熊某某离婚纠纷一审民事裁定书.txt	依照 《 中华人民共和国 婚姻法 》 第三十二条 、 《 中华人民共和国 民事 诉讼法 》 第 一百四十四 条 之 规定 ， 判决 如下 ： 

朱某某与余某某离婚纠纷一审民事判决书.txt	据此 ， 依照 《 中华人民共和国 婚姻法 》 第三十二条 、 《 中华人民共和国 民事 诉讼法 》 第六十四 条 之 规定 ， 判决 如下 ： 

朱某某与廖某甲离婚纠纷一审民事判决书.txt	依照 《 中华人民共和国 婚姻法 》 第三十二条 之 规定 ， 判决 如下 ： 

朱某某与张某某离婚纠纷一审民事判决书.txt	据此 ， 依照 《 中华人民共和国 婚姻法 》 第三十二条 、 第三十六条 ， 《 中华人民共和国 民事 诉讼法 》 第 一百四十四 条 规定 ， 判决 如下 ： 

朱某某与陈某某离婚纠纷一审民事判决书.txt	据此 ， 依照 《 中华人民共和国 婚姻法 》 第三十二条 ， 《 中华人民共和国 民事 诉讼法 》 第 一百四十四 条 之 规定 ， 判决 如下 ： 

李兰与子龙离婚纠纷一审民事判决书.txt	据此 ， 依照 《 中华人民共和国 婚姻法 》 第三十二条 第二款 和 《 中华人民共和国 民事 诉讼法 》 第 一百四十四 条 之 规定 ， 判决 如下 ： 

李某与刘某关于离婚纠纷一审民事判决书.txt	据此 ， 依照 《 中华人民共和国 婚姻法 》 第三十二条 之 规定 ， 判决 如下 ： 

李某与李某甲离婚纠纷一审民事判决书.txt	依照 《 中华人民共和国 民事 诉讼法 》 第 一百四十四 条 、 《 中华人民共和国 婚姻法 》 第三十二条 之 规定 ， 判决 如下 ： 

李某某与兰某某离婚纠纷一审民事判决书.txt	依照 《 中华人民共和国 婚姻法 》 第三十二条 、 《 中华人民共和国 民事 诉讼法 》 第 一百四十四 条 的 规定 ， 判决 如下 ： 

李某某与刘某甲离婚纠纷一审民事判决书.txt	依照 《 中华人民共和国 婚姻法 》 第三十二条 之 规定 ， 判决 如下 ： 

李某某与周某甲离婚纠纷一审民事判决书.txt	依照 《 中华人民共和国 婚姻法 》 第三十二条 之 规定 ， 判决 如下 ： 

李某某与徐某某离婚纠纷一审民事判决书.txt	依照 《 中华人民共和国 民事 诉讼法 》 第 一百四十四 条 ， 《 中华人民共和国 婚姻法 》 第三十二条 之 规定 ， 判决 如下 ： 

李某某与林某甲离婚纠纷一审民事判决书.txt	据此 ， 依照 《 中华人民共和国 民事 诉讼法 》 第六十四 条 第一款 之 规定 ， 判决 如下 ： 

李某某与潘某某离婚纠纷一审民事判决书.txt	据此 ， 依照 《 中华人民共和国 婚姻法 》 第三十二条 、 《 中华人民共和国 民事 诉讼法 》 第六十四 条 第一款 之 规定 ， 判决 如下 ： 

李某某与祝某某离婚纠纷一审民事判决书.txt	据此 ， 依照 《 中华人民共和国 婚姻法 》 第三十二条 、 《 中华人民共和国 民事 诉讼法 》 第六十四 条 第一款 之 规定 ， 判决 如下 ： 

李某某与胡某甲离婚纠纷一审民事判决书.txt	依照 《 中华人民共和国 婚姻法 》 第三十二条 之 规定 ， 判决 如下 ： 

李某某与陈某某离婚纠纷一审判决书.txt	据此 ， 判决 如下 ： 

李某某与陈某某离婚纠纷一审民事判决书.txt	依照 《 中华人民共和国 婚姻法 》 第三十二条 之 规定 ， 判决 如下 ： 

李某某诉刘某某离婚纠纷一审民事判决书.txt	依照 《 中华人民共和国 婚姻法 》 第三十二条 、 《 中华人民共和国 民事 诉讼法 》 第 一百四十四 条 之 规定 ， 判决 如下 ： 

李某某诉周某某离婚纠纷民事一审判决书.txt	据此 ， 根据 《 中华人民共和国 婚姻法 》 第三十二条 、 《 中华人民共和国 民事 诉讼法 》 第六十四 条 、 第 一百四十四 条 之 规定 ， 判决 如下 ： 

李某某诉王某甲离婚纠纷一审民事判决书.txt	据此 ， 依照 《 中华人民共和国 婚姻法 》 第三十二条 的 规定 ， 判决 如下 ： 

李某甲与刘某甲离婚纠纷一审民事判决书.txt	依照 《 中华人民共和国 婚姻法 》 第三十二条 ， 《 中华人民共和国 民事 诉讼法 》 第六十四 条 的 规定 ， 判决 如下 ： 

李某甲与周某某离婚纠纷一审民事判决书.txt	据此 ， 依照 《 中华人民共和国 婚姻法 》 第三十二条 之 规定 ， 判决 如下 ： 

李某甲与李某乙离婚纠纷一审民事判决书.txt	据此 ， 依照 《 中华人民共和国 婚姻法 》 第三十二条 之 规定 ， 判决 如下 ： 

李某甲与梁某某离婚纠纷一审民事判决书.txt	据此 ， 依照 《 中华人民共和国 婚姻法 》 第三十二条 第二款 和 《 中华人民共和国 民事 诉讼法 》 第六十四 条 第一款 、 第 一百四十四 条 之 规定 ， 判决 如下 ： 

李某甲与谢某某离婚纠纷一审民事判决书.txt	依照 《 中华人民共和国 婚姻法 》 第三十二条 之 规定 ， 判决 如下 ： 

李甲与徐某离婚纠纷案一审民事判决书.txt	据此 ， 依照 《 中华人民共和国 婚姻法 》 第三十二条 、 《 中华人民共和国 民事 诉讼法 》 第六十四 条 之 规定 ， 判决 如下 ： 

杜某诉蒋某离婚纠纷一审民事判决书.txt	依照 《 中华人民共和国 婚姻法 》 第三十二条 之 规定 ， 判决 如下 ： 

杨某某与冯某某离婚纠纷一审民事判决书.txt	依照 《 中华人民共和国 婚姻法 》 第三十二条 、 《 中华人民共和国 民事 诉讼法 》 一百四十四 条 之 规定 ， 判决 如下 ： 

杨某某与孙某某离婚纠纷案一审民事判决书.txt	据此 ， 依照 《 中华人民共和国 婚姻法 》 第三十二条 ， 《 中华人民共和国 民事 诉讼法 》 第六十四 条 、 第 一百四十四 条 之 规定 ， 判决 如下 ： 

杨某某与张某乙离婚纠纷一审民事判决书.txt	据此 ， 依照 《 中华人民共和国 婚姻法 》 第三十二条 和 《 中华人民共和国 民事 诉讼法 》 第六十四 条 第一款 之 规定 ， 判决 如下 ： 

杨某某与李某某离婚纠纷一审民事判决书.txt	据此 ， 依照 《 中华人民共和国 婚姻法 》 第三十二条 、 《 中华人民共和国 民事 诉讼法 》 第六十四 条 、 第 一百四十四 条 之 规定 ， 判决 如下 ： 

杨某某与李某甲离婚纠纷一审民事判决书.txt	据此 ， 依照 《 中华人民共和国 婚姻法 》 第三十二条 之 规定 ， 判决 如下 ： 

杨某某与潘某某离婚纠纷一审民事判决书.txt	据此 ， 依照 《 中华人民共和国 婚姻法 》 第三十二条 之 规定 ， 判决 如下 ： 

杨某某与王某甲离婚纠纷一审民事判决书.txt	据此 ， 依照 《 中华人民共和国 婚姻法 》 第三十二条 第二款 之 规定 判决 如下 ： 

杨某某与罗某离婚纠纷一审民事判决书.txt	依照 《 中华人民共和国 婚姻法 》 第三十二条 之 规定 ， 判决 如下 ： 

杨某某与银某某离婚纠纷案一审民事判决书.txt	依照 《 中华人民共和国 婚姻法 》 第三十二条 和 《 中华人民共和国 民事 诉讼法 》 第六十四 条 、 第 一百四十四 条 、 第一百 六十条 之 规定 ， 判决 如下 ： 

杨某某与鲜某某离婚纠纷一审民事判决书.txt	据此 ， 依照 《 中华人民共和国 婚姻法 》 第三十二条 、 《 中华人民共和国 民事 诉讼法 》 第六十四 条 第一款 规定 ， 判决 如下 ： 

杨某某诉熊某某离婚纠纷一审民事判决书.txt	依照 《 中华人民共和国 婚姻法 》 第三十二条 、 《 中华人民共和国 民事 诉讼法 》 第 一百四十四 条 之 规定 ， 判决 如下 ： 

杨某某诉胡某某离婚纠纷一审民事判决书.txt	据此 ， 依照 《 中华人民共和国 婚姻法 》 第三十二条 之 规定 ， 判决 如下 ： 

杨某甲与李某离婚纠纷一审民事判决书.txt	据此 ， 依照 《 中华人民共和国 婚姻法 》 第三十二条 、 《 中华人民共和国 民事 诉讼法 》 第六十四 条 之 规定 ， 判决 如下 ： 

杨某诉肖甲离婚纠纷一案一审民事判决书.txt	据此 ， 依照 《 中华人民共和国 婚姻法 》 第三十二条 和 《 中华人民共和国 民事 诉讼法 》 第六十四 条 第一款 、 第 一百四十四 条 之 规定 ， 判决 如下 ： 

林某某与倪某某离婚纠纷一审民事判决书.txt	依照 《 中华人民共和国 婚姻法 》 第三十二条 之 规定 ， 判决 如下 ： 

林某某与向某某离婚纠纷一审民事判决书.txt	据此 ， 依照 《 中华人民共和国 婚姻法 》 第三十二条 之 规定 ， 判决 如下 ： 

柳某某诉贺某某离婚纠纷一审民事判决书.txt	依照 《 中华人民共和国 婚姻法 》 第三十二条 之 规定 ， 判决 如下 ： 

梁某某与张某某离婚纠纷一审民事判决书.txt	依照 《 中华人民共和国 婚姻法 》 第三十二条 、 《 中华人民共和国 民事 诉讼法 》 第六十四 条 第一款 之 规定 ， 判决 如下 ： 

梁某某与谢某某离婚纠纷一审民事判决书.txt	依照 《 中华人民共和国 婚姻法 》 第三十二条 之 规定 ， 判决 如下 ： 

梁某某与贾某某离婚纠纷一审民事判决书.txt	据此 ， 依照 《 中华人民共和国 婚姻法 》 第三十二条 以及 《 中华人民共和国 民事 诉讼法 》 第六十四 条 之 规定 ， 判决 如下 ： 

梁某某与雷某某离婚纠纷案一审民事判决书.txt	据此 ， 依照 《 中华人民共和国 婚姻法 》 第三十二条 ， 《 中华人民共和国 民事 诉讼法 》 第六十四 条 的 规定 ， 判决 如下 ： 

欧某某与杨某某离婚纠纷一审民事判决书.txt	依照 《 中华人民共和国 婚姻法 》 第三十二条 之 规定 ， 判决 如下 ： 

段某某诉刘某甲离婚纠纷一案一审民事判决书.txt	据此 ， 依照 《 中华人民共和国 婚姻法 》 第三十二条 和 《 中华人民共和国 民事 诉讼法 》 第六十四 条 第一款 、 第 一百四十四 条 之 规定 ， 判决 如下 ： 

江某某与张某甲离婚纠纷一审民事判决书.txt	依照 《 中华人民共和国 婚姻法 》 第三十二条 、 《 中华人民共和国 民事 诉讼法 》 第六十四 条 第一款 、 第 一百四十四 条 规定 ， 判决 如下 ： 

江某诉陈某某离婚纠纷一审民事判决书.txt	依照 《 中华人民共和国 婚姻法 》 第三十二条 之 规定 ， 判决 如下 ： 

汪某与彭某某离婚纠纷一审民事判决书.txt	依照 《 中华人民共和国 民事 诉讼法 》 第 一百四十四 条 ， 《 中华人民共和国 婚姻法 》 第三十二条 之 规定 ， 判决 如下 ： 

汪某某诉被告陈某甲离婚纠纷一审民事判决书.txt	据此 ， 依照 《 中华人民共和国 婚姻法 》 第三十二条 第二款 之 规定 ， 判决 如下 ： 

汪翠蓉与陈建平离婚纠纷一审民事判决书.txt	据此 ， 依照 《 中华人民共和国 婚姻法 》 第三十二条 之 规定 ， 判决 如下 ： 

涂某某诉曹某某离婚纠纷一审民事判决书.txt	据此 ， 依照 《 中华人民共和国 婚姻法 》 第三十二条 和 《 中华人民共和国 民事 诉讼法 》 第 一百四十四 条 的 规定 ， 判决 如下 ： 

滕某与庞某甲离婚纠纷一审民事判决书.txt	据此 ， 依照 《 中华人民共和国 婚姻法 》 第三十二条 之 规定 ， 判决 如下 ： 

滕某某与唐某甲离婚纠纷一审民事判决书.txt	据此 ， 依照 《 中华人民共和国 婚姻法 》 第三十二条 之 规定 ， 判决 如下 ： 

潘某与黎某某离婚纠纷一审民事判决书.txt	依照 《 中华人民共和国 婚姻法 》 第三十二条 、 《 中华人民共和国 民事 诉讼法 》 第 一百四十四 条 之 规定 ， 判决 如下 ： 

牟某某与裴某某离婚纠纷一审民事判决书.txt	据此 ， 依照 《 中华人民共和国 婚姻法 》 第三十二条 之 规定 ， 判决 如下 ： 

王光玉与任中禹离婚纠纷一审民事判决书.txt	据此 ， 依照 《 中华人民共和国 婚姻法 》 第三十二条 之 规定 ， 判决 如下 ： 

王加亮与李秀熙离婚纠纷一审民事判决书.txt	据此 ， 依照 《 中华人民共和国 婚姻法 》 第三十二条 之 规定 ， 判决 如下 ： 

王勇与何花离婚纠纷一案民事判决书.txt	依照 《 中华人民共和国 婚姻法 》 第三十二条 之 规定 ， 判决 如下 ： 

王林与吴文胜离婚纠纷一审民事判决书.txt	依照 《 中华人民共和国 民事 诉讼法 》 第六十四 条 、 第 一百四十四 条 ， 《 中华人民共和国 婚姻法 》 第三十二条 的 规定 ， 判决 如下 ： 

王某与杨某离婚纠纷一审民事判决书.txt	依照 《 中华人民共和国 民事 诉讼法 》 第六十四 条 第一款 之 规定 ， 判决 如下 ： 

王某与郑某离婚纠纷一审民事判决书.txt	依照 《 中华人民共和国 婚姻法 》 第三十二条 ， 判决 如下 ： 

王某与郭某关于离婚纠纷一审民事判决书.txt	据此 ， 依照 《 中华人民共和国 婚姻法 》 第三十二条 之 规定 ， 判决 如下 ： 

王某与黄某某离婚纠纷一案一审民事判决书.txt	据此 ， 依照 《 中华人民共和国 婚姻法 》 第三十二条 、 《 中华人民共和国 民事 诉讼法 》 第六十四 条 之 规定 ， 判决 如下 ： 

王某某与何某离婚纠纷一审民事判决书.txt	据此 ， 依照 《 中华人民共和国 婚姻法 》 第三十二条 、 《 中华人民共和国 民事 诉讼法 》 第 一百四十四 条 之 规定 ， 判决 如下 ： 

王某某与叶某某离婚纠纷一审民事判决书.txt	据此 ， 依照 《 中华人民共和国 婚姻法 》 第三十二条 的 规定 ， 判决 如下 ： 

王某某与胡某甲离婚纠纷一审民事判决书.txt	据此 ， 依照 《 中华人民共和国 婚姻法 》 第三十二条 、 《 中华人民共和国 民事 诉讼法 》 第六十四 条 第一款 之 规定 ， 判决 如下 ： 

王某某与舒某某离婚纠纷一案一审民事判决书.txt	据此 ， 依照 《 中华人民共和国 婚姻法 》 第三十二条 、 《 中华人民共和国 民事 诉讼法 》 第六十四 条 之 规定 ， 判决 如下 ： 

王某某与谢某某离婚纠纷一审民事判决书.txt	依照 《 中华人民共和国 婚姻法 》 第三十二条 、 《 中华人民共和国 民事 诉讼法 》 第 一百四十四 条 之 规定 ， 判决 如下 ： 

王某某与邓某某离婚纠纷一审民事判决书.txt	依照 《 中华人民共和国 婚姻法 》 第三十二条 、 《 中华人民共和国 民事 诉讼法 》 第 一百四十四 条 之 规定 ， 判决 如下 ： 

王某某诉崔某甲离婚纠纷一审民事判决书.txt	依照 《 中华人民共和国 婚姻法 》 第三十二条 之 规定 ， 判决 如下 ： 

王某某诉谭某甲离婚纠纷一审民事判决书.txt	据此 ， 依照 《 中华人民共和国 婚姻法 》 第三十二条 的 规定 ， 判决 如下 ： 

王某甲与邓某某离婚纠纷一审民事判决书.txt	依照 《 中华人民共和国 婚姻法 》 第三十二条 、 《 中华人民共和国 民事 诉讼法 》 第六十四 条 之 规定 ， 判决 如下 ： 

王某诉杜某离婚纠纷一审民事判决书.txt	依照 《 中华人民共和国 婚姻法 》 第三十二条 之 规定 ， 判决 如下 ： 

王美诉何波离婚纠纷一审民事判决书.txt	依照 《 中华人民共和国 婚姻法 》 第三十二条 之 规定 ， 判决 如下 ： 

田某某与彭某离婚纠纷一审民事判决书.txt	依照 《 中华人民共和国 婚姻法 》 第三十二条 之 规定 ， 判决 如下 ： 

申某与许某甲离婚纠纷一审民事判决书.txt	据此 ， 依照 《 中华人民共和国 民事 诉讼法 》 第六十四 条 、 《 中华人民共和国 婚姻法 》 第三十二条 的 规定 ， 判决 如下 ： 

白某某与曾某某离婚纠纷一审民事判决书.txt	据此 ， 依照 《 中华人民共和国 民事 诉讼法 》 第 一百四十四 条 、 《 中华人民共和国 婚姻法 》 第三十二条 之 规定 ， 判决 如下 ： 

白某甲诉郑某离婚纠纷一审民事判决书.txt	依照 《 中华人民共和国 婚姻法 》 第三十二条 之 规定 ， 判决 如下 ： 

祝某某与唐某甲离婚纠纷一审民事判决书.txt	依照 《 中华人民共和国 婚姻法 》 第三十二条 ， 《 中华人民共和国 民事 诉讼法 》 第 一百四十四 条 之 规定 ， 判决 如下 ： 

祝淑英与赵国辉离婚纠纷一审民事判决书.txt	据此 ， 依照 《 中华人民共和国 婚姻法 》 第三十二条 第二款 和 《 中华人民共和国 民事 诉讼法 》 第 一百四十四 条 之 规定 ， 判决 如下 ： 

程某与王某甲离婚纠纷一审民事判决书.txt	据此 ， 依照 《 中华人民共和国 婚姻法 》 第三十二条 ， 《 中华人民共和国 民事 诉讼法 》 第六十四 条 第一款 之 规定 ， 判决 如下 ： 

程某某与被告尤某某离婚纠纷一审民事判决书.txt	据此 ， 判决 如下 ： 

程某某诉王某某离婚纠纷民事一审判决书.txt	据此 ， 根据 《 中华人民共和国 婚姻法 》 第三十二条 、 《 中华人民共和国 民事 诉讼法 》 第六十四 条 、 第 一百四十四 条 之 规定 ， 判决 如下 ： 

穆某某诉郑某某离婚纠纷民事一审判决书.txt	据此 ， 依照 《 中华人民共和国 婚姻法 》 第三十二条 、 《 中华人民共和国 民事 诉讼法 》 第 一百四十四 条 之 规定 ， 判决 如下 ： 

米某某与杨某某离婚纠纷一审民事判决书.txt	据此 ， 依照 《 中华人民共和国 婚姻法 》 第三十二条 之 规定 ， 判决 如下 ： 

粟某某与向某某离婚纠纷一审民事判决书.txt	据此 ， 依照 《 中华人民共和国 婚姻法 》 第三十二条 的 规定 ， 判决 如下 ： 

罗俭英与张文友离婚纠纷一审民事判决书.txt	依照 《 中华人民共和国 婚姻法 》 第三十二条 之 规定 ， 判决 如下 ： 

罗某某与刘某某离婚纠纷一审民事判决书.txt	据此 ， 依照 《 中华人民共和国 婚姻法 》 第三十二条 、 第三十六条 ， 《 中华人民共和国 民事 诉讼法 》 第 一百四十四 条 之 规定 ， 判决 如下 ： 

罗某某与封某甲离婚纠纷一审民事判决书.txt	据此 ， 依照 《 中华人民共和国 婚姻法 》 第三十二条 、 《 中华人民共和国 民事 诉讼法 》 第六十四 条 、 第 一百四十四 条 之 规定 ， 判决 如下 ： 

罗某某与胡某某离婚纠纷案一审民事判决书.txt	据此 ， 依照 《 中华人民共和国 婚姻法 》 第三十二条 ， 《 中华人民共和国 民事 诉讼法 》 第六十四 条 、 第 一百四十四 条 的 规定 ， 缺席判决 如下 ： 

罗某某与谢某某离婚纠纷一审民事判决书.txt	据此 ， 依照 《 中华人民共和国 婚姻法 》 第三十二条 ， 《 中华人民共和国 民事 诉讼法 》 第六十四 条 之 规定 ， 判决 如下 ： 

罗某某诉曹某某离婚纠纷一审民事判决书.txt	据此 ， 依照 《 中华人民共和国 婚姻法 》 第三十二条 之 规定 ， 判决 如下 ： 

罗某甲与张某离婚纠纷案一审民事判决书.txt	据此 ， 依照 《 中华人民共和国 婚姻法 》 第三十二条 ， 《 中华人民共和国 民事 诉讼法 》 第六十四 条 第一款 之 规定 ， 判决 如下 ： 

罗某甲与罗某乙离婚纠纷一审民事判决书.txt	据此 ， 依照 《 中华人民共和国 婚姻法 》 第三十二条 之 规定 ， 判决 如下 ： 

耿某某诉赵某某离婚纠纷一审民事判决书.txt	依照 《 中华人民共和国 婚姻法 》 第三十二条 之 规定 ， 判决 如下 ： 

聂某某与李某某离婚纠纷一审民事判决书.txt	据此 、 依照 《 中华人民共和国 婚姻法 》 第三十二条 之 规定 ， 判决 如下 ： 

肖某与刘某甲离婚纠纷一审民事判决书.txt	依照 《 中华人民共和国 婚姻法 》 第三十二条 和 《 中华人民共和国 民事 诉讼法 》 第六十四 条 、 第 一百四十四 条 之 规定 ， 判决 如下 ： 

肖某与朱某甲离婚纠纷一审民事判决书.txt	依照 《 中华人民共和国 婚姻法 》 第三十二条 和 《 中华人民共和国 民事 诉讼法 》 第六十四 条 、 第 一百四十四 条 之 规定 ， 判决 如下 ： 

肖某某与严某甲离婚纠纷一审民事判决书.txt	依照 《 中华人民共和国 婚姻法 》 第三十二条 、 《 中华人民共和国 民事 诉讼法 》 第六十四 条 、 第 一百四十四 条 之 规定 ， 判决 如下 ： 

肖某某与倪某某离婚纠纷一审民事判决书.txt	依照 《 中华人民共和国 婚姻法 》 第三十二条 之 规定 ， 及 《 中华人民共和国 民事 诉讼法 》 第 一百四十四 条 之 规定 ， 判决 如下 ： 

肖某某与罗德国罗某甲离婚纠纷一审民事判决书.txt	据此 ， 依照 《 中华人民共和国 婚姻法 》 第三十二条 之 规定 ， 判决 如下 ： 

肖某甲诉文某甲离婚纠纷一案民事一审判决书.txt	据此 ， 依照 《 中华人民共和国 婚姻法 》 第三十二条 、 《 中华人民共和国 民事 诉讼法 》 第六十四 条 之 规定 ， 判决 如下 ： 

胡某与唐某某离婚纠纷一审民事判决书.txt	依照 《 中华人民共和国 婚姻法 》 第三十二条 之 规定 ， 判决 如下 ： 

胡某某与潘某离婚纠纷一审民事判决书.txt	依照 《 中华人民共和国 婚姻法 》 第三十二条 之 规定 ， 判决 如下 ： 

胥某某诉李某某离婚纠纷一审民事判决书.txt	依照 《 中华人民共和国 婚姻法 》 第三十二条 、 《 中华人民共和国 民事 诉讼法 》 第六十四 条 之 规定 ， 判决 如下 ： 

胥某某诉杜某某离婚纠纷一审民事判决书.txt	依照 《 中华人民共和国 婚姻法 》 第三十二条 之 规定 ， 判决 如下 ： 

胥某甲与覃某某离婚纠纷一审民事判决书.txt	依照 《 中华人民共和国 婚姻法 》 第三十二条 ， 《 中华人民共和国 民事 诉讼法 》 第六十四 条 的 规定 ， 判决 如下 ： 

舒某诉周某离婚纠纷一审民事判决书.txt	据此 ， 依照 《 中华人民共和国 婚姻法 》 第三十二条 ， 《 中华人民共和国 民事 诉讼法 》 第六十四 条 的 规定 ， 判决 如下 ： 

苏某与江某甲离婚纠纷一审民事判决书.txt	依照 《 中华人民共和国 婚姻法 》 第三十二条 和 《 中华人民共和国 民事 诉讼法 》 第六十四 条 之 规定 ， 判决 如下 ： 

苟某与高某离婚纠纷一案一审民事判决书.txt	据此 ， 依照 《 中华人民共和国 婚姻法 》 第三十二条 的 规定 ， 判决 如下 ： 

苟某某诉李某某离婚纠纷一案民事判决书.txt	据此 ， 判决 如下 ： 

范某某与张某某离婚纠纷一审民事判决书.txt	据此 ， 依照 《 中华人民共和国 婚姻法 》 第三十二条 之 规定 ， 判决 如下 ： 

范某某与牟某某离婚纠纷一审民事判决书.txt	据此 ， 依照 《 中华人民共和国 婚姻法 》 第三十二条 、 《 中华人民共和国 民事 诉讼法 》 第六十四 条 、 第 一百四十四 条 之 规定 ， 判决 如下 ： 

范某某与马某某离婚纠纷一审民事判决书.txt	依照 《 中华人民共和国 婚姻法 》 第三十二条 之 规定 ， 判决 如下 ： 

范某甲与张某某离婚纠纷一审民事判决书.txt	据此 ， 依照 《 中华人民共和国 婚姻法 》 第三十二条 之 规定 ， 判决 如下 ： 

董某某与邹某某离婚纠纷一案一审民事判决书.txt	依照 《 中华人民共和国 婚姻法 》 第三十二条 、 《 中华人民共和国 民事 诉讼法 》 第六十四 条 之 规定 ， 判决 如下 ： 

董某某与陆某某离婚纠纷一审民事判决书.txt	据此 ， 依照 《 中华人民共和国 民事 诉讼法 》 第六十四 条 、 《 中华人民共和国 婚姻法 》 第三十二条 的 规定 ， 判决 如下 ： 

董某某诉秦某某离婚纠纷案一审民事判决书.txt	据此 ， 依照 《 中华人民共和国 婚姻法 》 第三十二条 ， 《 中华人民共和国 民事 诉讼法 》 第六十四 条 之 规定 ， 判决 如下 ： 

蒋某某与修某某离婚纠纷一审民事判决书.txt	据此 ， 依照 《 中华人民共和国 婚姻法 》 第三十二条 、 《 中华人民共和国 民事 诉讼法 》 第六十四 条 第一款 之 规定 ， 判决 如下 ： 

蒋某某与刘某离婚纠纷一审民事判决书.txt	据此 判决 如下 ： 

蒋某某与黄某某离婚纠纷一审民事判决书.txt	依照 《 中华人民共和国 婚姻法 》 第三十二条 之 规定 ， 判决 如下 ： 

蒙某某与敬某甲离婚纠纷一审民事判决书.txt	据此 ， 依照 《 中华人民共和国 婚姻法 》 第三十二条 、 《 中华人民共和国 民事 诉讼法 》 第六十四 条 、 第 一百四十四 条 之 规定 ， 判决 如下 ： 

蒙某某诉李某离婚纠纷一审民事判决书.txt	据此 ， 依照 《 中华人民共和国 婚姻法 》 第三十二条 之 规定 ， 判决 如下 ： 

薛某某诉胡某某离婚纠纷民事一审判决书.txt	据此 ， 根据 《 中华人民共和国 婚姻法 》 第三十二条 、 第三十六条 第二款 、 第三十七条 、 《 中华人民共和国 民事 诉讼法 》 第六十四 条 、 第 一百四十四 条 之 规定 ， 判决 如下 ： 

袁某某与吴某某离婚一审判决书.txt	依照 《 中华人民共和国 婚姻法 》 第三十二条 之 规定 ， 判决 如下 ： 

袁某某与曾某甲离婚纠纷一审民事判决书.txt	依照 《 中华人民共和国 婚姻法 》 第三十二条 、 《 中华人民共和国 民事 诉讼法 》 第六十四 条 之 规定 ， 判决 如下 ： 

袁某某与陈某甲离婚纠纷一审民事判决书.txt	依照 《 中华人民共和国 婚姻法 》 第三十二条 之 规定 ， 判决 如下 ： 

袁某甲与王某离婚纠纷一审民事判决书.txt	依照 《 中华人民共和国 民事 诉讼法 》 第 一百四十四 条 、 《 中华人民共和国 婚姻法 》 第三十二条 之 规定 ， 判决 如下 ： 

袁某诉胥某某离婚纠纷一审民事判决书.txt	依照 《 中华人民共和国 婚姻法 》 第三十二条 之 规定 ， 判决 如下 ： 

许某某与李某甲离婚纠纷一审民事判决书.txt	据此 ， 依照 《 中华人民共和国 婚姻法 》 第三十二条 、 《 中华人民共和国 民事 诉讼法 》 第六十四 第一款 、 第 一百四十四 条 之 规定 ， 判决 如下 ： 

谢某某与刘某某离婚纠纷一审民事判决书.txt	依照 《 中华人民共和国 民事 诉讼法 》 第 一百四十四 条 和 《 中华人民共和国 婚姻法 》 第三十二条 之 规定 ， 判决 如下 ： 

谢某某与王某某离婚纠纷一审民事裁定书.txt	据此 ， 依照 《 中华人民共和国 婚姻法 》 第三十二条 之 规定 ， 判决 如下 ： 

谢某某与聂某离婚纠纷一审民事判决书.txt	依照 《 中华人民共和国 婚姻法 》 第三十二条 和 《 中华人民共和国 民事 诉讼法 》 第 一百四十四 条 之 规定 ， 判决 如下 ： 

谭某甲与何某某离婚纠纷一审民事判决书.txt	依照 《 中华人民共和国 婚姻法 》 第三十二条 之 规定 ， 判决 如下 ： 

贺某某与赵某某离婚纠纷一审民事判决书.txt	依照 《 中华人民共和国 婚姻法 》 第三十二条 ， 《 中华人民共和国 民事 诉讼法 》 第六十四 条 之 规定 ， 判决 如下 ： 

贾某某与汪某甲离婚纠纷一审民事判决书.txt	据此 ， 依照 《 中华人民共和国 婚姻法 》 第三十二条 、 《 中华人民共和国 民事 诉讼法 》 第六十四 条 、 第 一百四十四 条 之 规定 ， 判决 如下 ： 

贾菊香与陈猛离婚纠纷一审民事判决书.txt	据此 ， 依照 《 中华人民共和国 婚姻法 》 第三十二条 之 规定 ， 判决 如下 ： 

赵某某与周某某离婚纠纷一审民事判决书.txt	依照 《 中华人民共和国 民事 诉讼法 》 第 一百四十四 条 和 《 中华人民共和国 婚姻法 》 第三十二条 之 规定 ， 判决 如下 ： 

赵某某与李某离婚纠纷案一审民事判决书.txt	依照 《 中华人民共和国 婚姻法 》 第三十二条 之 规定 ， 判决 如下 ： 

赵某甲与王某甲离婚纠纷一审民事判决书.txt	依照 《 中华人民共和国 民事 诉讼法 》 第 一百四十四 条 、 《 中华人民共和国 婚姻法 》 第三十二条 、 第三十七条 之 规定 ， 判决 如下 ： 

赵某甲与被告赵某乙离婚纠纷一审民事判决书.txt	据此 ， 依照 《 中华人民共和国 民事 诉讼法 》 第六十四 条 第一款 之 规定 ， 判决 如下 ： 

路某某与吴某某离婚纠纷案一审民事判决书.txt	依照 《 中华人民共和国 婚姻法 》 第三十二条 和 《 中华人民共和国 民事 诉讼法 》 第六十四 条 、 第 一百四十四 条 、 第一百 六十条 之 规定 ， 判决 如下 ： 

邓某与张某甲离婚纠纷一审民事判决书.txt	依照 《 中华人民共和国 婚姻法 》 第三十二条 和 《 中华人民共和国 民事 诉讼法 》 第六十四 条 、 第 一百四十四 条 之 规定 ， 判决 如下 ： 

邓某某与唐某某离婚纠纷一审民事判决书.txt	据此 ， 依照 《 中华人民共和国 婚姻法 》 第三十二条 之 规定 ， 判决 如下 ： 

邓某某与瞿某某离婚纠纷一案一审民事判决书.txt	依照 《 中华人民共和国 婚姻法 》 第三十二条 、 《 中华人民共和国 民事 诉讼法 》 第六十四 条 之 规定 ， 判决 如下 ： 

邓某某与蒋某甲离婚纠纷一审民事判决书.txt	据此 ， 依照 《 中华人民共和国 婚姻法 》 第三十二条 、 第三十六条 和 《 中华人民共和国 民事 诉讼法 》 第 一百四十四 条 之 规定 ， 判决 如下 ： 

邓某甲与许某甲离婚纠纷一审民事判决书.txt	依照 《 中华人民共和国 婚姻法 》 第三十二条 之 规定 ， 判决 如下 ： 

邓某甲与马某某离婚纠纷一审民事判决书.txt	依照 《 中华人民共和国 婚姻法 》 第三十二条 之 规定 ， 判决 如下 ： 

邓玉皎与杜松离婚纠纷一审民事判决书.txt	据此 ， 依照 《 中华人民共和国 婚姻法 》 第三十二条 第二款 和 《 中华人民共和国 民事 诉讼法 》 第 一百四十四 条 之 规定 ， 判决 如下 ： 

邱某某诉龚某某离婚纠纷一审民事判决书.txt	据此 ， 依照 《 中华人民共和国 婚姻法 》 第三十二条 的 规定 ， 判决 如下 ： 

邹某某与张某某离婚纠纷民事一审判决书.txt	据此 ， 依照 《 中华人民共和国 婚姻法 》 第三十二条 ， 《 中华人民共和国 民事 诉讼法 》 第六十四 条 、 第 一百四十四 条 之 规定 ， 判决 如下 ： 

郑某某与谢某某离婚纠纷一审民事判决书.txt	据此 ， 依照 《 中华人民共和国 婚姻法 》 第三十二条 之 规定 ， 判决 如下 ： 

郑某某与陈某离婚纠纷一审民事判决书.txt	据此 ， 依照 《 中华人民共和国 婚姻法 》 第三十二条 的 规定 ， 判决 如下 ： 

郑某某诉被告李某某离婚纠纷一案一审民事判决书.txt	据此 ， 根据 《 中华人民共和国 婚姻法 》 第三十二条 ， 《 中华人民共和国 民事 诉讼法 》 第六十四 条 的 规定 ， 判决 如下 ： 

郑某某诉黄某某离婚纠纷民事一审判决书.txt	据此 ， 根据 《 中华人民共和国 婚姻法 》 第三十二条 、 《 中华人民共和国 民事 诉讼法 》 第六十四 条 、 第 一百四十四 条 之 规定 ， 判决 如下 ： 

郑甲某某与陈某某离婚纠纷一审民事判决书.txt	依照 《 中华人民共和国 婚姻法 》 第三十二条 第二款 、 第三十七条 第一款 ， 《 中华人民共和国 民事 诉讼法 》 第 一百四十四 条 之 规定 ， 判决 如下 ： 

郭某与林某甲离婚纠纷一审民事判决书.txt	据此 ， 依照 《 中华人民共和国 婚姻法 》 第三十二条 的 规定 ， 判决 如下 ： 

郭某某与唐某某离婚纠纷案一审民事判决书.txt	依照 《 中华人民共和国 婚姻法 》 第三十二条 之 规定 ， 判决 如下 ： 

郭某某与李某某离婚纠纷一审民事判决书.txt	依照 《 中华人民共和国 婚姻法 》 第三十二条 、 《 中华人民共和国 民事 诉讼法 》 第六十四 条 之 规定 ， 判决 如下 ： 

郭某某与李某某离婚纠纷案一审民事判决书.txt	依照 《 中华人民共和国 婚姻法 》 第三十二条 ， 《 中华人民共和国 民事 诉讼法 》 第 一百四十四 条 之 规定 ， 判决 如下 ： 

郭某某与邓某某离婚纠纷一审民事判决书.txt	依照 《 中华人民共和国 民事 诉讼法 》 第 一百四十四 条 、 《 中华人民共和国 婚姻法 》 第三十二条 之 规定 ， 判决 如下 ： 

阿某某与薛某某离婚纠纷一审民事判决书.txt	据此 ， 依照 《 中华人民共和国 民事 诉讼法 》 第 一百四十四 条 、 《 中华人民共和国 婚姻法 》 第三十二条 之 规定 ， 判决 如下 ： 

陈某与朱某甲离婚纠纷一审民事判决书.txt	依照 《 中华人民共和国 婚姻法 》 第三十二条 之 规定 ， 判决 如下 ： 

陈某某与何某甲离婚纠纷一审民事判决书.txt	依照 《 中华人民共和国 婚姻法 》 第三十二条 之 规定 ， 判决 如下 ： 

陈某某与冯某某离婚纠纷一审民事判决书.txt	依照 《 中华人民共和国 婚姻法 》 第三十二条 之 规定 ， 判决 如下 ： 

陈某某与康某某离婚纠纷一审民事判决书.txt	依照 《 中华人民共和国 婚姻法 》 第三十二条 之 规定 ， 判决 如下 ： 

陈某某与杨某甲离婚纠纷案一审民事判决书.txt	据此 ， 依照 《 中华人民共和国 婚姻法 》 第三十二条 之 规定 ， 判决 如下 ： 

陈某某与郝某某离婚纠纷一审民事判决书.txt	据此 ， 依照 《 中华人民共和国 婚姻法 》 第三十二条 ， 《 中华人民共和国 民事 诉讼法 》 第六十四 条 之 规定 ， 判决 如下 ： 

陈某某诉余某甲离婚纠纷一审民事判决书.txt	依照 《 中华人民共和国 婚姻法 》 第三十二条 之 规定 ， 判决 如下 ： 

陈某甲与陈某离婚纠纷一审民事判决书.txt	依照 《 中华人民共和国 民事 诉讼法 》 第六十四 条 一款 、 第 一百四十四 条 之 规定 ， 判决 如下 ： 

陈某诉张某某离婚纠纷一案一审民事判决书.txt	据此 ， 依照 《 中华人民共和国 婚姻法 》 第三十二条 和 《 中华人民共和国 民事 诉讼法 》 第六十四 条 第一款 之 规定 ， 判决 如下 ： 

陈艳诉姚发强离婚纠纷案一审民事判决书.txt	依照 《 中华人民共和国 婚姻法 》 第三十二条 ， 判决 如下 ： 

陶某与伏某某离婚纠纷一审民事判决书.txt	据此 ， 依照 《 中华人民共和国 婚姻法 》 第三十二条 、 第三十六条 、 《 中华人民共和国 民事 诉讼法 》 第 一百四十四 条 之 规定 ， 判决 如下 ： 

韩某与夏某某离婚纠纷一案一审民事判决书.txt	依照 《 中华人民共和国 婚姻法 》 第三十二条 之 规定 ， 判决 如下 ： 

韩某某与余某某离婚纠纷一审民事判决书.txt	依照 《 中华人民共和国 婚姻法 》 第三十二条 、 《 中华人民共和国 民事 诉讼法 》 第六十四 条 第一款 的 规定 ， 判决 如下 ： 

韩某某与宗某某离婚纠纷一审民事判决书.txt	依照 《 中华人民共和国 婚姻法 》 第三十二条 、 《 中华人民共和国 民事 诉讼法 》 第 一百四十四 条 之 规定 ， 判决 如下 ： 

马某某与刘某甲离婚纠纷一审民事判决书.txt	依照 《 中华人民共和国 婚姻法 》 第三十二条 之 规定 ， 判决 如下 ： 

马某某与周某离婚纠纷一案民事判决书.txt	依照 《 中华人民共和国 婚姻法 》 第三十二条 和 《 中华人民共和国 民事 诉讼法 》 第六十四 条 第一款 之 规定 ， 判决 如下 ： 

马某某与汤某某离婚纠纷一审民事判决书.txt	据此 ， 依照 《 中华人民共和国 民事 诉讼法 》 第六十四 条 、 《 中华人民共和国 婚姻法 》 第三十二条 的 规定 ， 判决 如下 ： 

高某与唐某某离婚纠纷一审民事判决书.txt	据此 ， 依照 《 中华人民共和国 婚姻法 》 第三十二条 、 《 中华人民共和国 民事 诉讼法 》 第六十四 条 第一款 之 规定 ， 判决 如下 ： 

高某某与邱某某离婚纠纷案一审民事判决书.txt	据此 ， 依照 《 中华人民共和国 婚姻法 》 第三十二条 ， 《 中华人民共和国 民事 诉讼法 》 第六十四 条 、 第 一百四十四 条 之 规定 ， 判决 如下 ： 

魏某某与李某某离婚纠纷一审民事判决书.txt	依照 《 中华人民共和国 婚姻法 》 第三十二条 、 《 中华人民共和国 民事 诉讼法 》 第六十四 条 、 第 一百四十四 条 之 规定 ， 判决 如下 ： 

魏某诉林某某离婚纠纷民事判决书.txt	据此 ， 依照 《 中华人民共和国 婚姻法 》 第三十二条 、 《 中华人民共和国 民事 诉讼法 》 第 一百四十四 条 之 规定 ， 判决 如下 ： 

鲜光琼与何文清离婚纠纷一审民事判决书.txt	据此 ， 依照 《 中华人民共和国 婚姻法 》 第三十二条 、 《 中华人民共和国 民事 诉讼法 》 第 一百四十四 条 之 规定 ， 判决 如下 ： 

黄某某与牟某某离婚纠纷一审民事判决书.txt	依照 《 中华人民共和国 婚姻法 》 第三十二条 、 第三十六条 、 《 中华人民共和国 民事 诉讼法 》 第 一百四十四 条 之 规定 ， 判决 如下 ： 

黄某某与苏某某离婚纠纷一审民事判决书.txt	据此 ， 依照 《 中华人民共和国 婚姻法 》 第三十二条 之 规定 ， 判决 如下 ： 

黄某某与邓某某离婚纠纷一审民事判决书.txt	依照 《 中华人民共和国 婚姻法 》 第三十二条 、 《 中华人民共和国 民事 诉讼法 》 第 一百四十四 条 之 规定 ， 判决 如下 ： 

黄某某与陈某某离婚纠纷一审民事判决书.txt	据此 ， 依照 《 中华人民共和国 婚姻法 》 第三十二条 之 规定 ， 判决 如下 ： 

黄某某与魏某某离婚纠纷一审民事判决书.txt	据此 ， 依照 《 中华人民共和国 婚姻法 》 第三十二条 ， 《 中华人民共和国 民事 诉讼法 》 第 一百四十四 条 的 规定 ， 判决 如下 ： 

黄某某诉杨某某离婚纠纷一审民事判决书.txt	依照 《 中华人民共和国 婚姻法 》 第三十二条 、 《 中华人民共和国 民事 诉讼法 》 第 一百四十四 条 之 规定 ， 判决 如下 ： 

黄某甲与宋某甲离婚纠纷一审民事判决书.txt	依照 《 中华人民共和国 婚姻法 》 第三十二条 之 规定 ， 判决 如下 ： 

黄某甲与徐某某离婚纠纷一审民事判决书.txt	据此 ， 依照 《 中华人民共和国 婚姻法 》 第三十二条 第二款 和 《 中华人民共和国 民事 诉讼法 》 第六十四 条 第一款 、 第 一百四十四 条 之 规定 ， 判决 如下 ： 

黄某甲与程某某离婚纠纷一审民事判决书.txt	依照 《 中华人民共和国 婚姻法 》 第三十二条 之 规定 ， 判决 如下 ： 

黎某某与周某某离婚纠纷一审民事判决书.txt	据此 ， 依照 《 中华人民共和国 民事 诉讼法 》 第六十四 条 第一款 、 《 中华人民共和国 婚姻法 》 第三十二条 的 规定 ， 判决 如下 ： 

龙某某与刘某某离婚纠纷一审民事判决书.txt	依照 《 中华人民共和国 婚姻法 》 第三十二条 、 《 中华人民共和国 民事 诉讼法 》 第 一百四十四 条 之 规定 ， 判决 如下 ： 

龙某某与高某某离婚纠纷案一审民事判决书.txt	依照 《 中华人民共和国 婚姻法 》 第三十二条 、 《 中华人民共和国 民事 诉讼法 》 第六十四 条 的 规定 ， 判决 如下 ： 

龚某某与周某某离婚纠纷一审民事判决书.txt	据此 ， 依照 《 中华人民共和国 婚姻法 》 第三十二条 之 规定 ， 判决 如下 ： 

龚某某与方某某离婚纠纷一审民事判决书.txt	依照 《 中华人民共和国 婚姻法 》 第三十二条 之 规定 ， 判决 如下 ： 

龚某某诉徐某某离婚纠纷一审民事判决书.txt	据此 ， 依照 《 中华人民共和国 婚姻法 》 第三十二条 的 规定 ， 判决 如下 ： 
